"aa" = (/turf/floor/beach/water/deep/saltwater,/area/caribbean/sea/top)
"ab" = (/obj/map_metadata/voyage,/turf/floor/beach/water/deep/saltwater,/area/caribbean/sea/top)
"ac" = (/obj/covers/repairedfloor/ship,/obj/structure/barricade/ship/blue/b1,/turf/floor/beach/water/deep/saltwater,/area/caribbean/pirates/ship/voyage/upper/inside)
"ad" = (/obj/structure/barricade/ship/wood/a7,/obj/covers/repairedfloor/ship,/turf/floor/beach/water/deep/saltwater,/area/caribbean/pirates/ship/voyage/upper/inside)
"ae" = (/obj/structure/barricade/ship/wood/a7,/obj/covers/repairedfloor/ship,/obj/item/flashlight/lantern/on/anchored,/turf/floor/beach/water/deep/saltwater,/area/caribbean/pirates/ship/voyage/upper/inside)
"af" = (/obj/structure/barricade/ship/wood/a7,/obj/covers/repairedfloor/ship,/obj/structure/sign/painting2,/turf/floor/beach/water/deep/saltwater,/area/caribbean/pirates/ship/voyage/upper/inside)
"ag" = (/obj/structure/barricade/ship/wood/a12,/obj/covers/repairedfloor/ship,/obj/structure/barricade/ship/wood/a9,/turf/floor/beach/water/deep/saltwater,/area/caribbean/pirates/ship/voyage/upper/inside)
"ah" = (/obj/structure/barricade/ship/wood/a7,/obj/covers/repairedfloor/ship,/turf/floor/beach/water/deep/saltwater,/area/caribbean/pirates/ship/voyage/upper)
"ai" = (/obj/covers/repairedfloor/ship,/obj/structure/barricade/ship/wood/a9,/turf/floor/beach/water/deep/saltwater,/area/caribbean/pirates/ship/voyage/upper)
"aj" = (/obj/covers/repairedfloor/ship,/obj/structure/barricade/ship/blue/bport_north,/turf/floor/beach/water/deep/saltwater,/area/caribbean/pirates/ship/voyage/upper)
"ak" = (/obj/covers/repairedfloor/ship/south,/obj/structure/barricade/ship/blue/bport3{dir = 1},/turf/floor/beach/water/deep/saltwater,/area/caribbean/pirates/ship/voyage/upper)
"al" = (/obj/covers/repairedfloor/ship,/obj/structure/barricade/ship/blue/b2,/turf/floor/beach/water/deep/saltwater,/area/caribbean/pirates/ship/voyage/upper/inside)
"am" = (/obj/effect/landmark{name = "JoinLatePirateBoatswain"},/obj/covers/repairedfloor/ship,/obj/structure/bed/chair{dir = 4},/turf/floor/beach/water/deep/saltwater,/area/caribbean/pirates/ship/voyage/upper/inside)
"an" = (/obj/structure/table/wood,/obj/covers/repairedfloor/ship,/obj/item/weapon/whistle,/turf/floor/beach/water/deep/saltwater,/area/caribbean/pirates/ship/voyage/upper/inside)
"ao" = (/obj/covers/repairedfloor/ship,/obj/structure/potted_plant{dir = 1},/turf/floor/beach/water/deep/saltwater,/area/caribbean/pirates/ship/voyage/upper/inside)
"ap" = (/obj/covers/repairedfloor/ship,/obj/structure/bed/wood,/obj/item/weapon/bedsheet/rd,/turf/floor/beach/water/deep/saltwater,/area/caribbean/pirates/ship/voyage/upper/inside)
"aq" = (/obj/structure/barricade/ship/wood/a12,/obj/covers/repairedfloor/ship,/obj/structure/sign/custom/plaque{desc = "The ship Boatswain's room and office."; name = "Boatswain's Room"},/turf/floor/beach/water/deep/saltwater,/area/caribbean/pirates/ship/voyage/upper/inside)
"ar" = (/obj/covers/repairedfloor/ship,/turf/floor/beach/water/deep/saltwater,/area/caribbean/pirates/ship/voyage/upper/inside)
"as" = (/obj/structure/barricade/ship/wood/a6,/obj/covers/repairedfloor/ship,/turf/floor/beach/water/deep/saltwater,/area/caribbean/pirates/ship/voyage/upper/inside)
"at" = (/obj/covers/repairedfloor/ship,/turf/floor/beach/water/deep/saltwater,/area/caribbean/pirates/ship/voyage/upper)
"au" = (/obj/structure/barricade/ship/wood/a5,/obj/covers/repairedfloor/ship,/turf/floor/beach/water/deep/saltwater,/area/caribbean/pirates/ship/voyage/upper)
"av" = (/obj/structure/barricade/ship/wood/a8,/obj/covers/repairedfloor/ship,/turf/floor/beach/water/deep/saltwater,/area/caribbean/pirates/ship/voyage/upper)
"aw" = (/obj/covers/repairedfloor/ship,/obj/structure/voyage_ropeladder/thin{dir = 1},/turf/floor/beach/water/deep/saltwater,/area/caribbean/pirates/ship/voyage/upper)
"ax" = (/obj/covers/repairedfloor/ship,/obj/structure/grapplehook,/turf/floor/beach/water/deep/saltwater,/area/caribbean/pirates/ship/voyage/upper)
"ay" = (/obj/covers/repairedfloor/ship,/obj/structure/cannon/modern/tank/voyage{dir = 1},/turf/floor/beach/water/deep/saltwater,/area/caribbean/pirates/ship/voyage/upper)
"az" = (/obj/covers/repairedfloor/ship,/obj/structure/grapplehook,/obj/structure/voyage_ropeladder/thin{dir = 1},/turf/floor/beach/water/deep/saltwater,/area/caribbean/pirates/ship/voyage/upper)
"aA" = (/obj/structure/barricade/ship/blue/bport_10,/obj/covers/repairedfloor/ship,/turf/floor/beach/water/deep/saltwater,/area/caribbean/pirates/ship/voyage/upper)
"aB" = (/obj/structure/simple_door/key_door/anyone/wood,/obj/covers/repairedfloor/ship,/turf/floor/beach/water/deep/saltwater,/area/caribbean/pirates/ship/voyage/upper/inside)
"aC" = (/obj/structure/barricade/ship/wood/a6,/obj/covers/repairedfloor/ship,/obj/item/flashlight/lantern/on/anchored,/turf/floor/beach/water/deep/saltwater,/area/caribbean/pirates/ship/voyage/upper/inside)
"aD" = (/obj/covers/repairedfloor/ship,/obj/covers/wood/stairs{dir = 8},/turf/floor/beach/water/deep/saltwater,/area/caribbean/pirates/ship/voyage/upper)
"aE" = (/obj/structure/barricade/ship/blue/bport/corner5,/obj/covers/repairedfloor/ship,/turf/floor/beach/water/deep/saltwater,/area/caribbean/pirates/ship/voyage/upper)
"aF" = (/obj/structure/barricade/ship/wood/a12,/obj/covers/repairedfloor/ship,/turf/floor/beach/water/deep/saltwater,/area/caribbean/pirates/ship/voyage/upper/inside)
"aG" = (/obj/structure/barricade/ship/blue/bport_10,/obj/covers/repairedfloor/ship,/turf/floor/beach/water/deep/saltwater,/area/caribbean/pirates/ship/voyage/upper/inside)
"aH" = (/obj/structure/barricade/ship/blue/bport/corner5,/obj/covers/repairedfloor/ship,/turf/floor/beach/water/deep/saltwater,/area/caribbean/pirates/ship/voyage/upper/inside)
"aI" = (/obj/covers/repairedfloor/ship,/obj/structure/bed/wood,/obj/item/weapon/bedsheet/blue,/turf/floor/beach/water/deep/saltwater,/area/caribbean/pirates/ship/voyage/upper/inside)
"aJ" = (/obj/structure/bookcase,/obj/covers/repairedfloor/ship,/obj/item/weapon/book,/obj/item/weapon/book,/obj/item/weapon/book,/obj/item/weapon/book,/turf/floor/beach/water/deep/saltwater,/area/caribbean/pirates/ship/voyage/upper/inside)
"aK" = (/obj/structure/bookcase,/obj/covers/repairedfloor/ship,/obj/item/weapon/book,/obj/item/weapon/book,/turf/floor/beach/water/deep/saltwater,/area/caribbean/pirates/ship/voyage/upper/inside)
"aL" = (/obj/structure/barricade/ship/wood/a12,/obj/covers/repairedfloor/ship,/obj/structure/sign/custom/plaque{desc = "The ship Quartermaster's room and office."; name = "Quartermaster's Room"},/turf/floor/beach/water/deep/saltwater,/area/caribbean/pirates/ship/voyage/upper/inside)
"aM" = (/obj/covers/repairedfloor/ship,/obj/structure/barricade/ship/wood/portl2,/turf/floor/beach/water/deep/saltwater,/area/caribbean/pirates/ship/voyage/upper)
"aN" = (/obj/covers/repairedfloor/ship,/obj/structure/closet/crate/chest/treasury/ship,/turf/floor/beach/water/deep/saltwater,/area/caribbean/pirates/ship/voyage/upper/inside)
"aO" = (/obj/structure/barricade/ship/blue/beast,/obj/covers/repairedfloor/ship,/turf/floor/beach/water/deep/saltwater,/area/caribbean/pirates/ship/voyage/upper/inside)
"aP" = (/obj/covers/repairedfloor/ship,/obj/structure/table/wood,/obj/item/weapon/attachment/scope/adjustable/binoculars,/turf/floor/beach/water/deep/saltwater,/area/caribbean/pirates/ship/voyage/upper)
"aQ" = (/obj/effect/landmark{name = "JoinLatePirateQM"},/obj/covers/repairedfloor/ship,/obj/structure/bed/chair{dir = 4},/turf/floor/beach/water/deep/saltwater,/area/caribbean/pirates/ship/voyage/upper/inside)
"aR" = (/obj/structure/table/wood,/obj/covers/repairedfloor/ship,/obj/item/trash/candle,/obj/item/weapon/pen,/turf/floor/beach/water/deep/saltwater,/area/caribbean/pirates/ship/voyage/upper/inside)
"aS" = (/obj/covers/repairedfloor/ship,/obj/structure/potted_plant{dir = 6},/turf/floor/beach/water/deep/saltwater,/area/caribbean/pirates/ship/voyage/upper/inside)
"aT" = (/obj/structure/bookcase,/obj/covers/repairedfloor/ship,/obj/item/weapon/book,/obj/item/weapon/book,/obj/item/weapon/book,/obj/item/weapon/book,/obj/item/weapon/book,/obj/item/weapon/book,/obj/item/weapon/book,/turf/floor/beach/water/deep/saltwater,/area/caribbean/pirates/ship/voyage/upper/inside)
"aU" = (/obj/covers/repairedfloor/ship,/obj/structure/voyage_shipwheel,/turf/floor/beach/water/deep/saltwater,/area/caribbean/pirates/ship/voyage/upper)
"aV" = (/obj/structure/multiz/ladder/ww2{area_id = "b1"},/obj/covers/repairedfloor/ship,/turf/floor/beach/water/deep/saltwater,/area/caribbean/pirates/ship/voyage/upper)
"aW" = (/obj/covers/repairedfloor/ship,/obj/structure/voyage_grid/partial{dir = 6},/turf/floor/beach/water/deep/saltwater,/area/caribbean/pirates/ship/voyage/upper)
"aX" = (/obj/covers/repairedfloor/ship,/obj/structure/voyage_grid/partial{dir = 10},/turf/floor/beach/water/deep/saltwater,/area/caribbean/pirates/ship/voyage/upper)
"aY" = (/obj/covers/repairedfloor/ship,/obj/structure/table/wood,/obj/structure/voyage_sextant,/turf/floor/beach/water/deep/saltwater,/area/caribbean/pirates/ship/voyage/upper)
"aZ" = (/obj/covers/repairedfloor/ship,/obj/structure/barricade/ship/mast/large,/turf/floor/beach/water/deep/saltwater,/area/caribbean/pirates/ship/voyage/upper)
"ba" = (/obj/covers/repairedfloor/ship,/obj/item/weapon/pen,/obj/item/clothing/head/powdered_wig,/obj/item/weapon/paper,/obj/item/weapon/paper,/obj/item/weapon/paper,/obj/item/weapon/paper,/obj/item/weapon/paper,/obj/item/weapon/paper,/obj/structure/closet/crate/chest,/turf/floor/beach/water/deep/saltwater,/area/caribbean/pirates/ship/voyage/upper/inside)
"bb" = (/obj/covers/repairedfloor/ship,/obj/structure/bed/wood,/obj/item/weapon/bedsheet/captain,/turf/floor/beach/water/deep/saltwater,/area/caribbean/pirates/ship/voyage/upper/inside)
"bc" = (/obj/covers/repairedfloor/ship,/obj/structure/table/fancy,/obj/structure/potted_plant{dir = 5},/turf/floor/beach/water/deep/saltwater,/area/caribbean/pirates/ship/voyage/upper/inside)
"bd" = (/obj/structure/bookcase,/obj/covers/repairedfloor/ship,/obj/item/weapon/book,/obj/item/weapon/book,/obj/item/weapon/book,/obj/item/weapon/book,/obj/item/weapon/book,/obj/item/weapon/book,/turf/floor/beach/water/deep/saltwater,/area/caribbean/pirates/ship/voyage/upper/inside)
"be" = (/obj/structure/table/wood,/obj/covers/repairedfloor/ship,/obj/structure/voyage_tablemap{dir = 4},/turf/floor/beach/water/deep/saltwater,/area/caribbean/pirates/ship/voyage/upper)
"bf" = (/obj/covers/repairedfloor/ship,/obj/structure/voyage_grid/partial{dir = 5},/turf/floor/beach/water/deep/saltwater,/area/caribbean/pirates/ship/voyage/upper)
"bg" = (/obj/covers/repairedfloor/ship,/obj/structure/voyage_grid/partial{dir = 9},/turf/floor/beach/water/deep/saltwater,/area/caribbean/pirates/ship/voyage/upper)
"bh" = (/obj/structure/barricade/ship/wood/a12,/obj/covers/repairedfloor/ship,/obj/structure/sign/custom/plaque{desc = "The ship Captain's room and office."; name = "Captain's Room"},/turf/floor/beach/water/deep/saltwater,/area/caribbean/pirates/ship/voyage/upper/inside)
"bi" = (/obj/covers/repairedfloor/ship,/obj/structure/barricade/ship/blue/b2,/obj/structure/sign/painting3,/turf/floor/beach/water/deep/saltwater,/area/caribbean/pirates/ship/voyage/upper/inside)
"bj" = (/obj/structure/table/wood,/obj/covers/repairedfloor/ship,/obj/item/weapon/flame/candle,/turf/floor/beach/water/deep/saltwater,/area/caribbean/pirates/ship/voyage/upper/inside)
"bk" = (/obj/structure/barricade/ship/blue/bport/corner6,/obj/covers/repairedfloor/ship,/turf/floor/beach/water/deep/saltwater,/area/caribbean/pirates/ship/voyage/upper/inside)
"bl" = (/obj/structure/barricade/ship/blue/bport9,/obj/covers/repairedfloor/ship,/turf/floor/beach/water/deep/saltwater,/area/caribbean/pirates/ship/voyage/upper/inside)
"bm" = (/obj/covers/repairedfloor/ship,/obj/structure/bed/chair/wood/red{dir = 4},/turf/floor/beach/water/deep/saltwater,/area/caribbean/pirates/ship/voyage/upper/inside)
"bn" = (/obj/structure/table/wood,/obj/covers/repairedfloor/ship,/obj/structure/voyage_tablemap{dir = 4},/turf/floor/beach/water/deep/saltwater,/area/caribbean/pirates/ship/voyage/upper/inside)
"bo" = (/obj/structure/barricade/ship/blue/bport/corner6,/obj/covers/repairedfloor/ship,/turf/floor/beach/water/deep/saltwater,/area/caribbean/pirates/ship/voyage/upper)
"bp" = (/obj/structure/barricade/ship/blue/bport9,/obj/covers/repairedfloor/ship,/turf/floor/beach/water/deep/saltwater,/area/caribbean/pirates/ship/voyage/upper)
"bq" = (/obj/effect/landmark{name = "JoinLatePirateCap"},/obj/covers/repairedfloor/ship,/turf/floor/beach/water/deep/saltwater,/area/caribbean/pirates/ship/voyage/upper/inside)
"br" = (/obj/structure/table/wood,/obj/covers/repairedfloor/ship,/obj/item/weapon/globe,/turf/floor/beach/water/deep/saltwater,/area/caribbean/pirates/ship/voyage/upper/inside)
"bs" = (/obj/covers/repairedfloor/ship,/obj/structure/potted_plant,/turf/floor/beach/water/deep/saltwater,/area/caribbean/pirates/ship/voyage/upper/inside)
"bt" = (/obj/covers/repairedfloor/ship,/obj/structure/closet/cabinet,/turf/floor/beach/water/deep/saltwater,/area/caribbean/pirates/ship/voyage/upper/inside)
"bu" = (/obj/structure/barricade/ship/blue/b18,/obj/covers/repairedfloor/ship,/turf/floor/beach/water/deep/saltwater,/area/caribbean/pirates/ship/voyage/upper)
"bv" = (/obj/structure/barricade/ship/blue/b8,/obj/covers/repairedfloor/ship,/turf/floor/beach/water/deep/saltwater,/area/caribbean/pirates/ship/voyage/upper)
"bx" = (/obj/covers/repairedfloor/ship,/obj/structure/barricade/ship/blue/b15,/turf/floor/beach/water/deep/saltwater,/area/caribbean/pirates/ship/voyage/upper/inside)
"by" = (/obj/structure/barricade/ship/blue/b9,/obj/covers/repairedfloor/ship,/turf/floor/beach/water/deep/saltwater,/area/caribbean/pirates/ship/voyage/upper/inside)
"bz" = (/obj/structure/barricade/ship/blue/b9,/obj/covers/repairedfloor/ship,/obj/item/flashlight/lantern/on/anchored,/turf/floor/beach/water/deep/saltwater,/area/caribbean/pirates/ship/voyage/upper/inside)
"bA" = (/obj/structure/barricade/ship/blue/b9,/obj/covers/repairedfloor/ship,/turf/floor/beach/water/deep/saltwater,/area/caribbean/pirates/ship/voyage/upper)
"bB" = (/obj/structure/barricade/ship/blue/b19,/obj/covers/repairedfloor/ship,/turf/floor/beach/water/deep/saltwater,/area/caribbean/pirates/ship/voyage/upper)
"bC" = (/obj/structure/barricade/ship/blue/bport0,/obj/covers/repairedfloor/ship,/turf/floor/beach/water/deep/saltwater,/area/caribbean/pirates/ship/voyage/upper)
"bD" = (/obj/structure/barricade/ship/blue/bport3,/obj/covers/repairedfloor/ship,/obj/structure/voyage_ropeladder/thin,/turf/floor/beach/water/deep/saltwater,/area/caribbean/pirates/ship/voyage/upper)
"bE" = (/obj/structure/barricade/ship/blue/bport3,/obj/covers/repairedfloor/ship,/turf/floor/beach/water/deep/saltwater,/area/caribbean/pirates/ship/voyage/upper)
"bF" = (/obj/structure/barricade/ship/blue/bport0,/obj/covers/repairedfloor/ship,/obj/structure/cannon/modern/tank/voyage,/turf/floor/beach/water/deep/saltwater,/area/caribbean/pirates/ship/voyage/upper)
"bG" = (/obj/structure/barricade/ship/blue/bport0,/obj/covers/repairedfloor/ship,/obj/structure/voyage_ropeladder/thin,/turf/floor/beach/water/deep/saltwater,/area/caribbean/pirates/ship/voyage/upper)
"bH" = (/obj/effect/landmark{name = "Grappling Hook area - do not block"},/turf/floor/beach/water/deep/saltwater,/area/caribbean/sea/top)

(1,1,1) = {"
aaaaaaaaaaaaaaaaaaaaaaaaaaaaaaaaaaaaaaaaaaaaaaaaaaaaaaaaaaaaaaaaaaaaaaaaaaaaaaaaaaaaaaaaaaaaaaaaaaaaaaaaaaaaaaaaaaaaaaaaaaaaaaaaaaaaaaaaaaaaaaaaaaaaaa
aaaaaaaaaaaaaaaaaaaaaaaaaaaaaaaaaaaaaaaaaaaaaaaaaaaaaaaaaaaaaaaaaaaaaaaaaaaaaaaaaaaaaaaaaaaaaaaaaaaaaaaaaaaaaaaaaaaaaaaaaaaaaaaaaaaaaaaaaaaaaaaaaaaaaa
aaaaaaaaaaaaaaaaaaaaaaaaaaaaaaaaaaaaaaaaaaaaaaaaaaaaaaaaaaaaaaaaaaaaaaaaaaaaaaaaaaaaaaaaaaaaaaaaaaaaaaaaaaaaaaaaaaaaaaaaaaaaaaaaaaaaaaaaaaaaaaaaaaaaaa
aaaaaaaaaaaaaaaaaaaaaaaaaaaaaaaaaaaaaaaaaaaaaaaaaaaaaaaaaaaaaaaaaaaaaaaaaaaaaaaaaaaaaaaaaaaaaaaaaaaaaaaaaaaaaaaaaaaaaaaaaaaaaaaaaaaaaaaaaaaaaaaaaaaaaa
aaaaaaaaaaaaaaaaaaaaaaaaaaaaaaaaaaaaaaaaaaaaaaaaaaaaaaaaaaaaaaaaaaaaaaaaaaaaaaaaaaaaaaaaaaaaaaaaaaaaaaaaaaaaaaaaaaaaaaaaaaaaaaaaaaaaaaaaaaaaaaaaaaaaaa
aaaaaaaaaaaaaaaaaaaaaaaaaaaaaaaaaaaaaaaaaaaaaaaaaaaaaaaaaaaaaaaaaaaaaaaaaaaaaaaaaaaaaaaaaaaaaaaaaaaaaaaaaaaaaaaaaaaaaaaaaaaaaaaaaaaaaaaaaaaaaaaaaaaaaa
aaaaaaaaaaaaaaaaaaaaaaaaaaaaaaaaaaaaaaaaaaaaaaaaaaaaaaaaaaaaaaaaaaaaaaaaaaaaaaaaaaaaaaaaaaaaaaaaaaaaaaaaaaaaaaaaaaaaaaaaaaaaaaaaaaaaaaaaaaaaaaaaaaaaaa
aaaaaaaaaaaaaaaaaaaaaaaaaaaaaaaaaaaaaaaaaaaaaaaaaaaaaaaaaaaaaaaaaaaaaaaaaaaaaaaaaaaaaaaaaaaaaaaaaaaaaaaaaaaaaaaaaaaaaaaaaaaaaaaaaaaaaaaaaaaaaaaaaaaaaa
aaaaaaaaaaaaaaaaaaaaaaaaaaaaaaaaaaaaaaaaaaaaaaaaaaaaaaaaaaaaaaaaaaaaaaaaaaaaaaaaaaaaaaaaaaaaaaaaaaaaaaaaaaaaaaaaaaaaaaaaaaaaaaaaaaaaaaaaaaaaaaaaaaaaaa
aaaaaaaaaaaaaaaaaaaaaaaaaaaaaaaaaaaaaaaaaaaaaaaaaaaaaaaaaaaaaaaaaaaaaaaaaaaaaaaaaaaaaaaaaaaaaaaaaaaaaaaaaaaaaaaaaaaaaaaaaaaaaaaaaaaaaaaaaaaaaaaaaaaaaa
aaaaaaaaaaaaaaaaaaaaaaaaaaaaaaaaaaaaaaaaaaaaaaaaaaaaaaaaaaaaaaaaaaaaaaaaaaaaaaaaaaaaaaaaaaaaaaaaaaaaaaaaaaaaaaaaaaaaaaaaaaaaaaaaaaaaaaaaaaaaaaaaaaaaaa
aaaaaaaaaaaaaaaaaaaaaaaaaaaaaaaaaaaaaaaaaaaaaaaaaaaaaaaaaaaaaaaaaaaaaaaaaaaaaaaaaaaaaaaaaaaaaaaaaaaaaaaaaaaaaaaaaaaaaaaaaaaaaaaaaaaaaaaaaaaaaaaaaaaaaa
aaaaaaaaaaaaaaaaaaaaaaaaaaaaaaaaaaaaaaaaaaaaaaaaaaaaaaaaaaaaaaaaaaaaaaaaaaaaaaaaaaaaaaaaaaaaaaaaaaaaaaaaaaaaaaaaaaaaaaaaaaaaaaaaaaaaaaaaaaaaaaaaaaaaaa
aaaaaaaaaaaaaaaaaaaaaaaaaaaaaaaaaaaaaaaaaaaaaaaaaaaaaaaaaaaaaaaaaaaaaaaaaaaaaaaaaaaaaaaaaaaaaaaaaaaaaaaaaaaaaaaaaaaaaaaaaaaaaaaaaaaaaaaaaaaaaaaaaaaaaa
aaaaaaaaaaaaaaaaaaaaaaaaaaaaaaaaaaaaaaaaaaaaaaaaaaaaaaaaaaaaaaaaaaaaaaaaaaaaaaaaaaaaaaaaaaaaaaaaaaaaaaaaaaaaaaaaaaaaaaaaaaaaaaaaaaaaaaaaaaaaaaaaaaaaaa
aaaaaaaaaaaaaaaaaaaaaaaaaaaaaaaaaaaaaaaaaaaaaaaaaaaaaaaaaaaaaaaaaaaaaaaaaaaaaaaaaaaaaaaaaaaaaaaaaaaaaaaaaaaaaaaaaaaaaaaaaaaaaaaaaaaaaaaaaaaaaaaaaaaaaa
aaaaaaaaaaaaaaaaaaaaaaaaaaaaaaaaaaaaaaaaaaaaaaaaaaaaaaaaaaaaaaaaaaaaaaaaaaaaaaaaaaaaaaaaaaaaaaaaaaaaaaaaaaaaaaaaaaaaaaaaaaaaaaaaaaaaaaaaaaaaaaaaaaaaaa
aaaaaaaaaaaaaaaaaaaaaaaaaaaaaaaaaaaaaaaaaaaaaaaaaaaaaaaaaaaaaaaaaaaaaaaaaaaaaaaaaaaaaaaaaaaaaaaaaaaaaaaaaaaaaaaaaaaaaaaaaaaaaaaaaaaaaaaaaaaaaaaaaaaaaa
aaaaaaaaaaaaaaaaaaaaaaaaaaaaaaaaaaaaaaaaaaaaaaaaaaaaaaaaaaaaaaaaaaaaaaaaaaaaaaaaaaaaaaaaaaaaaaaaaaaaaaaaaaaaaaaaaaaaaaaaaaaaaaaaaaaaaaaaaaaaaaaaaaaaaa
aaaaaaaaaaaaaaaaaaaaaaaaaaaaaaaaaaaaaaaaaaaaaaaaaaaaaaaaaaaaaaaaaaaaaaaaaaaaaaaaaaaaaaaaaaaaaaaaaaaaaaaaaaaaaaaaaaaaaaaaaaaaaaaaaaaaaaaaaaaaaaaaaaaaaa
aaaaaaaaaaaaaaaaaaaaaaaaaaaaaaaaaaaaaaaaaaaaaaaaaaaaaaaaaaaaaaaaaaaaaaaaaaaaaaaaaaaaaaaaaaaaaaaaaaaaaaaaaaaaaaaaaaaaaaaaaaaaaaaaaaaaaaaaaaaaaaaaaaaaaa
aaaaaaaaaaaaaaaaaaaaaaaaaaaaaaaaaaaaaaaaaaaaaaaaaaaaaaaaaaaaaaaaaaaaaaaaaaaaaaaaaaaaaaaaaaaaaaaaaaaaaaaaaaaaaaaaaaaaaaaaaaaaaaaaaaaaaaaaaaaaaaaaaaaaaa
aaaaaaaaaaaaaaaaaaaaaaaaaaaaaaaaaaaaaaaaaaaaaaaaaaaaaaaaaaaaaaaaaaaaaaaaaaaaaaaaaaaaaaaaaaaaaaaaaaaaaaaaaaaaaaaaaaaaaaaaaaaaaaaaaaaaaaaaaaaaaaaaaaaaaa
aaaaaaaaaaaaaaaaaaaaaaaaaaaaaaaaaaaaaaaaaaaaaaaaaaaaaaaaaaaaaaaaaaaaaaaaaaaaaaaaaaaaaaaaaaaaaaaaaaaaaaaaaaaaaaaaaaaaaaaaaaaaaaaaaaaaaaaaaaaaaaaaaaaaaa
abaaaaaaaaaaaaaaaaaaaaaaaaaaaaaaaaaaaaaaaaaaaaaaaaaaaaaaaaaaaaaaaaaaaaaaaaaaaaaaaaaaaaaaaaaaaaaaaaaaaaaaaaaaaaaaaaaaaaaaaaaaaaaaaaaaaaaaaaaaaaaaaaaaaa
"}

(1,1,2) = {"
aaaaaaaaaaaaaaaaaaaaaaaaaaaaaaaaaaaaaaaaaaaaaaaaaaaaaaaaaaaaaaaaaaaaaaaaaaaaaaaaaaaaaaaaaaaaaaaaaaaaaaaaaaaaaaaaaaaaaaaaaaaaaaaaaaaaaaaaaaaaaaaaaaaaaa
aaaaaaaaaaaaaaaaaaaaaaaaaaaaaaaaaaaaaaaaaaaaaaaaaaaaaaaaaaaaaaaaaaaaaaaaaaaaaaaaaaaaaaaaaaaaaaaaaaaaaaaaaaaaaaaaaaaaaaaaaaaaaaaaaaaaaaaaaaaaaaaaaaaaaa
aaaaaaaaaaaaaaaaaaaaaaaaaaaaaaaaaaaaaaaaaaaaaaaaaaaaaaaaaaaaaaaaaaaaaaaaaaaaaaaaaaaaaaaaaaaaaaaaaaaaaaaaaaaaaaaaaaaaaaaaaaaaaaaaaaaaaaaaaaaaaaaaaaaaaa
aaaaaaaaaaaaaaaaaaaaaaaaaaaaaaaaaaaaaaaaaaaaaaaaaaaaaaaaaaaaaaaaaaaaaaaaaaaaaaaaaaaaaaaaaaaaaaaaaaaaaaaaaaaaaaaaaaaaaaaaaaaaaaaaaaaaaaaaaaaaaaaaaaaaaa
aaaaaaaaaaaaaaaaaaaaaaaaaaaaaaaaaaaaaaaaaaaaaaaaaaaaaaaaaaaaaaaaaaaaaaaaaaaaaaaaaaaaaaaaaaaaaaaaaaaaaaaaaaaaaaaaaaaaaaaaaaaaaaaaaaaaaaaaaaaaaaaaaaaaaa
aaaaaaaaaaaaaaaaaaaaaaaaaaaaaaaaaaaaaaaaaaaaaaaaaaaaaaaaaaaaaaaaaaaaaaaaaaaaaaaaaaaaaaaaaaaaaaaaaaaaaaaaaaaaaaaaaaaaaaaaaaaaaaaaaaaaaaaaaaaaaaaaaaaaaa
aaaaaaaaaaaaaaaaaaaaaaaaacadaeafadagaeagahaiajajajakajajakajajakajajakajajajajajajajajajajajajajajajajaAaaaaaaaaaaaaaaaaaaaaaaaaaaaaaaaaaaaaaaaaaaaaaa
aaaaaaaaaaaaaaaaaaaaaaaaalamanaoapaqarasatauavatatawataxatayatatatatazatayatatatatawatatatatatatatatataEaGaaaaaaaaaaaaaaaaaaaaaaaaaaaaaaaaaaaaaaaaaaaa
aaaaaaaaaaaaaaaaaaaaaaaaalararararaBaraCatataDatatatatatatatatatatatatatatatatatatatatatatatatatatatatataHaGaaaaaaaaaaaaaaaaaaaaaaaaaaaaaaaaaaaaaaaaaa
aaaaaaaaaaaaaaaaaaaaaaaaaladaeadadaFaraBatataDatatatatatatatatatatatatatatatatatatatatatatatatatatatatataraHaGaaaaaaaaaaaaaaaaaaaaaaaaaaaaaaaaaaaaaaaa
aaaaaaaaaaaaaaaaaaaaaaaaalaIaraJaKaLarasatataMatatatatatatatatatatatatatatatatatatatatatatatatatatatatataraNaOaaaaaaaaaaaaaaaaaaaaaaaaaaaaaaaaaaaaaaaa
aaaaaaaaaaaaaaaaaaaaaaaaalararararaBarasataPaMatatatatatatatatatatatatatatatatatatatatatatatatatatatatataraNaOaaaaaaaaaaaaaaaaaaaaaaaaaaaaaaaaaaaaaaaa
aaaaaaaaaaaaaaaaaaaaaaaaalaQaRaSaTaFarasataUaMaVatatatatatataWataXatatatatatatatatatatatatatatatatatatataraNaOaaaaaaaaaaaaaaaaaaaaaaaaaaaaaaaaaaaaaaaa
aaaaaaaaaaaaaaaaaaaaaaaaaladaeadadagarasataYaMaVataZatatatatatatatataZatatatatatataZatatatatatatatatatataraNaOaaaaaaaaaaaaaaaaaaaaaaaaaaaaaaaaaaaaaaaa
aaaaaaaaaaaaaaaaaaaaaaaaalbabbbcbdaFarasatbeaMatatatatatatatbfatbgatatatatatatatatatatatatatatatatatatataraNaOaaaaaaaaaaaaaaaaaaaaaaaaaaaaaaaaaaaaaaaa
aaaaaaaaaaaaaaaaaaaaaaaaalararararbharaCatataMatatatatatatatatatatatatatatatatatatatatatatatatatatatatataraNaOaaaaaaaaaaaaaaaaaaaaaaaaaaaaaaaaaaaaaaaa
aaaaaaaaaaaaaaaaaaaaaaaabiarbjararaBaraBatataDatatatatatatatatatatatatatatatatatatatatatatatatatatatatatarbkblaaaaaaaaaaaaaaaaaaaaaaaaaaaaaaaaaaaaaaaa
aaaaaaaaaaaaaaaaaaaaaaaaalbmbnararaFarasatataDatatatataxatatatatatatataxatatatatatatatatatatatatatatatatbkblaaaaaaaaaaaaaaaaaaaaaaaaaaaaaaaaaaaaaaaaaa
aaaaaaaaaaaaaaaaaaaaaaaaalbqbrbsbtaFarasatbubvatatatataxatatatatatatataxatatatatatatatatatatatatatatatboblaaaaaaaaaaaaaaaaaaaaaaaaaaaaaaaaaaaaaaaaaaaa
aaaaaaaaaaaaaaaaaaaaaaaabxbybzbybybybzbybAbBbCbCbCbDbCbCbEbFbCbEbCbCbDbCbFbEbCbCbCbGbCbCbCbCbCbCbCbCbCbpaaaaaaaaaaaaaaaaaaaaaaaaaaaaaaaaaaaaaaaaaaaaaa
aaaaaaaaaaaaaaaaaaaaaaaaaaaaaaaaaaaaaaaaaaaaaaaaaaaaaaaabHaaaaaaaaaaaabHaaaaaaaaaaaaaaaaaaaaaaaaaaaaaaaaaaaaaaaaaaaaaaaaaaaaaaaaaaaaaaaaaaaaaaaaaaaaaa
aaaaaaaaaaaaaaaaaaaaaaaaaaaaaaaaaaaaaaaaaaaaaaaaaaaaaaaabHaaaaaaaaaaaabHaaaaaaaaaaaaaaaaaaaaaaaaaaaaaaaaaaaaaaaaaaaaaaaaaaaaaaaaaaaaaaaaaaaaaaaaaaaaaa
aaaaaaaaaaaaaaaaaaaaaaaaaaaaaaaaaaaaaaaaaaaaaaaaaaaaaaaabHaaaaaaaaaaaabHaaaaaaaaaaaaaaaaaaaaaaaaaaaaaaaaaaaaaaaaaaaaaaaaaaaaaaaaaaaaaaaaaaaaaaaaaaaaaa
aaaaaaaaaaaaaaaaaaaaaaaaaaaaaaaaaaaaaaaaaaaaaaaaaaaaaaaabHaaaaaaaaaaaabHaaaaaaaaaaaaaaaaaaaaaaaaaaaaaaaaaaaaaaaaaaaaaaaaaaaaaaaaaaaaaaaaaaaaaaaaaaaaaa
aaaaaaaaaaaaaaaaaaaaaaaaaaaaaaaaaaaaaaaaaaaaaaaaaaaaaaaabHaaaaaaaaaaaabHaaaaaaaaaaaaaaaaaaaaaaaaaaaaaaaaaaaaaaaaaaaaaaaaaaaaaaaaaaaaaaaaaaaaaaaaaaaaaa
"}
