"aa" = (/obj/structure/grille/fence/picket/goalpost{dir = 9},/turf/floor/dirt,/area/caribbean/football)
"ab" = (/turf/wall/indestructable/black,/area/caribbean/football/nopass)
"ac" = (/turf/floor/dirt,/area/caribbean/football)
"ad" = (/turf/floor/dirt,/area/caribbean/football/nopass)
"ae" = (/obj/structure/banner/faction/team/team2,/turf/floor/grass{name = "pitch"},/area/caribbean/football)
"af" = (/obj/structure/sign/traffic/central,/turf/floor/grass{name = "pitch"},/area/caribbean/football)
"ag" = (/obj/structure/sign/traffic/central,/turf/floor/grass{name = "pitch"},/area/caribbean/football/nopass)
"ah" = (/obj/structure/sign/traffic/central{dir = 4; icon_state = "centralline"},/turf/floor/grass{name = "pitch"},/area/caribbean/football)
"ai" = (/obj/structure/sign/traffic/central{dir = 8; icon_state = "centralline"},/obj/structure/sign/traffic/central{dir = 1; icon_state = "centralline"},/obj/structure/sign/traffic/central,/obj/structure/sign/traffic/central{dir = 4; icon_state = "centralline"},/obj/effect/landmark{name = "JoinLateCivB"},/turf/floor/grass{name = "pitch"},/area/caribbean/football/blue)
"aj" = (/obj/structure/sign/traffic/central{dir = 1; icon_state = "centralline"},/obj/structure/sign/traffic/central{dir = 8; icon_state = "centralline"},/turf/floor/grass{name = "pitch"},/area/caribbean/football/blue)
"ak" = (/obj/structure/sign/traffic/central{dir = 1; icon_state = "centralline"},/turf/floor/grass{name = "pitch"},/area/caribbean/football/blue)
"am" = (/obj/structure/sign/traffic/central{dir = 1; icon_state = "centralline"},/obj/structure/sign/traffic/central{dir = 4; icon_state = "centralline"},/turf/floor/grass{name = "pitch"},/area/caribbean/football/midfield)
"an" = (/obj/structure/sign/traffic/central{dir = 1; icon_state = "centralline"},/turf/floor/grass{name = "pitch"},/area/caribbean/football/red)
"ao" = (/obj/structure/sign/traffic/central{dir = 1; icon_state = "centralline"},/obj/structure/sign/traffic/central{dir = 8; icon_state = "centralline"},/turf/floor/grass{name = "pitch"},/area/caribbean/football/red/goalkeeper)
"ap" = (/obj/structure/sign/traffic/central,/obj/structure/banner/faction/team/team2,/turf/floor/grass{name = "pitch"},/area/caribbean/football)
"aq" = (/obj/structure/sign/traffic/central,/obj/structure/banner/faction/team/team1,/turf/floor/grass{name = "pitch"},/area/caribbean/football)
"ar" = (/obj/structure/sign/traffic/central{dir = 8; icon_state = "centralline"},/obj/structure/sign/traffic/central{dir = 1; icon_state = "centralline"},/turf/floor/grass{name = "pitch"},/area/caribbean/football/blue)
"as" = (/turf/floor/grass{name = "pitch"},/area/caribbean/football/blue)
"at" = (/obj/structure/sign/traffic/central{dir = 1; icon_state = "centralline"},/obj/structure/sign/traffic/central{dir = 8; icon_state = "centralline"},/turf/floor/grass{name = "pitch"},/area/caribbean/football/midfield)
"au" = (/obj/structure/sign/traffic/central{dir = 4; icon_state = "centralline"},/turf/floor/grass{name = "pitch"},/area/caribbean/football/midfield)
"av" = (/turf/floor/grass{name = "pitch"},/area/caribbean/football/red)
"aw" = (/obj/structure/sign/traffic/central{dir = 1; icon_state = "centralline"},/obj/structure/sign/traffic/central{dir = 4; icon_state = "centralline"},/obj/structure/sign/traffic/central,/obj/structure/sign/traffic/central{dir = 8; icon_state = "centralline"},/obj/effect/landmark{icon_state = "x1"; name = "JoinLateCivA"},/turf/floor/grass{name = "pitch"},/area/caribbean/football/red)
"ax" = (/obj/structure/sign/traffic/central{dir = 8; icon_state = "centralline"},/turf/floor/grass{name = "pitch"},/area/caribbean/football/blue)
"ay" = (/obj/structure/sign/traffic/central{dir = 4; icon_state = "centralline"},/turf/floor/grass{name = "pitch"},/area/caribbean/football/red)
"az" = (/obj/structure/sign/traffic/central{dir = 8; icon_state = "centralline"},/obj/structure/sign/traffic/central,/turf/floor/grass{name = "pitch"},/area/caribbean/football/blue)
"aA" = (/obj/structure/sign/traffic/central,/turf/floor/grass{name = "pitch"},/area/caribbean/football/blue)
"aB" = (/obj/structure/banner/faction/team/team1,/turf/floor/grass{name = "pitch"},/area/caribbean/football)
"aC" = (/obj/structure/sign/traffic/central{dir = 4; icon_state = "centralline"},/obj/structure/sign/traffic/central,/turf/floor/grass{name = "pitch"},/area/caribbean/football/midfield)
"aD" = (/obj/structure/sign/traffic/central,/turf/floor/grass{name = "pitch"},/area/caribbean/football/red)
"aE" = (/obj/structure/sign/traffic/central,/obj/structure/sign/traffic/central{dir = 8; icon_state = "centralline"},/turf/floor/grass{name = "pitch"},/area/caribbean/football/red/goalkeeper)
"aF" = (/obj/structure/sign/traffic/central{dir = 4; icon_state = "centralline"},/obj/effect/step_trigger/goal/red,/turf/floor/grass{name = "pitch"},/area/caribbean/football/blue/score)
"aG" = (/obj/structure/sign/traffic/central{dir = 1; icon_state = "centralline"},/obj/structure/sign/traffic/central{dir = 4; icon_state = "centralline"},/turf/floor/grass{name = "pitch"},/area/caribbean/football/blue/goalkeeper)
"aH" = (/obj/structure/sign/traffic/central,/obj/structure/sign/traffic/central{dir = 4; icon_state = "centralline"},/turf/floor/grass{name = "pitch"},/area/caribbean/football/blue/goalkeeper)
"aI" = (/obj/structure/sign/traffic/central,/obj/structure/sign/traffic/central{dir = 4; icon_state = "centralline"},/turf/floor/grass{name = "pitch"},/area/caribbean/football/blue)
"aJ" = (/obj/structure/sign/traffic/central{dir = 4; icon_state = "centralline"},/obj/structure/sign/traffic/central{dir = 1; icon_state = "centralline"},/obj/structure/sign/traffic/central{dir = 8; icon_state = "centralline"},/turf/floor/grass{name = "pitch"},/area/caribbean/football/midfield)
"aK" = (/obj/structure/sign/traffic/central{dir = 8; icon_state = "centralline"},/obj/structure/sign/traffic/central{dir = 1; icon_state = "centralline"},/obj/structure/sign/traffic/central{dir = 4; icon_state = "centralline"},/turf/floor/grass{name = "pitch"},/area/caribbean/football/midfield)
"aL" = (/obj/structure/sign/traffic/central{dir = 4; icon_state = "centralline"},/obj/structure/sign/traffic/central{dir = 1; icon_state = "centralline"},/turf/floor/grass{name = "pitch"},/area/caribbean/football/red)
"aM" = (/obj/structure/sign/traffic/central,/obj/structure/sign/traffic/central{dir = 4; icon_state = "centralline"},/turf/floor/grass{name = "pitch"},/area/caribbean/football/midfield)
"aN" = (/turf/floor/grass{name = "pitch"},/area/caribbean/football/red/goalkeeper)
"aO" = (/obj/structure/sign/traffic/central{dir = 4; icon_state = "centralline"},/turf/floor/grass{name = "pitch"},/area/caribbean/football/blue/goalkeeper)
"aP" = (/obj/structure/sign/traffic/central{dir = 8; icon_state = "centralline"},/obj/structure/sign/traffic/central{dir = 4; icon_state = "centralline"},/obj/structure/sign/traffic/central{dir = 1; icon_state = "centralline"},/turf/floor/grass{name = "pitch"},/area/caribbean/football/blue)
"aQ" = (/obj/structure/sign/traffic/central{dir = 8; icon_state = "centralline"},/turf/floor/grass{name = "pitch"},/area/caribbean/football)
"aR" = (/obj/structure/sign/traffic/central{dir = 4; icon_state = "centralline"},/obj/structure/sign/traffic/central,/turf/floor/grass{name = "pitch"},/area/caribbean/football/red)
"aS" = (/obj/structure/sign/traffic/central{dir = 4; icon_state = "centralline"},/obj/structure/sign/traffic/central,/obj/structure/sign/traffic/central{dir = 1; icon_state = "centralline"},/turf/floor/grass{name = "pitch"},/area/caribbean/football/blue)
"aT" = (/obj/structure/sign/traffic/central{dir = 4; icon_state = "centralline"},/turf/floor/grass{name = "pitch"},/area/caribbean/football/blue)
"aU" = (/obj/structure/sign/traffic/central,/obj/structure/sign/traffic/central{dir = 1; icon_state = "centralline"},/obj/structure/sign/traffic/central{dir = 8; icon_state = "centralline"},/turf/floor/grass{name = "pitch"},/area/caribbean/football/midfield)
"aW" = (/turf/floor/grass{name = "pitch"},/area/caribbean/football/midfield)
"aX" = (/obj/structure/sign/traffic/central{dir = 8; icon_state = "centralline"},/obj/structure/sign/traffic/central,/turf/floor/grass{name = "pitch"},/area/caribbean/football/midfield)
"aY" = (/obj/structure/sign/traffic/central{dir = 8; icon_state = "centralline"},/obj/structure/sign/traffic/central{dir = 4; icon_state = "centralline"},/obj/structure/sign/traffic/central,/turf/floor/grass{name = "pitch"},/area/caribbean/football/blue)
"ba" = (/obj/structure/sign/traffic/central{dir = 8; icon_state = "centralline"},/turf/floor/grass{name = "pitch"},/area/caribbean/football/midfield)
"bb" = (/obj/structure/sign/traffic/central,/obj/structure/sign/traffic/central{dir = 4; icon_state = "centralline"},/turf/floor/grass{name = "pitch"},/area/caribbean/football/red)
"bc" = (/obj/structure/sign/traffic/central{dir = 1; icon_state = "centralline"},/obj/structure/sign/traffic/central{dir = 4; icon_state = "centralline"},/turf/floor/grass{name = "pitch"},/area/caribbean/football/blue)
"bd" = (/obj/structure/sign/traffic/central{dir = 4; icon_state = "centralline"},/obj/structure/sign/traffic/central,/obj/structure/sign/traffic/central{dir = 8; icon_state = "centralline"},/turf/floor/grass{name = "pitch"},/area/caribbean/football/midfield)
"be" = (/obj/structure/sign/traffic/central{dir = 8; icon_state = "centralline"},/obj/structure/sign/traffic/central{dir = 1; icon_state = "centralline"},/turf/floor/grass{name = "pitch"},/area/caribbean/football/blue/goalkeeper)
"bf" = (/obj/structure/sign/traffic/central{dir = 4; icon_state = "centralline"},/obj/structure/sign/traffic/central{dir = 1; icon_state = "centralline"},/turf/floor/grass{name = "pitch"},/area/caribbean/football/midfield)
"bg" = (/obj/structure/sign/traffic/central{dir = 8; icon_state = "centralline"},/obj/structure/sign/traffic/central,/obj/structure/sign/traffic/central{dir = 1; icon_state = "centralline"},/obj/structure/sign/traffic/central{dir = 4; icon_state = "centralline"},/obj/effect/landmark{name = "JoinLateCivB"},/turf/floor/grass{name = "pitch"},/area/caribbean/football/blue)
"bh" = (/obj/structure/sign/traffic/central,/obj/structure/sign/traffic/central{dir = 8; icon_state = "centralline"},/turf/floor/grass{name = "pitch"},/area/caribbean/football/blue)
"bi" = (/obj/structure/sign/traffic/central{dir = 1; icon_state = "centralline"},/turf/floor/grass{name = "pitch"},/area/caribbean/football/blue/goalkeeper)
"bj" = (/obj/structure/sign/traffic/central{dir = 1; icon_state = "centralline"},/turf/floor/grass{name = "pitch"},/area/caribbean/football)
"bk" = (/obj/structure/sign/traffic/central{dir = 1; icon_state = "centralline"},/turf/floor/grass{name = "pitch"},/area/caribbean/football/nopass)
"bl" = (/obj/map_metadata/football,/turf/floor/dirt,/area/caribbean/football)
"bm" = (/obj/structure/sign/traffic/central{dir = 4; icon_state = "centralline"},/obj/structure/banner/faction/team/team2,/obj/structure/grille/fence/picket/goalpost{dir = 1},/turf/floor/grass{name = "pitch"},/area/caribbean/football)
"bn" = (/obj/structure/sign/traffic/central{dir = 1; icon_state = "centralline"},/turf/floor/grass{name = "pitch"},/area/caribbean/football/red/goalkeeper)
"bo" = (/obj/structure/sign/traffic/central{dir = 1; icon_state = "centralline"},/obj/structure/sign/traffic/central{dir = 4; icon_state = "centralline"},/turf/floor/grass{name = "pitch"},/area/caribbean/football/red/goalkeeper)
"bq" = (/obj/structure/sign/traffic/central{dir = 4; icon_state = "centralline"},/turf/floor/grass{name = "pitch"},/area/caribbean/football/red/goalkeeper)
"cb" = (/obj/structure/sign/traffic/central{dir = 1; icon_state = "centralline"},/obj/structure/sign/traffic/central{dir = 8; icon_state = "centralline"},/turf/floor/grass{name = "pitch"},/area/caribbean/football/red)
"id" = (/obj/structure/sign/traffic/central,/turf/floor/grass{name = "pitch"},/area/caribbean/football/blue/goalkeeper)
"jt" = (/obj/structure/sign/traffic/central,/obj/structure/sign/traffic/central{dir = 1; icon_state = "centralline"},/obj/structure/sign/traffic/central{dir = 4; icon_state = "centralline"},/turf/floor/grass{name = "pitch"},/area/caribbean/football/midfield)
"mn" = (/obj/structure/sign/traffic/central{dir = 4; icon_state = "centralline"},/obj/structure/sign/traffic/central{dir = 8; icon_state = "centralline"},/obj/structure/sign/traffic/central,/turf/floor/grass{name = "pitch"},/area/caribbean/football/red)
"os" = (/obj/structure/sign/traffic/central{dir = 8; icon_state = "centralline"},/obj/structure/sign/traffic/central{dir = 1; icon_state = "centralline"},/turf/floor/grass{name = "pitch"},/area/caribbean/football/midfield)
"qx" = (/obj/structure/sign/traffic/central,/obj/structure/sign/traffic/central{dir = 4; icon_state = "centralline"},/obj/structure/sign/traffic/central{dir = 1; icon_state = "centralline"},/obj/structure/sign/traffic/central{dir = 8; icon_state = "centralline"},/obj/effect/landmark{icon_state = "x1"; name = "JoinLateCivA"},/turf/floor/grass{name = "pitch"},/area/caribbean/football/red)
"qB" = (/obj/structure/sign/traffic/central,/obj/structure/sign/traffic/central{dir = 8; icon_state = "centralline"},/turf/floor/grass{name = "pitch"},/area/caribbean/football/red)
"qD" = (/obj/structure/submitter,/turf/floor/dirt,/area/caribbean/football/nopass)
"ts" = (/obj/structure/sign/traffic/central{dir = 4; icon_state = "centralline"},/obj/item/football,/obj/effect/landmark{name = "football"},/turf/floor/grass{name = "pitch"},/area/caribbean/football/midfield)
"wu" = (/obj/structure/grille/fence/picket/goalpost{dir = 8},/turf/floor/dirt,/area/caribbean/football)
"xL" = (/obj/structure/sign/traffic/central{dir = 8; icon_state = "centralline"},/obj/structure/banner/faction/team/team1,/obj/structure/grille/fence/picket/goalpost{dir = 1},/turf/floor/grass{name = "pitch"},/area/caribbean/football)
"yP" = (/obj/structure/sign/traffic/central{dir = 1; icon_state = "centralline"},/obj/structure/banner/faction/team/team2,/turf/floor/grass{name = "pitch"},/area/caribbean/football)
"zk" = (/obj/structure/grille/fence/picket/goalpost{dir = 10},/turf/floor/dirt,/area/caribbean/football)
"Bq" = (/obj/structure/sign/traffic/central,/turf/floor/grass{name = "pitch"},/area/caribbean/football/red/goalkeeper)
"Bz" = (/obj/structure/sign/traffic/central{dir = 8; icon_state = "centralline"},/obj/effect/step_trigger/goal/blue,/turf/floor/grass{name = "pitch"},/area/caribbean/football/red/score)
"Es" = (/obj/structure/grille/fence/picket/goalpost{dir = 5},/turf/floor/dirt,/area/caribbean/football)
"Fj" = (/obj/structure/sign/traffic/central{dir = 8; icon_state = "centralline"},/obj/structure/banner/faction/team/team1,/obj/structure/grille/fence/picket/goalpost,/turf/floor/grass{name = "pitch"},/area/caribbean/football)
"LW" = (/obj/structure/sign/traffic/central,/obj/structure/sign/traffic/central{dir = 8; icon_state = "centralline"},/turf/floor/grass{name = "pitch"},/area/caribbean/football/midfield)
"NU" = (/obj/structure/sign/traffic/central{dir = 4; icon_state = "centralline"},/obj/structure/sign/traffic/central{dir = 8; icon_state = "centralline"},/obj/structure/sign/traffic/central{dir = 1; icon_state = "centralline"},/turf/floor/grass{name = "pitch"},/area/caribbean/football/red)
"NW" = (/obj/structure/sign/traffic/central{dir = 8; icon_state = "centralline"},/obj/structure/sign/traffic/central,/turf/floor/grass{name = "pitch"},/area/caribbean/football/blue/goalkeeper)
"ON" = (/obj/structure/sign/traffic/central{dir = 8; icon_state = "centralline"},/turf/floor/grass{name = "pitch"},/area/caribbean/football/red/goalkeeper)
"Pu" = (/obj/structure/sign/traffic/central{dir = 8; icon_state = "centralline"},/obj/structure/sign/traffic/central,/obj/structure/sign/traffic/central{dir = 4; icon_state = "centralline"},/turf/floor/grass{name = "pitch"},/area/caribbean/football/midfield)
"QM" = (/turf/floor/grass{name = "pitch"},/area/caribbean/football/blue/goalkeeper)
"Re" = (/obj/structure/sign/traffic/central,/obj/structure/sign/traffic/central{dir = 4; icon_state = "centralline"},/turf/floor/grass{name = "pitch"},/area/caribbean/football/red/goalkeeper)
"SD" = (/obj/structure/sign/traffic/central{dir = 8; icon_state = "centralline"},/turf/floor/grass{name = "pitch"},/area/caribbean/football/blue/goalkeeper)
"SY" = (/obj/structure/sign/traffic/central{dir = 8; icon_state = "centralline"},/obj/structure/sign/traffic/central,/obj/structure/sign/traffic/central{dir = 1; icon_state = "centralline"},/turf/floor/grass{name = "pitch"},/area/caribbean/football/red)
"Tp" = (/obj/structure/sign/traffic/central{dir = 1; icon_state = "centralline"},/obj/structure/sign/traffic/central{dir = 4; icon_state = "centralline"},/turf/floor/grass{name = "pitch"},/area/caribbean/football/red)
"TO" = (/obj/structure/sign/traffic/central{dir = 8; icon_state = "centralline"},/obj/effect/landmark{name = "football"},/turf/floor/grass{name = "pitch"},/area/caribbean/football/midfield)
"VU" = (/obj/structure/grille/fence/picket/goalpost{dir = 4},/turf/floor/dirt,/area/caribbean/football)
"WM" = (/obj/structure/grille/fence/picket/goalpost{dir = 6},/turf/floor/dirt,/area/caribbean/football)
"Xw" = (/obj/structure/sign/traffic/central{dir = 4; icon_state = "centralline"},/obj/structure/banner/faction/team/team2,/obj/structure/grille/fence/picket/goalpost,/turf/floor/grass{name = "pitch"},/area/caribbean/football)
"Yx" = (/obj/structure/sign/traffic/central{dir = 8; icon_state = "centralline"},/turf/floor/grass{name = "pitch"},/area/caribbean/football/red)
"YA" = (/obj/structure/sign/traffic/central{dir = 1; icon_state = "centralline"},/obj/structure/banner/faction/team/team1,/turf/floor/grass{name = "pitch"},/area/caribbean/football)

(1,1,1) = {"
ababababababababababababababababababababababababababababababababababababababababababababab
ababababababababababababababababababababababababababababababababababababababababababababab
ababababababababababababababababababababababababababababababababababababababababababababab
ababababababababababababababababababababababababababababababababababababababababababababab
ababababababababababababababababababababababababababababababababababababababababababababab
ababababababababababababababababababababababababababababababababababababababababababababab
ababababababababababababababababababababababababababababababababababababababababababababab
ababababababababababababababababababababababababababababababababababababababababababababab
ababababababababababababababababababababababababababababababababababababababababababababab
ababababababababababababababababababababababababababababababababababababababababababababab
ababacacacacacacacacacacacacacacacacacqDqDacacacacacacacacacacacacacacacacacacabababababab
ababacacacacacacacacacacacacacacacacacadadacacacacacacacacacacacacacacacacacacabababababab
ababacacaeafafafafafafafafafafafafafapagagaqafafafafafafafafafafafafafaBacacacabababababab
ababacacahaiajakakakakakakakakakakakakamatananananananananananananTpawaQacacacabababababab
ababacacaharasasasasasasasasasasasasasaubaavavavavavavavavavavavavavaLaQacacacabababababab
ababacacahaxasasasasasasasasasasasasasaubaavavavavavavavavavavavavavayaQacacacabababababab
ababacacahaxasasasasasasasasasasasasasaubaavavavavavavavavavavavavavayaQacacacabababababab
ababacacahazaAaAasasasasasasasasasasasaCaXavavavavavavavavavavavaDaDbbaQacacacabababababab
ababacaabmbebiaGazasasasasasasasasasaIaJaKqBavavavavavavavavavaRaobnboxLEsacacabababababab
ababacwuaFSDQMaOaPazasasasasasasasaIataubaamqBavavavavavavavaRNUONaNbqBzVUacacabababababab
ababacwuaFSDQMaOaxaSaxasasasasasaTaUaWtsTOaWjtYxavavavavavaySYayONaNbqBzVUacacabababababab
ababacwuaFSDQMaOaYarasasasasasasasbcLWaubaaMcbavavavavavavavaLmnONaNbqBzVUacacabababababab
ababaczkXwNWidaHarasasasasasasasasasbcbdPucbavavavavavavavavavaLaEBqReFjWMacacabababababab
ababacacaharakakasasasasasasasasasasasbfosavavavavavavavavavavavananTpaQacacacabababababab
ababacacahaxasasasasasasasasasasasasasaubaavavavavavavavavavavavavavayaQacacacabababababab
ababacacahaxasasasasasasasasasasasasasaubaavavavavavavavavavavavavavayaQacacacabababababab
ababacacahazasasasasasasasasasasasasasaubaavavavavavavavavavavavavavaRaQacacacabababababab
ababacacahbgbhaAaAaAaAaAaAaAaAaAaAaAaAaMLWaDaDaDaDaDaDaDaDaDaDaDaDbbqxaQacacacabababababab
ababacacaebjbjbjbjbjbjbjbjbjbjbjbjbjyPbkbkYAbjbjbjbjbjbjbjbjbjbjbjbjbjaBacacacabababababab
ababacacacacacacacacacacacacacacacacacadadacacacacacacacacacacacacacacacacacacabababababab
ababblacacacacacacacacacacacacacacacacadadacacacacacacacacacacacacacacacacacacabababababab
ababababababababababababababababababababababababababababababababababababababababababababab
ababababababababababababababababababababababababababababababababababababababababababababab
ababababababababababababababababababababababababababababababababababababababababababababab
ababababababababababababababababababababababababababababababababababababababababababababab
"}
