"a" = (/turf/floor/dirt/winter,/area/caribbean/russian/land/outside)
"b" = (/turf/floor/winter/grass,/area/caribbean/russian/land/outside)
"c" = (/turf/floor/winter/grass,/area/caribbean/no_mans_land/invisible_wall)
"d" = (/turf/floor/winter/grass,/area/caribbean)
"e" = (/turf/floor/winter/grass,/area/caribbean/no_mans_land)
"f" = (/turf/floor/winter/grass,/area/caribbean/japanese/land)
"g" = (/obj/effect/landmark{icon_state = "x3"; name = "JoinLateRU"},/turf/floor/dirt/winter,/area/caribbean/russian/land/outside)
"h" = (/obj/effect/area_teleporter{name = "russian base"},/turf/floor/winter/grass,/area/caribbean/russian/land/outside)
"i" = (/obj/structure/window/classic,/turf/floor/wood,/area/caribbean/japanese/land/inside)
"j" = (/obj/structure/vending/japaneseapparel,/turf/floor/wood,/area/caribbean/japanese/land/inside)
"k" = (/obj/structure/vending/japweapons,/turf/floor/wood,/area/caribbean/japanese/land/inside)
"l" = (/turf/floor/wood,/area/caribbean/japanese/land/inside)
"m" = (/turf/floor/dirt/winter,/area/caribbean/japanese/land)
"n" = (/turf/wall/wood/low,/area/caribbean/japanese/land/inside)
"o" = (/obj/structure/sink/well,/turf/floor/winter/grass,/area/caribbean/japanese/land)
"p" = (/obj/structure/flag/japanese,/turf/floor/dirt/winter,/area/caribbean/japanese/land)
"q" = (/obj/structure/table/wood,/turf/floor/wood,/area/caribbean/japanese/land/inside)
"r" = (/obj/structure/filingcabinet/chestdrawer,/turf/floor/wood,/area/caribbean/japanese/land/inside)
"s" = (/obj/structure/filingcabinet/filingcabinet,/turf/floor/wood,/area/caribbean/japanese/land/inside)
"t" = (/obj/effect/area_teleporter{name = "no man's land"},/turf/floor/winter/grass,/area/caribbean/no_mans_land)
"u" = (/turf/floor/winter/grass,/area/caribbean/japanese/land/outside)
"v" = (/obj/structure/simple_door/key_door/japanese,/turf/floor/wood,/area/caribbean/japanese/land/inside)
"w" = (/obj/effect/area_teleporter{name = "japanese base"},/turf/floor/winter/grass,/area/caribbean/japanese/land)
"x" = (/obj/map_metadata/hill203,/turf/floor/dirt/winter,/area/caribbean/japanese/land)
"y" = (/obj/structure/flag/japanese,/turf/floor/winter/grass,/area/caribbean/japanese/land/outside)
"z" = (/turf/floor/dirt/winter,/area/caribbean/japanese/land/outside)
"A" = (/obj/effect/landmark{icon_state = "x3"; name = "JoinLateJP"},/turf/floor/wood,/area/caribbean/japanese/land/inside)
"B" = (/obj/effect/landmark{icon_state = "x3"; name = "JoinLateJPCap"},/turf/floor/wood,/area/caribbean/japanese/land/inside)
"C" = (/turf/wall/wood/low,/area/caribbean/russian/land/outside)
"D" = (/obj/effect/landmark{icon_state = "x3"; name = "JoinLateJP"},/turf/floor/dirt/winter,/area/caribbean/japanese/land/outside)
"E" = (/obj/item/weapon/gun/projectile/automatic/stationary/maximstat{dir = 1},/turf/floor/winter/grass,/area/caribbean/japanese/land/outside)
"F" = (/obj/structure/vending/russianapparel,/turf/floor/wood,/area/caribbean/russian/land/outside)
"G" = (/obj/structure/vending/rusweapons,/turf/floor/wood,/area/caribbean/russian/land/outside)
"H" = (/turf/floor/wood,/area/caribbean/russian/land/outside)
"I" = (/obj/effect/landmark{icon_state = "x3"; name = "JoinLateRU"},/turf/floor/wood,/area/caribbean/russian/land/outside)
"J" = (/obj/structure/flag/russian,/turf/floor/dirt/winter,/area/caribbean/russian/land/outside)
"K" = (/obj/structure/window/classic,/turf/floor/wood,/area/caribbean/russian/land/outside)
"L" = (/obj/structure/flag/russian,/turf/floor/winter/grass,/area/caribbean/russian/land/outside)
"M" = (/mob/living/carbon/human/corpse/jap_sashsoldier,/turf/floor/winter/grass,/area/caribbean/russian/land/outside)
"N" = (/mob/living/carbon/human/corpse/jap_sashsoldier,/turf/floor/winter/grass,/area/caribbean/no_mans_land/invisible_wall)
"O" = (/mob/living/carbon/human/corpse/jap_sashsoldier,/turf/floor/winter/grass,/area/caribbean)
"P" = (/mob/living/carbon/human/corpse/jap_sashsoldier,/turf/floor/winter/grass,/area/caribbean/no_mans_land)
"Q" = (/turf/floor/plating/snow,/area/caribbean/japanese/land/outside)

(1,1,1) = {"
abbbbbbbbbbbbbbbbbbbCCCCCCCbbbbbbbbbbbbbbbbbbbbbba
agaabbbbbbbbbbbbbbbCFGHHHGFCbbbbbbbbbbbbbbbbbbbaaa
aaaaaaaaaaaaaaaaaabCHHHHHHHCaaaaaaabbbbbbbbbbaaaaa
aaaaaaaaaaaaaaaaaaaHHHHHHHHCaaaaaaaaaaaaabbaaaaaaa
aaaaaaaaaaaaaaaaaaaCHHHHHHHCaaaaaaaaagaaaaaaaaaaaa
aaaaaaaaaaaaaaaaaaaCHHHHHHHCaaaaaaaaaaaaaaaaaaaaaa
aaaaaaaaaaaaaaaaaaaCIHHHHHHChbbbbaaaaaaaaaaabbbaaa
aaaaaaaaaaaaaaaaaaaJCCKCCKCLbbbbbbbbbbbbbbbbbbbbba
aaaaaaaaaaaaaaaaaabbbbbbbbbbbbbbbbbbbbbbbbbbbbbbbb
aaaaaaabbbbbbbbbbbbbbbbbbbbbbbbbbbbbbbbbbbbbbbbbbb
aaaaaabbbbbbbbbbbbbbbbbbbbbbbbbbbbbbbbbbbbbbbbbbbb
aaaaabbbbbbbbbbbbbbbbbbbbbbbbbbbbbbbbbbbbbbbbbbbbb
aaabbbbbbbbbbbbbbbbbbbbbbbbbbbbbbbbbbbbbbbbbbbbbbb
abbbbbbbbbbbbbbbbbbbbbbbbbbbbbbbbbbbbbbbLbbbbbbbbb
bbbbbbbbbMbbLbbbbbbbbbbbbbbbbbbbbbbbbbbbbbbMbbbbbb
MbbbbbbbbMbbbbbbbbbbbbbbbbbbbbbbbMbbbbbbbbbbbbbbbb
cccccccccNccccccccccccccccccccccccccccccccccccccNc
dddddOdddddddddddddddddddddddddddddOdddddddddddddd
dddddddddddddddddddddddddddddddddddOdddddddddddddd
ddddddddddddOddddOddddddddddddddddddddOddddOdddddd
ddOddOdddddddddddddddddddOdddOOddddddddddddddOdddd
ddddddddddddddddddddddddddddddddddddddddOddddddddd
ePeeeeeePeeeeeeeeeeeeeeeeeeeeeeeeeeeeeeeeeeeeeeeee
eeeeeeeeeeeeeeeeeeeeeeeeeeeeeePeeeeeeeeeeeeeeeeeee
eeeeeeeeeeePeeeeePeeeeeeeeeeeeeeeePeeeeeeeeeeeeeee
eeeeeeeeeeeeeeeeeeeeePeeeeeePeeeeeeeeeeeeePeeeeePe
eeeeeePeeeeeeeeeeeeeeeeeeeeeeeeeeeeeeePeeeeeeeeeee
eeeeeeeeeeeeeeeeeeeeeePeeeeeeeeeeeeeeeeeeeeeeeeeee
eeeeeeeeeeeeeeeeeeeeeeeeeeeeeePeeeeeeeeeeeeeeeeeee
eePeeeePeeeeeeePteeeeeeeeeeeeeeeeeeeeeeeeeeeeeeeeP
eeeeeeeeeeeeeeeeeeeeeeeeeeeeeeeeeeeeeeeeeeeeeeeeee
eeeeeeeeeeeeeeeeeeeeeeeeeeeeeeeeeeeeeeeeeeeeeeeeee
eeeeeeeeeeeeeeeeeeeeeeeeeeeeeeeeeeeeeeeeeeeeeeeeee
eeeeeeeeeeeeeeeeeeeeeeeeeeeeeeeeeeeeeeeeeeeeeeeeee
eeeeeeeeeeeeeeeeeeeeeeeeeeeeeeeeeeeeeeeeeeeeeeeeee
dddddddddddddddddddddddddddddddddddddddddddddddddd
dddddddddddddddddddddddddddddddddddddddddddddddddd
dddddddddddddddddddddddddddddddddddddddddddddddddd
cccccccccccccccccccccccccccccccccccccccccccccccccc
fffffffffffffffffuuuuuuuuuuuuuuuuuuuuuufffffffffff
fffffwfffffffffffuuuuuuuuuuuuuuuuuuuuuufffffffffff
fffuuuuuuuuuuuuEuuuuuuynninnninnyuuuuuufffffffffff
fffuuuuuuuuuuuuuuuuuuunjkljkjlkjnuuuuuufffffffffff
mffuuuuyninnuuuuuuuuuunlllllllllnuuuuuufoffffmpmmm
mmmzuuunqqrsnzzzzzzzzznlllllllllnuuuuuufmmmmmmmmmm
mmmzzuunqlllnzzzzzzzzznlllAAAlllnuuzzzzmmmmmmmmmmm
mmmzzzznBlllnzzzzzzzzznlllllllllnQzzzzzmmmmmmmmmmm
mmmzzzzznvnnzzzzzDzzzznAlllllllAnQzzzzDmmmmmmmmmmm
mmmzzzzzzzzzzuuzzzzzzzznnnnlnnnnzzzzuuufffmmmmmmmm
xmmzzuuuuuuuuuuuuuzzzzzuuuuuuuuuuuuuuuuffffffmmmmm
"}
