"a" = (/turf/floor/plating/cobblestone/vertical,/area/caribbean)
"b" = (/obj/covers/cement_wall,/turf/floor/plating/cobblestone/vertical,/area/caribbean)
"c" = (/obj/covers/brick_wall,/turf/floor/plating/cobblestone/vertical,/area/caribbean)
"d" = (/obj/effect/floor_decal/industrial/warning{icon_state = "warning"; dir = 4},/turf/floor/plating/cobblestone/vertical,/area/caribbean)
"e" = (/obj/structure/window/barrier/concrete{icon_state = "concrete"; dir = 8; step_x = 4},/obj/structure/barbwire{dir = 8},/turf/floor/plating/cobblestone/vertical,/area/caribbean)
"f" = (/obj/structure/post_execution,/turf/floor/plating/cobblestone/vertical,/area/caribbean)
"g" = (/obj/covers/cement_wall,/obj/structure/sign/medal,/turf/floor/wood,/area/caribbean)
"h" = (/obj/structure/table/modern,/obj/covers/jail/steeljail,/turf/floor/wood,/area/caribbean)
"i" = (/obj/covers/cement_wall,/turf/floor/wood,/area/caribbean)
"j" = (/turf/floor/wood,/area/caribbean)
"k" = (/obj/effect/floor_decal/industrial/hatch,/turf/floor/plating/cobblestone/vertical,/area/caribbean)
"l" = (/obj/structure/gate/blast,/turf/floor/wood,/area/caribbean)
"m" = (/obj/structure/table/modern,/obj/covers/jail/steeljail{icon = 'icons/obj/structures.dmi'; icon_state = "bars_bank"},/turf/floor/wood,/area/caribbean)
"n" = (/turf/floor/plating/road,/area/caribbean)
"o" = (/obj/structure/metal_detector,/turf/floor/wood,/area/caribbean)
"p" = (/turf/floor/plating/road/yellowline{icon_state = "road_yellowline"; dir = 4},/area/caribbean)
"q" = (/obj/structure/table/modern,/obj/structure/gatecontrol/blastcontrol{step_y = 8},/obj/structure/gatecontrol/blastcontrol{step_y = 0},/obj/structure/lamp/lamp_big/alwayson{dir = 1},/turf/floor/wood,/area/caribbean)
"r" = (/obj/structure/lamp/lamp_small/alwayson{dir = 4},/turf/floor/plating/cobblestone/vertical,/area/caribbean)
"s" = (/obj/structure/simple_door/key_door/soviet,/turf/floor/wood,/area/caribbean)
"t" = (/turf/floor/plating/road/yellowline{icon_state = "road_yellowline"; dir = 8},/area/caribbean)
"v" = (/obj/structure/lamp/lamp_big/alwayson{dir = 8},/turf/floor/wood,/area/caribbean)
"C" = (/obj/effect/floor_decal/industrial/warning{dir = 8},/turf/floor/plating/cobblestone/vertical,/area/caribbean)
"E" = (/obj/structure/closet/safe,/obj/item/weapon/gun/projectile/boltaction/mosin,/obj/item/ammo_magazine/mosin,/obj/item/ammo_magazine/mosin,/obj/item/ammo_magazine/mosin,/obj/item/weapon/attachment/scope/adjustable/sniper_scope,/obj/structure/lamp/lamp_big/alwayson,/turf/floor/wood,/area/caribbean)
"H" = (/obj/structure/window/classic/metal,/obj/covers/jail/steeljail,/turf/floor/wood,/area/caribbean)
"J" = (/obj/structure/lamp/lamp_big/alwayson{dir = 1},/turf/floor/wood,/area/caribbean)
"S" = (/obj/structure/lamp/lamp_big/alwayson{dir = 4},/turf/floor/wood,/area/caribbean)
"W" = (/obj/effect/floor_decal/industrial/hatch,/obj/structure/lamp/lamp_small/alwayson{dir = 4; pixel_x = 4},/turf/floor/plating/cobblestone/vertical,/area/caribbean)
"X" = (/obj/structure/lamp/lamp_big/alwayson,/turf/floor/wood,/area/caribbean)

(1,1,1) = {"
aaaaaaaaaaaaaaaaaaaaaaaaaaaaaaaaaaaaaaaaaaaaaaaaaaaaaaaaaaaaaaaaaaaaaaaaaaaaaaaaaaaaaaaaaaaaaaaaaaaaaaaannnnnnnnnnaaaaaaaaaaaaaaaa
aaaaaaaaaaaaaaaaaaaaaaaaaaaaaaaaaaaaaaaaaaaaaaaaaaaaaaaaaaaaaaaaaaaaaaaaaaaaaaaaaaaaaaaaaaaaaaaaaaaaaaaannnnnnnnnnaaaaaaaaaaaaaaaa
aaaaaaaaaaaaaaaaaaaaaaaaaaaaaaaaaaaaaaaaaaaaaaaaaaaaaaaaaaaaaaaaaaaaaaaaaaaaaaaaaaaaaaaaaaaaaaaaaaaaaaaannnnptnnnnaaaaaaaaaaaaaaaa
aaaaaaaaaaaaaaaaaaaaaaaaaaaaaaaaaaaaaaaaaaaaaaaaaaaaaaaaaaaaaaaaaaaaaaaaaaaaaaaaaaaaaaaaaaaaaaaaaaaaaaaannnnptnnnnaaaaaaaaaaaaaaaa
aaaaaaaaaaaaaaaaaaaaaaaaaaaaaaaaaaaaaaaaaaaaaaaaaaaaaaaaaaaaaaaaaaaaaaaaaaaaaaaaaaaaaaaaaaaaaaaaaaaaaaaannnnptnnnnaaaaaaaaaaaaaaaa
aaaaaaaaaaaaaaaaaaaaaaaaaaaaaaaaaaaaaaaaaaaaaaaaaaaaaaaaaaaaaaaaaaaaaaaaaaaaaaaaaaaaaaaaaaaaaaaaaaaaaaaannnnnnnnnnaaaaaaaaaaaaaaaa
aaaaaaaaaaaaaaaaaaaaaaaaaaaaaaaaaaaaaaaaaaaaaaaaaaaaaaaaaaaaaaaaaaaaaaaaaaaaaaaaaaaaaaaaaaaaaaaaaaaaaaaannnnnnnnnnaaaaaaaaaaaaaaaa
aaaaaaaaaaaaaaaaaaaaaaaaaaaaaaaaaaaaaaaaaaaaaaaaaaaaaaaaaaaaaaaaaaaaaaaaaaaaaaaaaaaaaaaaaaaaaaaaaaaaaaaannnnptnnnnaaaaaaaaaaaaaaaa
aaaaaaaaaaaaaaaaaaaaaaaaaaaaaaaaaaaaaaaaaaaaaaaaaaaaaaaaaaaaaaaaaaaaaaaaaaaaaaaaaaaaaaaaaaaaaaaaaaaaaaaannnnptnnnnaaaaaaaaaaaaaaaa
aaaaaaaaaaaaaaaaaaaaaaaaaaaaaaaaaaaaaaaaaaaaaaaaaaaaaaaaaaaaaaaaaaaaaaaaaaaaaaaaaaaaaaaaaaaaaaaaaaaaaaaannnnptnnnnaaaaaaaaaaaaaaaa
cccccccccccccccccccccccccccccccccccccccccccccaaabbbbbbbbbbbbbbbbbbbbbbbbbbbbbbbbbbbbbbbbbbbbbbbbbbbbaaaannnnnnnnnnaaaaaaaaaaaaaaaa
cccccccccccccccccccccccccccccccccccccccccccccaaabbbbbbbbbbbbbbbbbbbbbbbbbbbbbbbbbbbbbbbbbbbbbbbbbbbbaaaannnnnnnnnnaaaaaaaaaaaaaaaa
cccccccccccccccccccccccccccccccccccccccccccccaaabbbbbbbbbbbbbbbbbbbbbbbbbbbbbbbbbbbbbbbbbbbbbbbbbbbbaaaannnnptnnnnaaaaaaaaaaaaaaaa
cccccccccccccccccccccccccccccccccccccccccccccaaabbbbbbbbbbbbbbbbbbbbbbbbbbbbbbbbbbbbbbbbbbbbbbbbbbbbaaaannnnptnnnnaaaaaaaaaaaaaaaa
cccccccccccccccccccccccccccccccccccccccccccccaaabbbbbbbbbbbbbbbbbbbbbbbbbbbbbbbbbbbbbbbbbbbbbbbbbbbbaaaannnnptnnnnaaaaaaaaaaaaaaaa
cccccccccccccccccccccccccccccccccccccccccccccaaabbbbbbbbbbbbbbbbbbbbbbbbbbbbbbbbbbbbbbbbbbbbbbbbbbbbaaaannnnnnnnnnaaaaaaaaaaaaaaaa
cccccccccccccccccccccccccccccccccccccccccccccaaabbbbbbbbbbbbbbbbbbbbbbbbbbbbbbbbbbbbbbbbbbbbbbbbbbbbaaaannnnnnnnnnaaaaaaaaaaaaaaaa
cccccccccccccccccccccccccccccccccccccccccccccaaabbbbbbbbbbbbbbbbbbbbbbbbbbbbbbbbbbbbbbbbbbbbbbbbbbbbaaaannnnptnnnnaaaaaaaaaaaaaaaa
cccccccccccccccccccccccccccccccccccccccccccccaaabbbbbbbbbbbbbbbbbbbbbbbbbbbbbbbbbbbbbbbbbbbbbbbbbbbbaaaannnnptnnnnaaaaaaaaaaaaaaaa
cccccccccccaaaaaaaaaaaaaaaaaaaaaaaaaaaaaaaaaaaaabbbbbbbbbbbbbbbbbbbbbbbbbbbbbbbbbbbbbbbbbbbbbbbbbbbbaaaannnnptnnnnaaaaaaaaaaaaaaaa
cccccccccccafaaaaaaaaaaaaaaaaaaaaaaaaaaaaaaaaaaabbbbbbbbbbbbbbbbbbbbbbbbbbbbbbbbbbbbbbbbbbbbbbbbbbbbaaaannnnnnnnnnaaaaaaaaaaaaaaaa
cccccccccccaaaaaaaaaaaaaaaaaaaaaaaaaaaaaaaaaaaaabbbbbbbbbbbbbbbbbbbbbbbbbbbbbbbbbbbbbbbbbbbbbbbbbbbbaaaannnnnnnnnnaaaaaaaaaaaaaaaa
cccccccccccccccccccccccccccccccccccccccccccccaaabbbbbbbbbbbbbbbbbbbbbbbbbbbbbbbbbbbbbbbbbbbbbbbbbbbbaaaannnnptnnnnaaaaaaaaaaaaaaaa
cccccccccccccccccccccccccccccccccccccccccccccaaabbbbbbbbbbbbbbbbbbbbbbbbbbbbbbbbbbbbbbbbbbbbbbbbbbbbaaaannnnptnnnnaaaaaaaaaaaaaaaa
cccccccccccccccccccccccccccccccccccccccccccccaaabbbbbbbbbbbbbbbbbbbbbbbbbbbbbbbbbbbbbbbbbbbbbbbbbbbbaaaannnnptnnnnaaaaaaaaaaaaaaaa
cccccccccccccccccccccccccccccccccccccccccccccaaabbbbbbbbbbbbbbbbbbbbbbbbbbbbbbbbbbbbbbbbbbbbbbbbbbbbaaaannnnnnnnnnaaaaaaaaaaaaaaaa
cccccccccccccccccccccccccccccccccccccccccccccaaabbbbbbbbbbbbbbbbbbbbbbbbbbbbbbbbbbbbbbbbbbbbbbbbbbbbaaaannnnnnnnnnaaaaaaaaaaaaaaaa
cccccccccccccccccccccccccccccccccccccccccccccaaabbbbbbbbbbbbbbbbbbbbbbbbbbbbbbbbbbbbbbbbbbbbbbbbbbbbaaaannnnptnnnnaaaaaaaaaaaaaaaa
cccccccccccccccccccccccccccccccccccccccccccccaaabbbbbbbbbbbbbbbbbbbbbbbbbbbbbbbbbbbbbbbbbbbbbbbbbbbbaaaannnnptnnnnaaaaaaaaaaaaaaaa
cccccccccccccccccccccccccccccccccccccccccccccaaabbbbbbbbbbbbbbbbbbbbbbbbbbbbbbbbbbbbbbbbbbbbbbbbbbbbaaaannnnptnnnnaaaaaaaaaaaaaaaa
cccccccccccccccccccccccccccccccccccccccccccccaaabbbbbbbbbbbbbbbbbbbbbbbbbbbbbbbbbbbbbbbbbbbbbbbbbbbbaaaannnnnnnnnnaaaaaaaaaaaaaaaa
cccccccccccccccccccccccccccccccccccccccccccccaaabbbbbbbbbbbbbbbbbbbbbbbbbbbbbbbbbbbbbbbbbbbbbbbbbbbbaaaannnnnnnnnnaaaaaaaaaaaaaaaa
cccccccccccccccccccccccccccccccccccccccccccccaaabbbbbbbbbbbbbbbbbbbbbbbbbbbbbbbbbbbbbbbbbbbbbbbbbbbbaaaannnnptnnnnaaaaaaaaaaaaaaaa
cccccccccccccccccccccccccccccccccccccccccccccaaabbbbbbbbbbbbbbbbbbbbbbbbbbbbbbbbbbbbbbbbbbbbbbbbbbbbaaaannnnptnnnnaaaaaaaaaaaaaaaa
cccccccccccccccccccccccccccccccccccccccccccccaaabbbbbbbbbbbbbbbbbbbbbbbbbbbbbbbbbbbbbbbbbbbbbbbbbbbbaaaannnnptnnnnaaaaaaaaaaaaaaaa
cccccccccccccccccccccccccccccccccccccccccccccaaabbbbbbbbbbbbbbbbbbbbbbbbbbbbbbbbbbbbbbbbbbbbbbbbbbbbaaaannnnnnnnnnaaaaaaaaaaaaaaaa
cccccccccccccccccccccccccccccccccccccccccccccaaabbbbbbbbbbbbbbbbbbbbbbbbbbbbbbbbbbbbbbbbbbbbbbbbbbbbaaaannnnnnnnnnaaaaaaaaaaaaaaaa
cccccccccccccccccccccccccccccccccccccccccccccaaabbbbbbbbbbbbbbbbbbbbbbbbbbbbbbbbbbbbbbbbbbbbbbbbbbbbaaaannnnptnnnnaaaaaaaaaaaaaaaa
cccccccccccccccccccccccccccccccccccccccccccccaaabbbbbbbbbbbbbbbbbbbbbbbbbbbbbbbbbbbbbbbbbbbbbbbbbbbbaaaannnnptnnnnaaaaaaaaaaaaaaaa
cccccccccccccccccccccccccccccccccccccccccccccaaabbbbbbbbbbbbbbbbbbbbbbbbbbbbbbbbbbbbbbbbbbbbbbbbbbbbaaaannnnptnnnnaaaaaaaaaaaaaaaa
cccccccccccccccccccccccccccccccccccccccccccccaaabbbbbbbbbbbbbbbbbbbbbbbbbbbbbbbbbbbbbbbbbbbbbbbbbbbbaaaannnnnnnnnnaaaaaaaaaaaaaaaa
cccccccccccccccccccccccccccccccccccccccccccccaaabbbbbbbbbbbbbbbbbbbbbbbbbbbbbbbbbbbbbbbbbbbbbbbbbbbbaaaannnnnnnnnnaaaaaaaaaaaaaaaa
cccccccccccccccccccccccccccccccccccccccccccccaaabbbbbbbbbbbbbbbbbbbbbbbbbbbbbbbbbbbbbbbbbbbbbbbbbbbbaaaannnnptnnnnaaaaaaaaaaaaaaaa
cccccccccccccccccccccccccccccccccccccccccccccaaabbbbbbbbbbbbbbbbbbbbbbbbbbbbbbbbbbbbbbbbbbbbbbbbbbbbaaaannnnptnnnnaaaaaaaaaaaaaaaa
cccccccccccccccccccccccccccccccccccccccccccccaaabbbbbbbbbbbbbbbbbbbbbbbbbbbbbbbbbbbbbbbbbbbbbbbbbbbbaaaannnnptnnnnaaaaaaaaaaaaaaaa
cccccccccccccccccccccccccccccccccccccccccccccaaabbbbbbbbbbbbbbbbbbbbbbbbbbbbbbbbbbbbbbbbbbbbbbbbbbbbaaaannnnnnnnnnaaaaaaaaaaaaaaaa
aaaaaaaaaaaaaaaaaaaaaaaaaaaaaaaaaaaaaaaaaaaaaaaaaadkkkkekkkkCaaaaaaaaaaaaaaaaaaaaaaaaaaaaaaaaaaaaaaaaaaannnnnnnnnnaaaaaaaaaaaaaaaa
aaaaaaaaaaaaaaaaaaaaaaaaaaaaaaaaaaaaaaaaaaaaaaaaaadkkkWekkkkCaaaaaaaaaaaaaaaaaaaaaaaaaaaaaaaaaaaaaaaaaaannnnptnnnnaaaaaaaaaaaaaaaa
aaaaaaaaaaaaaaaaaaaaaaaaaaaaaaaaaaaaaaaaaaaaaaaaaadkkkkekkkkCaaaaaaaaaaaaaaaaaaaaaaaaaaaaaaaaaaaaaaaaaaannnnptnnnnaaaaaaaaaaaaaaaa
aaaaaaaaaaaaaaaaaaaaaaaaaaaaaaaaaaaaaaaaaaaaaaaaaadkkkkekkkkCaaaaaaaaaaaaaaaaaaaaaaaaaaaaaaaaaaaaaaaaaaannnnptnnnnaaaaaaaaaaaaaaaa
aaaaaaaaaaaaaaaaaaaaaaaaaaaaaaaaaaaaaaaaaaaaaaaaaadkkkkekkkkCaaaaaaaaaaaaaaaaaaaaaaaaaaaaaaaaaaaaaaaaaaannnnnnnnnnaaaaaaaaaaaaaaaa
aaaaaaaaaaaaaaaaaaaaaaaaaaaaaaaaaaaaaaaaaaaaaaaaaadkkkkekkkkCaaaaaaaaaaaaaaaaaaaaaaaaaaaaaaaaaaaaaaaaaaannnnnnnnnnaaaaaaaaaaaaaaaa
aaaaaaaaaaaaaaaaaaaaaaaaaaaaaaaaaaaaaaaaaaaaaaaaaadkkkWekkkkCaaaaaaaaaaaaaaaaaaaaaaaaaaaaaaaaaaaaaaaaaaannnnptnnnnaaaaaaaaaaaaaaaa
aaaaaaaaaaaaaaaaaaaaaaaaaaaaaaaaaaaaaaaaaaaaaaaaaadkkkkekkkkCaaaaaaaaaaaaaaaaaaaaaaaaaaaaaaaaaaaaaaaaaaannnnptnnnnaaaaaaaaaaaaaaaa
aaaaaaaaaaaaaaaaaaaaaaaaaaaaaaaaaaaaaaaaaaaaaaaaaadkkkkekkkkCaaaaaaaaaaaaaaaaaaaaaaaaaaaaaaaaaaaaaaaaaaannnnptnnnnaaaaaaaaaaaaaaaa
aaaaaaaaaaaaaaaaaaaaaaaaaaaaaaaaaaaaaaaaaaaaaaaaaadkkkkekkkkCaaaaaaaaaaaaaaaaaaaaaaaaaaaaaaaaaaaaaaaaaaannnnnnnnnnaaaaaaaaaaaaaaaa
aaaaaaaaaaaaaaaaaaaaaaaaaaaaaaaaaaaaaaaaaaaaaaaaaadkkkkekkkkCaaaaaaaaaaaaaaaaaaaaaaaaaaaaaaaaaaaaaaaaaaannnnnnnnnnaaaaaaaaaaaaaaaa
aaaaaaaaaaaaaaaaaaaaaaaaaaaaaaaaaaaaaaaaaaaaaaaaaadkkkWekkkkCaaaaaaaaaaaaaaaaaaaaaaaaaaaaaaaaaaaaaaaaaaannnnptnnnnaaaaaaaaaaaaaaaa
aaaaaaaaaaaaaaaaaaaaaaaaaaaaaaaaaaaaaaaaaaaaaaaaaadkkkkekkkkCaaaaaaaaaaaaaaaaaaaaaaaaaaaaaaaaaaaaaaaaaaannnnptnnnnaaaaaaaaaaaaaaaa
aaaaaaaaaaaaaaaaaaaaaaaaaaaaaaaaaaaaaaaaaaaaaaaaaaiiiigiiiiiiaaaaaaaaaaaaaaaaaaaaaaaaaaaaaaaaaaaaaaaaaaannnnptnnnnaaaaaaaaaaaaaaaa
aaaaaaaaaaaaaaaaaaaaaaaaaaaaaaaaaaaaaaaaaaaaaaaaarijjojJjojjiaaaaaaaaaaaaaaaaaaaaaaaaaaaaaaaaaaaaaaaaaaannnnnnnnnnaaaaaaaaaaaaaaaa
aaaaaaaaaaaaaaaaaaaaaaaaaaaaaaaaaaaaaaaaaaaaaaaaaaljXojjjoXjlaaaaaaaaaaaaaaaaaaaaaaaaaaaaaaaaaaaaaaaaaaannnnnnnnnnaaaaaaaaaaaaaaaa
aaaaaaaaaaaaaaaaaaaaaaaaaaaaaaaaaaaaaaaaaaaaaaaaariiiihmhiiiiaaaaaaaaaaaaaaaaaaaaaaaaaaaaaaaaaaaaaaaaaaannnnptnnnnaaaaaaaaaaaaaaaa
aaaaaaaaaaaaaaaaaaaaaaaaaaaaaaaaaaaaaaaaaaaaaaaaaaijjqjjjJjjiaaaaaaaaaaaaaaaaaaaaaaaaaaaaaaaaaaaaaaaaaaannnnptnnnnaaaaaaaaaaaaaaaa
aaaaaaaaaaaaaaaaaaaaaaaaaaaaaaaaaaaaaaaaaaaaaaaaaaijjjjXjjjjHaaaaaaaaaaaaaaaaaaaaaaaaaaaaaaaaaaaaaaaaaaannnnptnnnnaaaaaaaaaaaaaaaa
aaaaaaaaaaaaaaaaaaaaaaaaaaaaaaaaaaaaaaaaaaaaaaaaaaijjiiiiijjHaaaaaaaaaaaaaaaaaaaaaaaaaaaaaaaaaaaaaaaaaaannnnnnnnnnaaaaaaaaaaaaaaaa
aaaaaaaaaaaaaaaaaaaaaaaaaaaaaaaaaaaaaaaaaaaaaaaaaaivjjjJjjjSiaaaaaaaaaaaaaaaaaaaaaaaaaaaaaaaaaaaaaaaaaaannnnnnnnnnaaaaaaaaaaaaaaaa
aaaaaaaaaaaaaaaaaaaaaaaaaaaaaaaaaaaaaaaaaaaaaaaaaaijjjjjjjjjiaaaaaaaaaaaaaaaaaaaaaaaaaaaaaaaaaaaaaaaaaaannnnptnnnnaaaaaaaaaaaaaaaa
aaaaaaaaaaaaaaaaaaaaaaaaaaaaaaaaaaaaaaaaaaaaaaaaaaijjEjjjXjjsaaaaaaaaaaaaaaaaaaaaaaaaaaaaaaaaaaaaaaaaaaannnnptnnnnaaaaaaaaaaaaaaaa
aaaaaaaaaaaaaaaaaaaaaaaaaaaaaaaaaaaaaaaaaaaaaaaaaaiiiiiiiiiiiaaaaaaaaaaaaaaaaaaaaaaaaaaaaaaaaaaaaaaaaaaannnnptnnnnaaaaaaaaaaaaaaaa
"}
