"a" = (/turf/floor/plating/beach/water/deep,/area/caribbean)
"b" = (/turf/wall/wood,/area/caribbean/pirates/ship/main_deck)
"c" = (/turf/wall/wood{opacity = 0},/area/caribbean/pirates/ship/main_deck)
"d" = (/obj/structure/cannon{dir = 1},/turf/floor/wood_ship,/area/caribbean/pirates/ship/main_deck)
"e" = (/turf/floor/wood_ship,/area/caribbean/pirates/ship/main_deck)
"f" = (/obj/map_metadata/naval,/turf/floor/plating/beach/water/deep,/area/caribbean)
"g" = (/obj/item/flashlight/lantern/on/anchored,/turf/floor/wood_ship,/area/caribbean/pirates/ship/main_deck)
"h" = (/obj/effect/landmark{name = "JoinLateHeer"},/turf/floor/wood_ship,/area/caribbean/pirates/ship/main_deck)
"i" = (/obj/structure/vending/piratesapparel,/turf/floor/wood_ship,/area/caribbean/pirates/ship/main_deck)
"j" = (/obj/structure/simple_door/key_door/anyone/wood,/turf/floor/wood,/area/caribbean/pirates/ship/main_deck)
"k" = (/obj/structure/cannon{dir = 4},/turf/floor/wood_ship,/area/caribbean/pirates/ship/main_deck)
"l" = (/turf/wall/wood{name = "mast"},/area/caribbean/pirates/ship/main_deck)
"m" = (/obj/structure/vending/flintlock,/turf/floor/wood_ship,/area/caribbean/pirates/ship/main_deck)
"n" = (/obj/structure/railing{dir = 4},/obj/structure/railing{dir = 8},/turf/floor/wood,/area/caribbean/pirates/ship/main_deck)
"o" = (/obj/structure/railing{dir = 4},/obj/structure/railing{dir = 8},/turf/floor/wood,/area/caribbean/no_mans_land/invisible_wall)
"p" = (/obj/structure/cannon,/turf/wall/wood{opacity = 0},/area/caribbean/pirates/ship/main_deck)
"q" = (/turf/wall/wood,/area/caribbean/british/ship/main_deck)
"r" = (/turf/wall/wood{opacity = 0},/area/caribbean/british/ship/main_deck)
"s" = (/obj/structure/railing{dir = 4},/obj/structure/railing{dir = 8},/turf/floor/wood,/area/caribbean/british/ship/main_deck)
"t" = (/turf/floor/wood_ship,/area/caribbean/british/ship/main_deck)
"u" = (/obj/item/flashlight/lantern/on/anchored,/turf/floor/wood_ship,/area/caribbean/british/ship/main_deck)
"v" = (/obj/structure/cannon{dir = 1},/turf/floor/wood_ship,/area/caribbean/british/ship/main_deck)
"w" = (/obj/effect/landmark{name = "JoinLateRA"},/turf/floor/wood_ship,/area/caribbean/british/ship/main_deck)
"x" = (/obj/structure/vending/flintlock,/turf/floor/wood_ship,/area/caribbean/british/ship/main_deck)
"y" = (/obj/structure/simple_door/key_door/anyone/wood,/turf/floor/wood,/area/caribbean/british/ship/main_deck)
"z" = (/obj/structure/cannon{dir = 4},/turf/floor/wood_ship,/area/caribbean/british/ship/main_deck)
"A" = (/obj/structure/vending/britishapparel,/turf/floor/wood_ship,/area/caribbean/british/ship/main_deck)
"B" = (/turf/wall/wood{name = "mast"},/area/caribbean/british/ship/main_deck)
"C" = (/obj/structure/cannon,/turf/wall/wood{opacity = 0},/area/caribbean/british/ship/main_deck)
"D" = (/obj/structure/reagent_dispensers/barrel/gunpowder,/turf/floor/wood_ship,/area/caribbean/pirates/ship/main_deck)
"E" = (/obj/structure/reagent_dispensers/barrel/rum,/turf/floor/wood_ship,/area/caribbean/pirates/ship/main_deck)
"F" = (/obj/structure/closet/crate/blunderbuss_ammo,/turf/floor/wood_ship,/area/caribbean/pirates/ship/main_deck)
"G" = (/obj/structure/closet/crate/musketball,/turf/floor/wood_ship,/area/caribbean/pirates/ship/main_deck)
"H" = (/obj/structure/closet/crate/musketball_pistol,/turf/floor/wood_ship,/area/caribbean/pirates/ship/main_deck)
"I" = (/obj/structure/reagent_dispensers/barrel/gunpowder,/turf/floor/wood_ship,/area/caribbean/british/ship/main_deck)
"J" = (/obj/structure/closet/crate/blunderbuss_ammo,/turf/floor/wood_ship,/area/caribbean/british/ship/main_deck)
"K" = (/obj/structure/closet/crate/musketball_pistol,/turf/floor/wood_ship,/area/caribbean/british/ship/main_deck)
"L" = (/obj/structure/closet/crate/musketball,/turf/floor/wood_ship,/area/caribbean/british/ship/main_deck)
"M" = (/obj/structure/reagent_dispensers/barrel/water,/turf/floor/wood_ship,/area/caribbean/british/ship/main_deck)
"N" = (/obj/item/weapon/reagent_containers/food/drinks/drinkingglass,/obj/item/weapon/reagent_containers/food/drinks/drinkingglass,/obj/item/weapon/reagent_containers/food/drinks/drinkingglass,/turf/floor/wood_ship,/area/caribbean/pirates/ship/main_deck)
"O" = (/obj/structure/closet/crate/cannonball,/turf/floor/wood_ship,/area/caribbean/pirates/ship/main_deck)
"P" = (/obj/structure/closet/crate/cannonball,/turf/floor/wood_ship,/area/caribbean/british/ship/main_deck)
"Q" = (/obj/item/weapon/reagent_containers/food/drinks/drinkingglass,/obj/item/weapon/reagent_containers/food/drinks/drinkingglass,/turf/floor/wood_ship,/area/caribbean/british/ship/main_deck)

(1,1,1) = {"
aaaaaaaaaaaaaaaaaaaaaaaaaaaaaaaaaaaaaaaaaaaaaaaaaaaaaaaaaaaaaaaaaaaaaaaaaaa
aaaaaaaaaaaaaaaaaaaaaaaaaaaaaaaaaaaaaaaaaaaaaaaaaaaaaaaaaaaaaaaaaaaaaaaaaaa
aaaaaaaaaaaaaaaaaaaaaaaaaaaaaaaaaaaaaaaaaaaaaaaaaaaaaaaaaaaaaaaaaaaaaaaaaaa
aaaaaaaaaaaaaaaaaaaaaaaaaaaaaaaaaaaaaaaaaaaaaaaaaaaaaaaaaaaaaaaaaaaaaaaaaaa
aaaaaaaaaaaaaaaaaaaaaaaaaaaaaaaaaaaaaaaaaaaaaaaaaaaaaaaaaaaaaaaaaaaaaaaaaaa
aaaaaaaaaaaaaaaaaaaaaaaaaaaaaaaaaaaaaaaaaaaaaaaaaaaaaaaaaaaaaaaaaaaaaaaaaaa
aaaaaaaaaaaaaaaaaaaaaaaaaaaaaaaaaaaaaaaaaaaaaaaaaaaaaaaaaaaaaaaaaaaaaaaaaaa
aaaaaaaaaaaaaaaaaaaaaaaaaaaaaaaaaaaaaaaaaaaaaaaaaaaaaaaaaaaaaaaaaaaaaaaaaaa
aaaaaaaaaaaaaaaaaaaaaaaaaaaaaaaaaaaaaaaaaaaaaaaaaaaaaaaaaaaaaaaaaaaaaaaaaaa
aaaaaaaaaaaaaaaaaaaaaaaaaaaaaaaaaaaaaaaaaaaaaaaaaaaaaaaaaaaaaaaaaaaaaaaaaaa
aaaaaaaaaaaaaaaaaaaaaaaaaaaaaaaaaaaaaaaaaaaaaaaaaaaaaaaaaaaaaaaaaaaaaaaaaaa
aaaaaaaaaaaaaaaaaaaaaaaaaaaaaaaaaaaaaaaaaaaaaaaaaaaaaaaaaaaaaaaaaaaaaaaaaaa
aaaaaaaaaaaaaaaaaaaaaaaaaaaaaaaaaaaaaaaaaaaaaaaaaaaaaaaaaaaaaaaaaaaaaaaaaaa
aaaaaaaaaaaaaaaaaaaaaaaaaaaaaaaaaaaaaaaaaaaaaaaaaaaaaaaaaaaaaaaaaaaaaaaaaaa
aaaaaaaaaaaaaaaaaaaaaaaaaaaaaaaaaaaaaaaaaaaaaaaaaaaaaaaaaaaaaaaaaaaaaaaaaaa
aaaaaaaaaaaaaaaaaaaaaaaaaaaaaaaaaaaaaaaaaaaaaaaaaaaaaaaaaaaaaaaaaaaaaaaaaaa
aaaaaaaaaaaaaaaaaaaaaaaaaaaaaaaaaaaaaaaaaaaaaaaaaaaaaaaaaaaaaaaaaaaaaaaaaaa
aaaaaaaaaaaaaaaaaaaaaaaaaaaaaaaaaaaaaaaaaaaaaaaaaaaaaaaaaaaaaaaaaaaaaaaaaaa
aaaaaaaaaaaaaaaaaaaaaaaaaaaaaaaaaaaaaaaaaaaaaaaaaaaaaaaaaaaaaaaaaaaaaaaaaaa
aaaaaaaaaaaaaaaaaaaaaaaaaaaaaaaaaaaaaaaaaaaaaaaaaaaaaaaaaaaaaaaaaaaaaaaaaaa
aaaaaaaaaaaaaaaaaaaaaaaaaaaaaaaaaaaaaaaaaaaaaaaaaaaaaaaaaaaaaaaaaaaaaaaaaaa
aaaaaaaaaaaaaaaaaaaaaaaaaaaaaaaaaaaaaaaaaaaaaaaaaaaaaaaaaaaaaaaaaaaaaaaaaaa
aaaaaaaaaaaaaaaaaaaaaaaaaaaaaaaaaaaaaaaaaaaaaaaaaaaaaaaaaaaaaaaaaaaaaaaaaaa
aaaaaaaaaaaaaaaaaaaaaaaaaaaaaaaaaaaaaaaaaaaaaaaaaaaaaaaaaaaaaaaaaaaaaaaaaaa
aaaaaaaaaaaaaaaaaaaaaaaaaaaaaaaaaaaaaaaaaaaaaaaaaaaaaaaaaaaaaaaaaaaaaaaaaaa
aaaaaaaaaaaaaaaaaaaaaaaaaaaaaaaaaaaaaaaaaaaaaaaaaaaaaaaaaaaaaaaaaaaaaaaaaaa
aaaaaaaaaaaaaaaaaaaaaaaaaaaaaaaaaaaaaaaaaaaaaaaaaaaaaaaaaaaaaaaaaaaaaaaaaaa
aaaaaaaaaaaaaaaaaaaaaaaaaaaaaaaaaaaaaaaaaaaaaaaaaaaaaaaaaaaaaaaaaaaaaaaaaaa
aaaaaaaaaaaaaaaaaaaaaaaaaaaaaaaaaaaaaaaaaaaaaaaaaaaaaaaaaaaaaaaaaaaaaaaaaaa
aaaaaaaaaaaaaaaaaaaaaaaaaaaaaaaaaaaaaaaaaaaaaaaaaaaaaaaaaaaaaaaaaaaaaaaaaaa
aaaaaaaaaaaaaaaaaaaaaaaaaaaaaaaaaaaaaaaaaaaaaaaaaaaaaaaaaaaaaaaaaaaaaaaaaaa
aaaaaaaaaaaaaaaaaaaaaaaaaaaaaaaaaaaaaaaaaaaaaaaaaaaaaaaaaaaaaaaaaaaaaaaaaaa
aaaaaaaaaaaaaaaaaaaaaaaaaaaaaaaaaaaaaaaaaaaaaaaaaaaaaaaaaaaaaaaaaaaaaaaaaaa
aaaaaaaaaaaaaaaaaaaaaaaaaaaaaaaaaaaaaaaaaaaaaaaaaaaaaaaaaaaaaaaaaaaaaaaaaaa
aaaaaaaaaaaaaaaaabbbbbaaaaaaaaaaaaccccccccccccccaaaaaaaaaaaaaaaaaaaaaaaaaaa
aaaaaaaaaaaaaaaacccccccccccccccccccdegDedeDgedegcaaaaaaaaaaaaaaaaaaaaaaaaaa
aaaaaaaaaaaaaaabcgehegbeeeNEeegeeegeeeeeeeeeeeeeccaaaaaaaaaaaaaaaaaaaaaaaaa
aaaaaaaaaaaaaaabceeeeebgeeeeeeeeeeeeeeeeeeeeeeeeeccccaaaaaaaaaaaaaaaaaaaaaa
aaaaaaaaaaaaaaabcieheejeeeeeeeeeeeeekeeeeeeeeeeeeeeeccccaaaaaaaaaaaaaaaaaaa
aaaaaaaaaaaaaaabcieehebeeeeFeeeeeeeGHeeeeeeeeeeeeeeeeeecccaaaaaaaaaaaaaaaaa
aaaaaaaaaaaaaaabcieheebeeellgeeeeeellgeeeeeeellgeeeeeeeeecbbbbbaaaaaaaaaaaa
aaaaaaaaaaaaaaabcihehebeeeeeeeeeeeeeeeeeeeeeeeeeeeeeeeecccaaaaaaaaaaaaaaaaa
aaaaaaaaaaaaaaabceheeejeeeeeeeeeeeeeeeeeeeeeeeeeeeeeccccaaaaaaaaaaaaaaaaaaa
aaaaaaaaaaaaaaabceeehebgeeeeeeeeeeeeeeeeeeeeeeeeeccccaaaaaaaaaaaaaaaaaaaaaa
aaaaaaaaaaaaaaabcgemmgbeeeeenegeDDgeeeeeeeDDeeegncaaaaaaaaaaaaaaaaaaaaaaaaa
aaaaaaaaaaaaaaaaccccccccccccncccccceOgneeeDgOeecoaaaaaaaaaaaaaaaaaaaaaaaaaa
aaaaaaaaaaaaaaaaabbbbbaaaaaaoaaaaacpccncpccccpccoaaaaaaaaaaaaaaaaaaaaaaaaaa
aaaaaaaaaaaaaaaaaaaaaaaaaaaaoaaaaaaaaaoaaaaaaaaaoaaaaaaaaaaaaaaaaaaaaaaaaaa
aaaaaaaaaaaaaaaaaaaaaaaaaaaaoaaaaaaaaaoaaaaaaaaaoaaaaaaaaaaaaaaaaaaaaaaaaaa
aaaaaaaaaaaaaaaaaaaaaaaaaaaaoaaaaaaaaaoaaaaaaaaaoaaaaaaaaaaaaaaaaaaaaaaaaaa
aaaaaaaaaaaaaaaaaaaaaaaaaaaaoaaaaaaaaaoaaaaaaaaaoaaaaaaaaaaaaaaaaaaaaaaaaaa
aaaaaaaaaaaaaaaaaaqqqqqrrrraoaaaaaaaaaoaaaaarrrrsrrrrrrraaaaaaaaaaaaaaaaaaa
aaaaaaaaaaaaaaaaarrrrrrrrrrrsrrrrrrrrrsrrrrrrttusqqttttrraaaaaaaaaaaaaaaaaa
aaaaaaaaaaaaaaaaqrttttttttqtstuvutPuvustuvuPPttttqqtttttrraaaaaaaaaaaaaaaaa
aaaaaaaaaaaaaaaaqrttttttttqttttttttttttttttttttttqtwtwttxrraaaaaaaaaaaaaaaa
aaaaaaaaaaaaaaaaqrttttttttyttttttIIttzttttIItttttyttttttttrraaaaaaaaaaaaaaa
aaaaaaaaaaaaaaaaqrtttttttuqutttttItttttttttttttttqutwtwttArrraaaaaaaaaaaaaa
aaaaaaaaaaaaaaaaqrttttttttqBBttttttuBBButtttttBBuqtttttttArrrrrrraaaaaaaaaa
aaaaaaaaaaaaaaaaqrttttttttqBBtttttttBBBtttttttBBuqttttwttArrrrrrraaaaaaaaaa
aaaaaaaaaaaaaaaaqrtttttttuquttttttttJKLtttttttQMtquwttttttrrraaaaaaaaaaaaaa
aaaaaaaaaaaaaaaaqrttttttttyttttttttttttttttttttttytttwtwttrraaaaaaaaaaaaaaa
aaaaaaaaaaaaaaaaqrttttttttqtttttttIttttttttttttttqttttttxrraaaaaaaaaaaaaaaa
aaaaaaaaaaaaaaaaqrttttttttqtttututIutuItutuItttttqqtwtttrraaaaaaaaaaaaaaaaa
aaaaaaaaaaaaaaaaarrrrrrrrrrrrrrCrrrrCrrrrCrrrttutqqttttrraaaaaaaaaaaaaaaaaa
aaaaaaaaaaaaaaaaaaqqqqrrrrraaaaaaaaaaaaaaaaarrrrrrrrrrrraaaaaaaaaaaaaaaaaaa
aaaaaaaaaaaaaaaaaaaaaaaaaaaaaaaaaaaaaaaaaaaaaaaaaaaaaaaaaaaaaaaaaaaaaaaaaaa
aaaaaaaaaaaaaaaaaaaaaaaaaaaaaaaaaaaaaaaaaaaaaaaaaaaaaaaaaaaaaaaaaaaaaaaaaaa
aaaaaaaaaaaaaaaaaaaaaaaaaaaaaaaaaaaaaaaaaaaaaaaaaaaaaaaaaaaaaaaaaaaaaaaaaaa
aaaaaaaaaaaaaaaaaaaaaaaaaaaaaaaaaaaaaaaaaaaaaaaaaaaaaaaaaaaaaaaaaaaaaaaaaaa
aaaaaaaaaaaaaaaaaaaaaaaaaaaaaaaaaaaaaaaaaaaaaaaaaaaaaaaaaaaaaaaaaaaaaaaaaaa
aaaaaaaaaaaaaaaaaaaaaaaaaaaaaaaaaaaaaaaaaaaaaaaaaaaaaaaaaaaaaaaaaaaaaaaaaaa
aaaaaaaaaaaaaaaaaaaaaaaaaaaaaaaaaaaaaaaaaaaaaaaaaaaaaaaaaaaaaaaaaaaaaaaaaaa
aaaaaaaaaaaaaaaaaaaaaaaaaaaaaaaaaaaaaaaaaaaaaaaaaaaaaaaaaaaaaaaaaaaaaaaaaaa
aaaaaaaaaaaaaaaaaaaaaaaaaaaaaaaaaaaaaaaaaaaaaaaaaaaaaaaaaaaaaaaaaaaaaaaaaaa
faaaaaaaaaaaaaaaaaaaaaaaaaaaaaaaaaaaaaaaaaaaaaaaaaaaaaaaaaaaaaaaaaaaaaaaaaa
"}
