"aa" = (/turf/floor/plating/beach/water/deep,/area/caribbean)
"ab" = (/turf/wall/wood,/area/caribbean/pirates/ship/main_deck)
"ac" = (/turf/wall/wood{opacity = 0},/area/caribbean/pirates/ship/main_deck)
"ad" = (/obj/structure/cannon{dir = 1},/turf/floor/wood_ship,/area/caribbean/pirates/ship/main_deck)
"ae" = (/turf/floor/wood_ship,/area/caribbean/pirates/ship/main_deck)
"af" = (/obj/map_metadata/naval,/turf/floor/plating/beach/water/deep,/area/caribbean)
"ag" = (/obj/item/flashlight/lantern/on/anchored,/turf/floor/wood_ship,/area/caribbean/pirates/ship/main_deck)
"ah" = (/turf/wall/wood,/area/caribbean/pirates/ship/office)
"ai" = (/obj/item/flashlight/lantern/on/anchored,/turf/floor/wood_ship,/area/caribbean/pirates/ship/office)
"aj" = (/obj/structure/closet/cabinet,/turf/floor/wood_ship,/area/caribbean/pirates/ship/office)
"ak" = (/obj/structure/cannon{dir = 4},/turf/floor/wood_ship,/area/caribbean/pirates/ship/main_deck)
"al" = (/turf/wall/wood{name = "mast"},/area/caribbean/pirates/ship/main_deck)
"am" = (/obj/effect/landmark{name = "JoinLateHeer"},/turf/floor/wood_ship,/area/caribbean/pirates/ship/office)
"an" = (/obj/structure/railing{dir = 4},/obj/structure/railing{dir = 8},/turf/floor/wood,/area/caribbean/pirates/ship/main_deck)
"ao" = (/obj/structure/railing{dir = 4},/obj/structure/railing{dir = 8},/turf/floor/wood,/area/caribbean/no_mans_land/invisible_wall)
"ap" = (/obj/structure/cannon,/turf/wall/wood{opacity = 0},/area/caribbean/pirates/ship/main_deck)
"aq" = (/turf/wall/wood,/area/caribbean/british/ship/main_deck)
"ar" = (/turf/wall/wood{opacity = 0},/area/caribbean/british/ship/main_deck)
"as" = (/obj/structure/railing{dir = 4},/obj/structure/railing{dir = 8},/turf/floor/wood,/area/caribbean/british/ship/main_deck)
"at" = (/turf/floor/wood_ship,/area/caribbean/british/ship/main_deck)
"au" = (/obj/item/flashlight/lantern/on/anchored,/turf/floor/wood_ship,/area/caribbean/british/ship/main_deck)
"av" = (/obj/structure/cannon{dir = 1},/turf/floor/wood_ship,/area/caribbean/british/ship/main_deck)
"aw" = (/obj/effect/landmark{name = "JoinLateRA"},/turf/floor/wood_ship,/area/caribbean/british/ship/main_deck)
"ax" = (/obj/structure/vending/flintlock,/turf/floor/wood_ship,/area/caribbean/british/ship/main_deck)
"ay" = (/obj/structure/simple_door/key_door/anyone/wood,/turf/floor/wood,/area/caribbean/british/ship/main_deck)
"az" = (/obj/structure/cannon{dir = 4},/turf/floor/wood_ship,/area/caribbean/british/ship/main_deck)
"aA" = (/obj/structure/vending/britishapparel,/turf/floor/wood_ship,/area/caribbean/british/ship/main_deck)
"aB" = (/turf/wall/wood{name = "mast"},/area/caribbean/british/ship/main_deck)
"aC" = (/obj/structure/cannon,/turf/wall/wood{opacity = 0},/area/caribbean/british/ship/main_deck)
"aD" = (/obj/structure/reagent_dispensers/barrel/gunpowder,/turf/floor/wood_ship,/area/caribbean/pirates/ship/main_deck)
"aE" = (/obj/structure/reagent_dispensers/barrel/rum,/turf/floor/wood_ship,/area/caribbean/pirates/ship/main_deck)
"aF" = (/obj/structure/closet/crate/blunderbuss_ammo,/turf/floor/wood_ship,/area/caribbean/pirates/ship/main_deck)
"aG" = (/obj/structure/closet/crate/musketball,/turf/floor/wood_ship,/area/caribbean/pirates/ship/main_deck)
"aH" = (/obj/structure/closet/crate/musketball_pistol,/turf/floor/wood_ship,/area/caribbean/pirates/ship/main_deck)
"aI" = (/obj/structure/reagent_dispensers/barrel/gunpowder,/turf/floor/wood_ship,/area/caribbean/british/ship/main_deck)
"aJ" = (/obj/structure/closet/crate/blunderbuss_ammo,/turf/floor/wood_ship,/area/caribbean/british/ship/main_deck)
"aK" = (/obj/structure/closet/crate/musketball_pistol,/turf/floor/wood_ship,/area/caribbean/british/ship/main_deck)
"aL" = (/obj/structure/closet/crate/musketball,/turf/floor/wood_ship,/area/caribbean/british/ship/main_deck)
"aM" = (/obj/structure/reagent_dispensers/barrel/water,/turf/floor/wood_ship,/area/caribbean/british/ship/main_deck)
"aN" = (/obj/item/weapon/reagent_containers/food/drinks/drinkingglass,/obj/item/weapon/reagent_containers/food/drinks/drinkingglass,/obj/item/weapon/reagent_containers/food/drinks/drinkingglass,/turf/floor/wood_ship,/area/caribbean/pirates/ship/main_deck)
"aO" = (/obj/structure/closet/crate/cannonball,/turf/floor/wood_ship,/area/caribbean/pirates/ship/main_deck)
"aP" = (/obj/structure/closet/crate/cannonball,/turf/floor/wood_ship,/area/caribbean/british/ship/main_deck)
"aQ" = (/obj/item/weapon/reagent_containers/food/drinks/drinkingglass,/obj/item/weapon/reagent_containers/food/drinks/drinkingglass,/turf/floor/wood_ship,/area/caribbean/british/ship/main_deck)
"aR" = (/turf/floor/wood_ship,/area/caribbean/pirates/ship/office)
"aS" = (/obj/structure/vending/piratesapparel,/turf/floor/wood_ship,/area/caribbean/pirates/ship/office)
"aT" = (/obj/structure/simple_door/key_door/anyone/wood,/turf/floor/wood,/area/caribbean/pirates/ship/office)
"aU" = (/obj/structure/vending/flintlock,/turf/floor/wood_ship,/area/caribbean/pirates/ship/office)
"aV" = (/turf/wall/wood,/area/caribbean/british/ship/office)
"aW" = (/turf/floor/wood_ship,/area/caribbean/british/ship/office)
"aX" = (/obj/structure/table/wood,/obj/item/weapon/pen,/turf/floor/wood_ship,/area/caribbean/british/ship/office)
"aY" = (/obj/structure/bookcase,/turf/floor/wood_ship,/area/caribbean/british/ship/office)
"aZ" = (/obj/structure/closet/cabinet,/turf/floor/wood_ship,/area/caribbean/british/ship/office)
"ba" = (/obj/structure/bed/chair/wood{dir = 4},/turf/floor/wood_ship,/area/caribbean/british/ship/office)
"bb" = (/obj/structure/table/wood,/obj/item/weapon/book,/turf/floor/wood_ship,/area/caribbean/british/ship/office)
"bc" = (/obj/structure/table/wood,/turf/floor/wood_ship,/area/caribbean/british/ship/office)
"bd" = (/obj/structure/simple_door/key_door/anyone/wood,/turf/floor/wood,/area/caribbean/british/ship/office)
"be" = (/obj/item/flashlight/lantern/on/anchored,/turf/floor/wood_ship,/area/caribbean/british/ship/office)

(1,1,1) = {"
aaaaaaaaaaaaaaaaaaaaaaaaaaaaaaaaaaaaaaaaaaaaaaaaaaaaaaaaaaaaaaaaaaaaaaaaaaaaaaaaaaaaaaaaaaaaaaaaaaaaaaaaaaaaaaaaaaaaaaaaaaaaaaaaaaaaaaaaaaaaaaaaaaaaaa
aaaaaaaaaaaaaaaaaaaaaaaaaaaaaaaaaaaaaaaaaaaaaaaaaaaaaaaaaaaaaaaaaaaaaaaaaaaaaaaaaaaaaaaaaaaaaaaaaaaaaaaaaaaaaaaaaaaaaaaaaaaaaaaaaaaaaaaaaaaaaaaaaaaaaa
aaaaaaaaaaaaaaaaaaaaaaaaaaaaaaaaaaaaaaaaaaaaaaaaaaaaaaaaaaaaaaaaaaaaaaaaaaaaaaaaaaaaaaaaaaaaaaaaaaaaaaaaaaaaaaaaaaaaaaaaaaaaaaaaaaaaaaaaaaaaaaaaaaaaaa
aaaaaaaaaaaaaaaaaaaaaaaaaaaaaaaaaaaaaaaaaaaaaaaaaaaaaaaaaaaaaaaaaaaaaaaaaaaaaaaaaaaaaaaaaaaaaaaaaaaaaaaaaaaaaaaaaaaaaaaaaaaaaaaaaaaaaaaaaaaaaaaaaaaaaa
aaaaaaaaaaaaaaaaaaaaaaaaaaaaaaaaaaaaaaaaaaaaaaaaaaaaaaaaaaaaaaaaaaaaaaaaaaaaaaaaaaaaaaaaaaaaaaaaaaaaaaaaaaaaaaaaaaaaaaaaaaaaaaaaaaaaaaaaaaaaaaaaaaaaaa
aaaaaaaaaaaaaaaaaaaaaaaaaaaaaaaaaaaaaaaaaaaaaaaaaaaaaaaaaaaaaaaaaaaaaaaaaaaaaaaaaaaaaaaaaaaaaaaaaaaaaaaaaaaaaaaaaaaaaaaaaaaaaaaaaaaaaaaaaaaaaaaaaaaaaa
aaaaaaaaaaaaaaaaaaaaaaaaaaaaaaaaaaaaaaaaaaaaaaaaaaaaaaaaaaaaaaaaaaaaaaaaaaaaaaaaaaaaaaaaaaaaaaaaaaaaaaaaaaaaaaaaaaaaaaaaaaaaaaaaaaaaaaaaaaaaaaaaaaaaaa
aaaaaaaaaaaaaaaaaaaaaaaaaaaaaaaaaaaaaaaaaaaaaaaaaaaaaaaaaaaaaaaaaaaaaaaaaaaaaaaaaaaaaaaaaaaaaaaaaaaaaaaaaaaaaaaaaaaaaaaaaaaaaaaaaaaaaaaaaaaaaaaaaaaaaa
aaaaaaaaaaaaaaaaaaaaaaaaaaaaaaaaaaaaaaaaaaaaaaaaaaaaaaaaaaaaaaaaaaaaaaaaaaaaaaaaaaaaaaaaaaaaaaaaaaaaaaaaaaaaaaaaaaaaaaaaaaaaaaaaaaaaaaaaaaaaaaaaaaaaaa
aaaaaaaaaaaaaaaaaaaaaaaaaaaaaaaaaaaaaaaaaaaaaaaaaaaaaaaaaaaaaaaaaaaaaaaaaaaaaaaaaaaaaaaaaaaaaaaaaaaaaaaaaaaaaaaaaaaaaaaaaaaaaaaaaaaaaaaaaaaaaaaaaaaaaa
aaaaaaaaaaaaaaaaaaaaaaaaaaaaaaaaaaaaaaaaaaaaaaaaaaaaaaaaaaaaaaaaaaaaaaaaaaaaaaaaaaaaaaaaaaaaaaaaaaaaaaaaaaaaaaaaaaaaaaaaaaaaaaaaaaaaaaaaaaaaaaaaaaaaaa
aaaaaaaaaaaaaaaaaaaaaaaaaaaaaaaaaaaaaaaaaaaaaaaaaaaaaaaaaaaaaaaaaaaaaaaaaaaaaaaaaaaaaaaaaaaaaaaaaaaaaaaaaaaaaaaaaaaaaaaaaaaaaaaaaaaaaaaaaaaaaaaaaaaaaa
aaaaaaaaaaaaaaaaaaaaaaaaaaaaaaaaaaaaaaaaaaaaaaaaaaaaaaaaaaaaaaaaaaaaaaaaaaaaaaaaaaaaaaaaaaaaaaaaaaaaaaaaaaaaaaaaaaaaaaaaaaaaaaaaaaaaaaaaaaaaaaaaaaaaaa
aaaaaaaaaaaaaaaaaaaaaaaaaaaaaaaaaaaaaaaaaaaaaaaaaaaaaaaaaaaaaaaaaaaaaaaaaaaaaaaaaaaaaaaaaaaaaaaaaaaaaaaaaaaaaaaaaaaaaaaaaaaaaaaaaaaaaaaaaaaaaaaaaaaaaa
aaaaaaaaaaaaaaaaaaaaaaaaaaaaaaaaaaaaaaaaaaaaaaaaaaaaaaaaaaaaaaaaaaaaaaaaaaaaaaaaaaaaaaaaaaaaaaaaaaaaaaaaaaaaaaaaaaaaaaaaaaaaaaaaaaaaaaaaaaaaaaaaaaaaaa
aaaaaaaaaaaaaaaaaaaaaaaaaaaaaaaaaaaaaaaaaaaaaaaaaaaaaaaaaaaaaaaaaaaaaaaaaaaaaaaaaaaaaaaaaaaaaaaaaaaaaaaaaaaaaaaaaaaaaaaaaaaaaaaaaaaaaaaaaaaaaaaaaaaaaa
aaaaaaaaaaaaaaaaaaaaaaaaaaaaaaaaaaaaaaaaaaaaaaaaaaaaaaaaaaaaaaaaaaaaaaaaaaaaaaaaaaaaaaaaaaaaaaaaaaaaaaaaaaaaaaaaaaaaaaaaaaaaaaaaaaaaaaaaaaaaaaaaaaaaaa
aaaaaaaaaaaaaaaaaaaaaaaaaaaaaaaaaaaaaaaaaaaaaaaaaaaaaaaaaaaaaaaaaaaaaaaaaaaaaaaaaaaaaaaaaaaaaaaaaaaaaaaaaaaaaaaaaaaaaaaaaaaaaaaaaaaaaaaaaaaaaaaaaaaaaa
aaaaaaaaaaaaaaaaaaaaaaaaaaaaaaaaaaaaaaaaaaaaaaaaaaaaaaaaaaaaaaaaaaaaaaaaaaaaaaaaaaaaaaaaaaaaaaaaaaaaaaaaaaaaaaaaaaaaaaaaaaaaaaaaaaaaaaaaaaaaaaaaaaaaaa
aaaaaaaaaaaaaaaaaaaaaaaaaaaaaaaaaaaaaaaaaaaaaaaaaaaaaaaaaaaaaaaaaaaaaaaaaaaaaaaaaaaaaaaaaaaaaaaaaaaaaaaaaaaaaaaaaaaaaaaaaaaaaaaaaaaaaaaaaaaaaaaaaaaaaa
aaaaaaaaaaaaaaaaaaaaaaaaaaaaaaaaaaaaaaaaaaaaaaaaaaaaaaaaaaaaaaaaaaaaaaaaaaaaaaaaaaaaaaaaaaaaaaaaaaaaaaaaaaaaaaaaaaaaaaaaaaaaaaaaaaaaaaaaaaaaaaaaaaaaaa
aaaaaaaaaaaaaaaaaaaaaaaaaaaaaaaaaaaaaaaaaaaaaaaaaaaaaaaaaaaaaaaaaaaaaaaaaaaaaaaaaaaaaaaaaaaaaaaaaaaaaaaaaaaaaaaaaaaaaaaaaaaaaaaaaaaaaaaaaaaaaaaaaaaaaa
aaaaaaaaaaaaaaaaaaaaaaaaaaaaaaaaaaaaaaaaaaaaaaaaaaaaaaaaaaaaaaaaaaaaaaaaaaaaaaaaaaaaaaaaaaaaaaaaaaaaaaaaaaaaaaaaaaaaaaaaaaaaaaaaaaaaaaaaaaaaaaaaaaaaaa
aaaaaaaaaaaaaaaaaaaaaaaaaaaaaaaaaaaaaaaaaaaaaaaaaaaaaaaaaaaaaaaaaaaaaaaaaaaaaaaaaaaaaaaaaaaaaaaaaaaaaaaaaaaaaaaaaaaaaaaaaaaaaaaaaaaaaaaaaaaaaaaaaaaaaa
aaaaaaaaaaaaaaaaaaaaaaaaaaaaaaaaaaaaaaaaaaaaaaaaaaaaaaaaaaaaaaaaaaaaaaaaaaaaaaaaaaaaaaaaaaaaaaaaaaaaaaaaaaaaaaaaaaaaaaaaaaaaaaaaaaaaaaaaaaaaaaaaaaaaaa
aaaaaaaaaaaaaaaaaaaaaaaaaaaaaaaaaaaaaaaaaaaaaaaaaaaaaaaaaaaaaaaaaaaaaaaaaaaaaaaaaaaaaaaaaaaaaaaaaaaaaaaaaaaaaaaaaaaaaaaaaaaaaaaaaaaaaaaaaaaaaaaaaaaaaa
aaaaaaaaaaaaaaaaaaaaaaaaaaaaaaaaaaaaaaaaaaaaaaaaaaaaaaaaaaaaaaaaaaaaaaaaaaaaaaaaaaaaaaaaaaaaaaaaaaaaaaaaaaaaaaaaaaaaaaaaaaaaaaaaaaaaaaaaaaaaaaaaaaaaaa
aaaaaaaaaaaaaaaaaaaaaaaaaaaaaaaaaaaaaaaaaaaaaaaaaaaaaaaaaaaaaaaaaaaaaaaaaaaaaaaaaaaaaaaaaaaaaaaaaaaaaaaaaaaaaaaaaaaaaaaaaaaaaaaaaaaaaaaaaaaaaaaaaaaaaa
aaaaaaaaaaaaaaaaaaaaaaaaaaaaaaaaaaaaaaaaaaaaaaaaaaaaaaaaaaaaaaaaaaaaaaaaaaaaaaaaaaaaaaaaaaaaaaaaaaaaaaaaaaaaaaaaaaaaaaaaaaaaaaaaaaaaaaaaaaaaaaaaaaaaaa
aaaaaaaaaaaaaaaaaaaaaaaaaaaaaaaaaaaaaaaaaaaaaaaaaaaaaaaaaaaaaaaaaaaaaaaaaaaaaaaaaaaaaaaaaaaaaaaaaaaaaaaaaaaaaaaaaaaaaaaaaaaaaaaaaaaaaaaaaaaaaaaaaaaaaa
aaaaaaaaaaaaaaaaaaaaaaaaaaaaaaaaaaaaaaaaaaaaaaaaaaaaaaaaaaaaaaaaaaaaaaaaaaaaaaaaaaaaaaaaaaaaaaaaaaaaaaaaaaaaaaaaaaaaaaaaaaaaaaaaaaaaaaaaaaaaaaaaaaaaaa
aaaaaaaaaaaaaaaaaaaaaaaaaaaaaaaaaaaaaaaaaaaaaaaaaaaaaaaaaaaaaaaaaaaaaaaaaaaaaaaaaaaaaaaaaaaaaaaaaaaaaaaaaaaaaaaaaaaaaaaaaaaaaaaaaaaaaaaaaaaaaaaaaaaaaa
aaaaaaaaaaaaaaaaaaaaaaaaaaaaaaaaaaaaaaaaaaaaaaaaaaaaaaaaaaaaaaaaaaaaaaaaaaaaaaaaaaaaaaaaaaaaaaaaaaaaaaaaaaaaaaaaaaaaaaaaaaaaaaaaaaaaaaaaaaaaaaaaaaaaaa
aaaaaaaaaaaaaaaaaaaaaaaaaaaaaaaaaaaaaaaaaaaaaaaaaaaaaaaaaaaaaaaaaaaaaaaaaaaaaaaaaaaaaaaaaaaaaaaaaaaaaaaaaaaaaaaaaaaaaaaaaaaaaaaaaaaaaaaaaaaaaaaaaaaaaa
aaaaaaaaaaaaaaaaaaaaaaaaaaaaaaaaaaahahahahahaaaaaaaaaaaaaaaaaaaaaaaaacacacacacacacacacacacacacacaaaaaaaaaaaaaaaaaaaaaaaaaaaaaaaaaaaaaaaaaaaaaaaaaaaaaa
aaaaaaaaaaaaaaaaaaaaaaaaaaaaaaaaahahahahahahahacacacacacacacacacacacacadaeagaDaeadaeaDagaeadaeagacaaaaaaaaaaaaaaaaaaaaaaaaaaaaaaaaaaaaaaaaaaaaaaaaaaaa
aaaaaaaaaaaaaaaaaaaaaaaaaaaaaaahahaiajamajaiahaeaeaeaNaEaeaeagaeaeaeagaeaeaeaeaeaeaeaeaeaeaeaeaeacacaaaaaaaaaaaaaaaaaaaaaaaaaaaaaaaaaaaaaaaaaaaaaaaaaa
aaaaaaaaaaaaaaaaaaaaaaaaaaaaaaahahaRaRaRaRaRahagaeaeaeaeaeaeaeaeaeaeaeaeaeaeaeaeaeaeaeaeaeaeaeaeaeacacacacaaaaaaaaaaaaaaaaaaaaaaaaaaaaaaaaaaaaaaaaaaaa
aaaaaaaaaaaaaaaaaaaaaaaaaaaaaaahahaSaRamaRaRaTaeaeaeaeaeaeaeaeaeaeaeaeaeakaeaeaeaeaeaeaeaeaeaeaeaeaeaeaeacacacacaaaaaaaaaaaaaaaaaaaaaaaaaaaaaaaaaaaaaa
aaaaaaaaaaaaaaaaaaaaaaaaaaaaaaahahaSaRaRamaRahaeaeaeaeaFaeaeaeaeaeaeaeaGaHaeaeaeaeaeaeaeaeaeaeaeaeaeaeaeaeaeaeacacacaaaaaaaaaaaaaaaaaaaaaaaaaaaaaaaaaa
aaaaaaaaaaaaaaaaaaaaaaaaaaaaaaahahaSaRamaRaRahaeaeaealalagaeaeaeaeaeaealalagaeaeaeaeaeaeaealalagaeaeaeaeaeaeaeaeaeacabababababaaaaaaaaaaaaaaaaaaaaaaaa
aaaaaaaaaaaaaaaaaaaaaaaaaaaaaaahahaSamaRamaRahaeaeaeaeaeaeaeaeaeaeaeaeaeaeaeaeaeaeaeaeaeaeaeaeaeaeaeaeaeaeaeaeacacacaaaaaaaaaaaaaaaaaaaaaaaaaaaaaaaaaa
aaaaaaaaaaaaaaaaaaaaaaaaaaaaaaahahaRamaRaRaRaTaeaeaeaeaeaeaeaeaeaeaeaeaeaeaeaeaeaeaeaeaeaeaeaeaeaeaeaeaeacacacacaaaaaaaaaaaaaaaaaaaaaaaaaaaaaaaaaaaaaa
aaaaaaaaaaaaaaaaaaaaaaaaaaaaaaahahaRaRaRamaRahagaeaeaeaeaeaeaeaeaeaeaeaeaeaeaeaeaeaeaeaeaeaeaeaeaeacacacacaaaaaaaaaaaaaaaaaaaaaaaaaaaaaaaaaaaaaaaaaaaa
aaaaaaaaaaaaaaaaaaaaaaaaaaaaaaahahaiaRaUaUaiahaeaeaeaeaeanaeagaeaDaDagaeaeaeaeaeaeaeaDaDaeaeaeaganacaaaaaaaaaaaaaaaaaaaaaaaaaaaaaaaaaaaaaaaaaaaaaaaaaa
aaaaaaaaaaaaaaaaaaaaaaaaaaaaaaaaahahahahahahahacacacacacanacacacacacacaeaOaganaeaeaeaDagaOaeaeacaoaaaaaaaaaaaaaaaaaaaaaaaaaaaaaaaaaaaaaaaaaaaaaaaaaaaa
aaaaaaaaaaaaaaaaaaaaaaaaaaaaaaaaaaahahahahahaaaaaaaaaaaaaoaaaaaaaaaaacapacacanacapacacacacapacacaoaaaaaaaaaaaaaaaaaaaaaaaaaaaaaaaaaaaaaaaaaaaaaaaaaaaa
aaaaaaaaaaaaaaaaaaaaaaaaaaaaaaaaaaaaaaaaaaaaaaaaaaaaaaaaaoaaaaaaaaaaaaaaaaaaaoaaaaaaaaaaaaaaaaaaaoaaaaaaaaaaaaaaaaaaaaaaaaaaaaaaaaaaaaaaaaaaaaaaaaaaaa
aaaaaaaaaaaaaaaaaaaaaaaaaaaaaaaaaaaaaaaaaaaaaaaaaaaaaaaaaoaaaaaaaaaaaaaaaaaaaoaaaaaaaaaaaaaaaaaaaoaaaaaaaaaaaaaaaaaaaaaaaaaaaaaaaaaaaaaaaaaaaaaaaaaaaa
aaaaaaaaaaaaaaaaaaaaaaaaaaaaaaaaaaaaaaaaaaaaaaaaaaaaaaaaaoaaaaaaaaaaaaaaaaaaaoaaaaaaaaaaaaaaaaaaaoaaaaaaaaaaaaaaaaaaaaaaaaaaaaaaaaaaaaaaaaaaaaaaaaaaaa
aaaaaaaaaaaaaaaaaaaaaaaaaaaaaaaaaaaaaaaaaaaaaaaaaaaaaaaaaoaaaaaaaaaaaaaaaaaaaoaaaaaaaaaaaaaaaaaaaoaaaaaaaaaaaaaaaaaaaaaaaaaaaaaaaaaaaaaaaaaaaaaaaaaaaa
aaaaaaaaaaaaaaaaaaaaaaaaaaaaaaaaaaaaaVaVaVaVaVaVaVaVaVaaaoaaaaaaaaaaaaaaaaaaaoaaaaaaaaaaararararasaqaqaqaqaqaqaqaaaaaaaaaaaaaaaaaaaaaaaaaaaaaaaaaaaaaa
aaaaaaaaaaaaaaaaaaaaaaaaaaaaaaaaaaaVaVaVaVaVaVaVaVaVaVarasarararararararararasararararararatatauasaqaqatatatataqaqaaaaaaaaaaaaaaaaaaaaaaaaaaaaaaaaaaaa
aaaaaaaaaaaaaaaaaaaaaaaaaaaaaaaaaVaVaWaXaWaWaYaYaYaZaVatasatauavauataPauavauasatauavauaPaPatatatataqaqatatatatataqaqaaaaaaaaaaaaaaaaaaaaaaaaaaaaaaaaaa
aaaaaaaaaaaaaaaaaaaaaaaaaaaaaaaaaVaVbabbaWaWaWaWaWaWaVatatatatatatatatatatatatatatatatatatatatatataqatawatawatataxaqaqaaaaaaaaaaaaaaaaaaaaaaaaaaaaaaaa
aaaaaaaaaaaaaaaaaaaaaaaaaaaaaaaaaVaVaWbcaWaWaWaWaWaWbdatatatatatataIaIatatazatatatataIaIatatatatatayatatatatatatatataqaqaaaaaaaaaaaaaaaaaaaaaaaaaaaaaa
aaaaaaaaaaaaaaaaaaaaaaaaaaaaaaaaaVaVaWaWaWaWaWaWaWbeaVauatatatatataIatatatatatatatatatatatatatatataqauatawatawatataAaqaqaqaaaaaaaaaaaaaaaaaaaaaaaaaaaa
aaaaaaaaaaaaaaaaaaaaaaaaaaaaaaaaaVaVaWaWaWaWaWaWaWaWaVaBaBatatatatatatauaBaBaBauatatatatatataBaBauaqatatatatatatataAaqaqaqaqaqaqaqaaaaaaaaaaaaaaaaaaaa
aaaaaaaaaaaaaaaaaaaaaaaaaaaaaaaaaVaVaWaWaWaWaWaWaWaWaVaBaBatatatatatatataBaBaBatatatatatatataBaBauaqatatatatawatataAaqaqaqaqaqaqaqaaaaaaaaaaaaaaaaaaaa
aaaaaaaaaaaaaaaaaaaaaaaaaaaaaaaaaVaVaWaWaWaWaWaWaWbeaVauatatatatatatatataJaKaLatatatatatatataQaMataqauawatatatatatataqaqaqaaaaaaaaaaaaaaaaaaaaaaaaaaaa
aaaaaaaaaaaaaaaaaaaaaaaaaaaaaaaaaVaVbabcaWaWaWaWaWaWbdatatatatatatatatatatatatatatatatatatatatatatayatatatawatawatataqaqaaaaaaaaaaaaaaaaaaaaaaaaaaaaaa
aaaaaaaaaaaaaaaaaaaaaaaaaaaaaaaaaVaVaWbcaWaWaWaWaWaWaVatatatatatatataIatatatatatatatatatatatatatataqatatatatatataxaqaqaaaaaaaaaaaaaaaaaaaaaaaaaaaaaaaa
aaaaaaaaaaaaaaaaaaaaaaaaaaaaaaaaaVaVaWbcaWaWaWaWaWaWaVatatatauatauataIauatauaIatauatauaIatatatatataqaqatawatatataqaqaaaaaaaaaaaaaaaaaaaaaaaaaaaaaaaaaa
aaaaaaaaaaaaaaaaaaaaaaaaaaaaaaaaaaaVaVaVaVaVaVaVaVaVaVararararaCararararaCararararaCarararatatauataqaqatatatataqaqaaaaaaaaaaaaaaaaaaaaaaaaaaaaaaaaaaaa
aaaaaaaaaaaaaaaaaaaaaaaaaaaaaaaaaaaaaVaVaVaVaVaVaVaVaVaaaaaaaaaaaaaaaaaaaaaaaaaaaaaaaaaaarararararaqaqaqaqaqaqaqaaaaaaaaaaaaaaaaaaaaaaaaaaaaaaaaaaaaaa
aaaaaaaaaaaaaaaaaaaaaaaaaaaaaaaaaaaaaaaaaaaaaaaaaaaaaaaaaaaaaaaaaaaaaaaaaaaaaaaaaaaaaaaaaaaaaaaaaaaaaaaaaaaaaaaaaaaaaaaaaaaaaaaaaaaaaaaaaaaaaaaaaaaaaa
aaaaaaaaaaaaaaaaaaaaaaaaaaaaaaaaaaaaaaaaaaaaaaaaaaaaaaaaaaaaaaaaaaaaaaaaaaaaaaaaaaaaaaaaaaaaaaaaaaaaaaaaaaaaaaaaaaaaaaaaaaaaaaaaaaaaaaaaaaaaaaaaaaaaaa
aaaaaaaaaaaaaaaaaaaaaaaaaaaaaaaaaaaaaaaaaaaaaaaaaaaaaaaaaaaaaaaaaaaaaaaaaaaaaaaaaaaaaaaaaaaaaaaaaaaaaaaaaaaaaaaaaaaaaaaaaaaaaaaaaaaaaaaaaaaaaaaaaaaaaa
aaaaaaaaaaaaaaaaaaaaaaaaaaaaaaaaaaaaaaaaaaaaaaaaaaaaaaaaaaaaaaaaaaaaaaaaaaaaaaaaaaaaaaaaaaaaaaaaaaaaaaaaaaaaaaaaaaaaaaaaaaaaaaaaaaaaaaaaaaaaaaaaaaaaaa
aaaaaaaaaaaaaaaaaaaaaaaaaaaaaaaaaaaaaaaaaaaaaaaaaaaaaaaaaaaaaaaaaaaaaaaaaaaaaaaaaaaaaaaaaaaaaaaaaaaaaaaaaaaaaaaaaaaaaaaaaaaaaaaaaaaaaaaaaaaaaaaaaaaaaa
aaaaaaaaaaaaaaaaaaaaaaaaaaaaaaaaaaaaaaaaaaaaaaaaaaaaaaaaaaaaaaaaaaaaaaaaaaaaaaaaaaaaaaaaaaaaaaaaaaaaaaaaaaaaaaaaaaaaaaaaaaaaaaaaaaaaaaaaaaaaaaaaaaaaaa
aaaaaaaaaaaaaaaaaaaaaaaaaaaaaaaaaaaaaaaaaaaaaaaaaaaaaaaaaaaaaaaaaaaaaaaaaaaaaaaaaaaaaaaaaaaaaaaaaaaaaaaaaaaaaaaaaaaaaaaaaaaaaaaaaaaaaaaaaaaaaaaaaaaaaa
aaaaaaaaaaaaaaaaaaaaaaaaaaaaaaaaaaaaaaaaaaaaaaaaaaaaaaaaaaaaaaaaaaaaaaaaaaaaaaaaaaaaaaaaaaaaaaaaaaaaaaaaaaaaaaaaaaaaaaaaaaaaaaaaaaaaaaaaaaaaaaaaaaaaaa
aaaaaaaaaaaaaaaaaaaaaaaaaaaaaaaaaaaaaaaaaaaaaaaaaaaaaaaaaaaaaaaaaaaaaaaaaaaaaaaaaaaaaaaaaaaaaaaaaaaaaaaaaaaaaaaaaaaaaaaaaaaaaaaaaaaaaaaaaaaaaaaaaaaaaa
afaaaaaaaaaaaaaaaaaaaaaaaaaaaaaaaaaaaaaaaaaaaaaaaaaaaaaaaaaaaaaaaaaaaaaaaaaaaaaaaaaaaaaaaaaaaaaaaaaaaaaaaaaaaaaaaaaaaaaaaaaaaaaaaaaaaaaaaaaaaaaaaaaaaa
"}
