"aa" = (/turf/floor/plating/beach/water/deep,/area/caribbean)
"ab" = (/turf/wall/wood,/area/caribbean/pirates/ship/main_deck)
"ac" = (/turf/wall/wood{opacity = 0},/area/caribbean/pirates/ship/main_deck)
"ad" = (/obj/structure/cannon{dir = 1},/turf/floor/wood_ship,/area/caribbean/pirates/ship/main_deck)
"ae" = (/turf/floor/wood_ship,/area/caribbean/pirates/ship/main_deck)
"af" = (/obj/map_metadata/naval,/turf/floor/plating/beach/water/deep,/area/caribbean)
"ag" = (/obj/item/flashlight/lantern/on/anchored,/turf/floor/wood_ship,/area/caribbean/pirates/ship/main_deck)
"ah" = (/turf/wall/wood,/area/caribbean/pirates/ship/office)
"ai" = (/obj/item/flashlight/lantern/on/anchored,/turf/floor/wood_ship,/area/caribbean/pirates/ship/office)
"aj" = (/obj/structure/closet/cabinet,/turf/floor/wood_ship,/area/caribbean/pirates/ship/office)
"ak" = (/obj/structure/cannon{dir = 4},/turf/floor/wood_ship,/area/caribbean/pirates/ship/main_deck)
"al" = (/turf/wall/wood{name = "mast"},/area/caribbean/pirates/ship/main_deck)
"am" = (/obj/effect/landmark{name = "JoinLatePirate"},/turf/floor/wood_ship,/area/caribbean/pirates/ship/office)
"an" = (/obj/structure/railing{dir = 4},/obj/structure/railing{dir = 8},/turf/floor/wood,/area/caribbean/pirates/ship/main_deck)
"ao" = (/obj/structure/railing{dir = 4},/obj/structure/railing{dir = 8},/turf/floor/wood,/area/caribbean/no_mans_land/invisible_wall)
"ap" = (/obj/structure/cannon,/turf/wall/wood{opacity = 0},/area/caribbean/pirates/ship/main_deck)
"aq" = (/turf/wall/wood,/area/caribbean/british/ship/main_deck)
"ar" = (/turf/wall/wood{opacity = 0},/area/caribbean/british/ship/main_deck)
"as" = (/obj/structure/railing{dir = 4},/obj/structure/railing{dir = 8},/turf/floor/wood,/area/caribbean/british/ship/main_deck)
"at" = (/turf/floor/wood_ship,/area/caribbean/british/ship/main_deck)
"au" = (/obj/item/flashlight/lantern/on/anchored,/turf/floor/wood_ship,/area/caribbean/british/ship/main_deck)
"av" = (/obj/structure/cannon{dir = 1},/turf/floor/wood_ship,/area/caribbean/british/ship/main_deck)
"aw" = (/obj/effect/landmark{name = "JoinLatePirateCook"},/turf/floor/wood_ship,/area/caribbean/pirates/ship/main_deck)
"ax" = (/obj/structure/vending/flintlock,/turf/floor/wood_ship,/area/caribbean/british/ship/main_deck)
"ay" = (/obj/structure/simple_door/key_door/anyone/wood,/turf/floor/wood,/area/caribbean/british/ship/main_deck)
"az" = (/obj/structure/cannon{dir = 4},/turf/floor/wood_ship,/area/caribbean/british/ship/main_deck)
"aA" = (/obj/structure/vending/britishapparel,/turf/floor/wood_ship,/area/caribbean/british/ship/main_deck)
"aB" = (/turf/wall/wood{name = "mast"},/area/caribbean/british/ship/main_deck)
"aC" = (/obj/structure/cannon,/turf/wall/wood{opacity = 0},/area/caribbean/british/ship/main_deck)
"aD" = (/obj/structure/reagent_dispensers/barrel/gunpowder,/turf/floor/wood_ship,/area/caribbean/pirates/ship/main_deck)
"aE" = (/obj/structure/reagent_dispensers/barrel/rum,/turf/floor/wood_ship,/area/caribbean/pirates/ship/main_deck)
"aF" = (/obj/structure/closet/crate/blunderbuss_ammo,/turf/floor/wood_ship,/area/caribbean/pirates/ship/main_deck)
"aG" = (/obj/structure/closet/crate/musketball,/turf/floor/wood_ship,/area/caribbean/pirates/ship/main_deck)
"aH" = (/obj/structure/closet/crate/musketball_pistol,/turf/floor/wood_ship,/area/caribbean/pirates/ship/main_deck)
"aI" = (/obj/structure/reagent_dispensers/barrel/gunpowder,/turf/floor/wood_ship,/area/caribbean/british/ship/main_deck)
"aJ" = (/obj/structure/closet/crate/blunderbuss_ammo,/turf/floor/wood_ship,/area/caribbean/british/ship/main_deck)
"aK" = (/obj/structure/closet/crate/musketball_pistol,/turf/floor/wood_ship,/area/caribbean/british/ship/main_deck)
"aL" = (/obj/structure/closet/crate/musketball,/turf/floor/wood_ship,/area/caribbean/british/ship/main_deck)
"aM" = (/obj/structure/reagent_dispensers/barrel/water,/turf/floor/wood_ship,/area/caribbean/british/ship/main_deck)
"aN" = (/obj/item/weapon/reagent_containers/food/drinks/drinkingglass,/obj/item/weapon/reagent_containers/food/drinks/drinkingglass,/obj/item/weapon/reagent_containers/food/drinks/drinkingglass,/turf/floor/wood_ship,/area/caribbean/pirates/ship/main_deck)
"aO" = (/obj/structure/closet/crate/cannonball,/turf/floor/wood_ship,/area/caribbean/pirates/ship/main_deck)
"aP" = (/obj/structure/closet/crate/cannonball,/turf/floor/wood_ship,/area/caribbean/british/ship/main_deck)
"aQ" = (/obj/item/weapon/reagent_containers/food/drinks/drinkingglass,/obj/item/weapon/reagent_containers/food/drinks/drinkingglass,/turf/floor/wood_ship,/area/caribbean/british/ship/main_deck)
"aR" = (/turf/floor/wood_ship,/area/caribbean/pirates/ship/office)
"aS" = (/obj/structure/vending/piratesapparel,/turf/floor/wood_ship,/area/caribbean/pirates/ship/office)
"aT" = (/obj/structure/simple_door/key_door/anyone/wood,/turf/floor/wood,/area/caribbean/pirates/ship/office)
"aU" = (/obj/structure/vending/flintlock,/turf/floor/wood_ship,/area/caribbean/pirates/ship/office)
"aV" = (/turf/wall/wood,/area/caribbean/british/ship/office)
"aW" = (/turf/floor/wood_ship,/area/caribbean/british/ship/office)
"aX" = (/obj/structure/table/wood,/obj/item/weapon/pen,/turf/floor/wood_ship,/area/caribbean/british/ship/office)
"aY" = (/obj/structure/bookcase,/turf/floor/wood_ship,/area/caribbean/british/ship/office)
"aZ" = (/obj/structure/closet/cabinet,/turf/floor/wood_ship,/area/caribbean/british/ship/office)
"ba" = (/obj/structure/bed/chair/wood{dir = 4},/turf/floor/wood_ship,/area/caribbean/british/ship/office)
"bb" = (/obj/structure/table/wood,/obj/item/weapon/book,/turf/floor/wood_ship,/area/caribbean/british/ship/office)
"bc" = (/obj/structure/table/wood,/turf/floor/wood_ship,/area/caribbean/british/ship/office)
"bd" = (/obj/structure/simple_door/key_door/anyone/wood,/turf/floor/wood,/area/caribbean/british/ship/office)
"be" = (/obj/item/flashlight/lantern/on/anchored,/turf/floor/wood_ship,/area/caribbean/british/ship/office)
"bf" = (/obj/structure/table/wood,/obj/item/weapon/reagent_containers/food/snacks/stew,/obj/item/weapon/reagent_containers/food/snacks/stew,/obj/item/weapon/reagent_containers/food/snacks/stew,/obj/item/weapon/reagent_containers/food/snacks/stew,/turf/floor/wood_ship,/area/caribbean/pirates/ship/main_deck)
"bg" = (/obj/structure/table/wood,/obj/item/weapon/reagent_containers/food/snacks/sausage,/turf/floor/wood_ship,/area/caribbean/pirates/ship/main_deck)
"bh" = (/obj/structure/reagent_dispensers/barrel/water,/turf/floor/wood_ship,/area/caribbean/pirates/ship/main_deck)
"bi" = (/obj/item/weapon/reagent_containers/food/snacks/sliceable/bread,/obj/item/weapon/reagent_containers/food/snacks/sliceable/bread,/obj/structure/table/wood,/turf/floor/wood_ship,/area/caribbean/british/ship/main_deck)
"bj" = (/obj/item/weapon/reagent_containers/food/snacks/sliceable/bread,/obj/structure/table/wood,/turf/floor/wood_ship,/area/caribbean/british/ship/main_deck)
"bk" = (/obj/item/weapon/reagent_containers/food/snacks/stew,/obj/structure/table/wood,/turf/floor/wood_ship,/area/caribbean/british/ship/main_deck)
"bl" = (/obj/item/weapon/reagent_containers/food/snacks/stew,/obj/item/weapon/reagent_containers/food/snacks/stew,/obj/structure/table/wood,/turf/floor/wood_ship,/area/caribbean/british/ship/main_deck)
"bm" = (/obj/structure/reagent_dispensers/barrel/beer,/turf/floor/wood_ship,/area/caribbean/british/ship/office)
"bn" = (/obj/structure/closet/crate/wood,/turf/floor/wood_ship,/area/caribbean/pirates/ship/main_deck)
"bo" = (/obj/structure/closet/crate/wood,/turf/floor/wood_ship,/area/caribbean/british/ship/main_deck)
"bp" = (/obj/effect/landmark{name = "JoinLatePirateSurgeon"},/turf/floor/wood_ship,/area/caribbean/pirates/ship/main_deck)
"bq" = (/obj/effect/landmark{name = "JoinLatePirateMidshipman"},/turf/floor/wood_ship,/area/caribbean/pirates/ship/main_deck)
"br" = (/obj/effect/landmark{name = "JoinLatePirateCarpenter"},/turf/floor/wood_ship,/area/caribbean/pirates/ship/main_deck)
"bs" = (/obj/effect/landmark{name = "JoinLatePirateBoatswain"},/turf/floor/wood_ship,/area/caribbean/pirates/ship/main_deck)
"bt" = (/obj/effect/landmark{name = "JoinLatePirateCap"},/turf/floor/wood_ship,/area/caribbean/pirates/ship/main_deck)
"bu" = (/obj/effect/landmark{name = "JoinLatePirateQM"},/turf/floor/wood_ship,/area/caribbean/pirates/ship/main_deck)
"bv" = (/obj/effect/landmark{name = "JoinLateRNCook"},/turf/floor/wood_ship,/area/caribbean/british/ship/main_deck)
"bw" = (/obj/effect/landmark{name = "JoinLateRN"},/turf/floor/wood_ship,/area/caribbean/british/ship/main_deck)
"bx" = (/obj/effect/landmark{name = "JoinLateRNMidshipman"},/turf/floor/wood_ship,/area/caribbean/british/ship/main_deck)
"by" = (/obj/effect/landmark{name = "JoinLateRNBoatswain"},/turf/floor/wood_ship,/area/caribbean/british/ship/office)
"bz" = (/obj/effect/landmark{name = "Observer-Start"},/turf/floor/wood_ship,/area/caribbean/british/ship/main_deck)
"bA" = (/obj/effect/landmark{name = "JoinLateRNCap"},/turf/floor/wood_ship,/area/caribbean/british/ship/office)
"bB" = (/obj/effect/landmark{name = "JoinLateRNSurgeon"},/turf/floor/wood_ship,/area/caribbean/british/ship/office)
"bC" = (/obj/effect/landmark{name = "JoinLateRNCarpenter"},/turf/floor/wood_ship,/area/caribbean/british/ship/main_deck)
"bD" = (/obj/effect/landmark{name = "JoinLateRNQM"},/turf/floor/wood_ship,/area/caribbean/british/ship/office)

(1,1,1) = {"
aaaaaaaaaaaaaaaaaaaaaaaaaaaaaaaaaaaaaaaaaaaaaaaaaaaaaaaaaaaaaaaaaaaaaaaaaaaaaaaaaaaaaaaaaaaaaaaaaaaaaaaaaaaaaaaaaaaaaaaaaaaaaaaaaaaaaaaaaaaaaaaaaaaaaa
aaaaaaaaaaaaaaaaaaaaaaaaaaaaaaaaaaaaaaaaaaaaaaaaaaaaaaaaaaaaaaaaaaaaaaaaaaaaaaaaaaaaaaaaaaaaaaaaaaaaaaaaaaaaaaaaaaaaaaaaaaaaaaaaaaaaaaaaaaaaaaaaaaaaaa
aaaaaaaaaaaaaaaaaaaaaaaaaaaaaaaaaaaaaaaaaaaaaaaaaaaaaaaaaaaaaaaaaaaaaaaaaaaaaaaaaaaaaaaaaaaaaaaaaaaaaaaaaaaaaaaaaaaaaaaaaaaaaaaaaaaaaaaaaaaaaaaaaaaaaa
aaaaaaaaaaaaaaaaaaaaaaaaaaaaaaaaaaaaaaaaaaaaaaaaaaaaaaaaaaaaaaaaaaaaaaaaaaaaaaaaaaaaaaaaaaaaaaaaaaaaaaaaaaaaaaaaaaaaaaaaaaaaaaaaaaaaaaaaaaaaaaaaaaaaaa
aaaaaaaaaaaaaaaaaaaaaaaaaaaaaaaaaaaaaaaaaaaaaaaaaaaaaaaaaaaaaaaaaaaaaaaaaaaaaaaaaaaaaaaaaaaaaaaaaaaaaaaaaaaaaaaaaaaaaaaaaaaaaaaaaaaaaaaaaaaaaaaaaaaaaa
aaaaaaaaaaaaaaaaaaaaaaaaaaaaaaaaaaaaaaaaaaaaaaaaaaaaaaaaaaaaaaaaaaaaaaaaaaaaaaaaaaaaaaaaaaaaaaaaaaaaaaaaaaaaaaaaaaaaaaaaaaaaaaaaaaaaaaaaaaaaaaaaaaaaaa
aaaaaaaaaaaaaaaaaaaaaaaaaaaaaaaaaaaaaaaaaaaaaaaaaaaaaaaaaaaaaaaaaaaaaaaaaaaaaaaaaaaaaaaaaaaaaaaaaaaaaaaaaaaaaaaaaaaaaaaaaaaaaaaaaaaaaaaaaaaaaaaaaaaaaa
aaaaaaaaaaaaaaaaaaaaaaaaaaaaaaaaaaaaaaaaaaaaaaaaaaaaaaaaaaaaaaaaaaaaaaaaaaaaaaaaaaaaaaaaaaaaaaaaaaaaaaaaaaaaaaaaaaaaaaaaaaaaaaaaaaaaaaaaaaaaaaaaaaaaaa
aaaaaaaaaaaaaaaaaaaaaaaaaaaaaaaaaaaaaaaaaaaaaaaaaaaaaaaaaaaaaaaaaaaaaaaaaaaaaaaaaaaaaaaaaaaaaaaaaaaaaaaaaaaaaaaaaaaaaaaaaaaaaaaaaaaaaaaaaaaaaaaaaaaaaa
aaaaaaaaaaaaaaaaaaaaaaaaaaaaaaaaaaaaaaaaaaaaaaaaaaaaaaaaaaaaaaaaaaaaaaaaaaaaaaaaaaaaaaaaaaaaaaaaaaaaaaaaaaaaaaaaaaaaaaaaaaaaaaaaaaaaaaaaaaaaaaaaaaaaaa
aaaaaaaaaaaaaaaaaaaaaaaaaaaaaaaaaaaaaaaaaaaaaaaaaaaaaaaaaaaaaaaaaaaaaaaaaaaaaaaaaaaaaaaaaaaaaaaaaaaaaaaaaaaaaaaaaaaaaaaaaaaaaaaaaaaaaaaaaaaaaaaaaaaaaa
aaaaaaaaaaaaaaaaaaaaaaaaaaaaaaaaaaaaaaaaaaaaaaaaaaaaaaaaaaaaaaaaaaaaaaaaaaaaaaaaaaaaaaaaaaaaaaaaaaaaaaaaaaaaaaaaaaaaaaaaaaaaaaaaaaaaaaaaaaaaaaaaaaaaaa
aaaaaaaaaaaaaaaaaaaaaaaaaaaaaaaaaaaaaaaaaaaaaaaaaaaaaaaaaaaaaaaaaaaaaaaaaaaaaaaaaaaaaaaaaaaaaaaaaaaaaaaaaaaaaaaaaaaaaaaaaaaaaaaaaaaaaaaaaaaaaaaaaaaaaa
aaaaaaaaaaaaaaaaaaaaaaaaaaaaaaaaaaaaaaaaaaaaaaaaaaaaaaaaaaaaaaaaaaaaaaaaaaaaaaaaaaaaaaaaaaaaaaaaaaaaaaaaaaaaaaaaaaaaaaaaaaaaaaaaaaaaaaaaaaaaaaaaaaaaaa
aaaaaaaaaaaaaaaaaaaaaaaaaaaaaaaaaaaaaaaaaaaaaaaaaaaaaaaaaaaaaaaaaaaaaaaaaaaaaaaaaaaaaaaaaaaaaaaaaaaaaaaaaaaaaaaaaaaaaaaaaaaaaaaaaaaaaaaaaaaaaaaaaaaaaa
aaaaaaaaaaaaaaaaaaaaaaaaaaaaaaaaaaaaaaaaaaaaaaaaaaaaaaaaaaaaaaaaaaaaaaaaaaaaaaaaaaaaaaaaaaaaaaaaaaaaaaaaaaaaaaaaaaaaaaaaaaaaaaaaaaaaaaaaaaaaaaaaaaaaaa
aaaaaaaaaaaaaaaaaaaaaaaaaaaaaaaaaaaaaaaaaaaaaaaaaaaaaaaaaaaaaaaaaaaaaaaaaaaaaaaaaaaaaaaaaaaaaaaaaaaaaaaaaaaaaaaaaaaaaaaaaaaaaaaaaaaaaaaaaaaaaaaaaaaaaa
aaaaaaaaaaaaaaaaaaaaaaaaaaaaaaaaaaaaaaaaaaaaaaaaaaaaaaaaaaaaaaaaaaaaaaaaaaaaaaaaaaaaaaaaaaaaaaaaaaaaaaaaaaaaaaaaaaaaaaaaaaaaaaaaaaaaaaaaaaaaaaaaaaaaaa
aaaaaaaaaaaaaaaaaaaaaaaaaaaaaaaaaaaaaaaaaaaaaaaaaaaaaaaaaaaaaaaaaaaaaaaaaaaaaaaaaaaaaaaaaaaaaaaaaaaaaaaaaaaaaaaaaaaaaaaaaaaaaaaaaaaaaaaaaaaaaaaaaaaaaa
aaaaaaaaaaaaaaaaaaaaaaaaaaaaaaaaaaaaaaaaaaaaaaaaaaaaaaaaaaaaaaaaaaaaaaaaaaaaaaaaaaaaaaaaaaaaaaaaaaaaaaaaaaaaaaaaaaaaaaaaaaaaaaaaaaaaaaaaaaaaaaaaaaaaaa
aaaaaaaaaaaaaaaaaaaaaaaaaaaaaaaaaaaaaaaaaaaaaaaaaaaaaaaaaaaaaaaaaaaaaaaaaaaaaaaaaaaaaaaaaaaaaaaaaaaaaaaaaaaaaaaaaaaaaaaaaaaaaaaaaaaaaaaaaaaaaaaaaaaaaa
aaaaaaaaaaaaaaaaaaaaaaaaaaaaaaaaaaaaaaaaaaaaaaaaaaaaaaaaaaaaaaaaaaaaaaaaaaaaaaaaaaaaaaaaaaaaaaaaaaaaaaaaaaaaaaaaaaaaaaaaaaaaaaaaaaaaaaaaaaaaaaaaaaaaaa
aaaaaaaaaaaaaaaaaaaaaaaaaaaaaaaaaaaaaaaaaaaaaaaaaaaaaaaaaaaaaaaaaaaaaaaaaaaaaaaaaaaaaaaaaaaaaaaaaaaaaaaaaaaaaaaaaaaaaaaaaaaaaaaaaaaaaaaaaaaaaaaaaaaaaa
aaaaaaaaaaaaaaaaaaaaaaaaaaaaaaaaaaaaaaaaaaaaaaaaaaaaaaaaaaaaaaaaaaaaaaaaaaaaaaaaaaaaaaaaaaaaaaaaaaaaaaaaaaaaaaaaaaaaaaaaaaaaaaaaaaaaaaaaaaaaaaaaaaaaaa
aaaaaaaaaaaaaaaaaaaaaaaaaaaaaaaaaaaaaaaaaaaaaaaaaaaaaaaaaaaaaaaaaaaaaaaaaaaaaaaaaaaaaaaaaaaaaaaaaaaaaaaaaaaaaaaaaaaaaaaaaaaaaaaaaaaaaaaaaaaaaaaaaaaaaa
aaaaaaaaaaaaaaaaaaaaaaaaaaaaaaaaaaaaaaaaaaaaaaaaaaaaaaaaaaaaaaaaaaaaaaaaaaaaaaaaaaaaaaaaaaaaaaaaaaaaaaaaaaaaaaaaaaaaaaaaaaaaaaaaaaaaaaaaaaaaaaaaaaaaaa
aaaaaaaaaaaaaaaaaaaaaaaaaaaaaaaaaaaaaaaaaaaaaaaaaaaaaaaaaaaaaaaaaaaaaaaaaaaaaaaaaaaaaaaaaaaaaaaaaaaaaaaaaaaaaaaaaaaaaaaaaaaaaaaaaaaaaaaaaaaaaaaaaaaaaa
aaaaaaaaaaaaaaaaaaaaaaaaaaaaaaaaaaaaaaaaaaaaaaaaaaaaaaaaaaaaaaaaaaaaaaaaaaaaaaaaaaaaaaaaaaaaaaaaaaaaaaaaaaaaaaaaaaaaaaaaaaaaaaaaaaaaaaaaaaaaaaaaaaaaaa
aaaaaaaaaaaaaaaaaaaaaaaaaaaaaaaaaaaaaaaaaaaaaaaaaaaaaaaaaaaaaaaaaaaaaaaaaaaaaaaaaaaaaaaaaaaaaaaaaaaaaaaaaaaaaaaaaaaaaaaaaaaaaaaaaaaaaaaaaaaaaaaaaaaaaa
aaaaaaaaaaaaaaaaaaaaaaaaaaaaaaaaaaaaaaaaaaaaaaaaaaaaaaaaaaaaaaaaaaaaaaaaaaaaaaaaaaaaaaaaaaaaaaaaaaaaaaaaaaaaaaaaaaaaaaaaaaaaaaaaaaaaaaaaaaaaaaaaaaaaaa
aaaaaaaaaaaaaaaaaaaaaaaaaaaaaaaaaaaaaaaaaaaaaaaaaaaaaaaaaaaaaaaaaaaaaaaaaaaaaaaaaaaaaaaaaaaaaaaaaaaaaaaaaaaaaaaaaaaaaaaaaaaaaaaaaaaaaaaaaaaaaaaaaaaaaa
aaaaaaaaaaaaaaaaaaaaaaaaaaaaaaaaaaaaaaaaaaaaaaaaaaaaaaaaaaaaaaaaaaaaaaaaaaaaaaaaaaaaaaaaaaaaaaaaaaaaaaaaaaaaaaaaaaaaaaaaaaaaaaaaaaaaaaaaaaaaaaaaaaaaaa
aaaaaaaaaaaaaaaaaaaaaaaaaaaaaaaaaaaaaaaaaaaaaaaaaaaaaaaaaaaaaaaaaaaaaaaaaaaaaaaaaaaaaaaaaaaaaaaaaaaaaaaaaaaaaaaaaaaaaaaaaaaaaaaaaaaaaaaaaaaaaaaaaaaaaa
aaaaaaaaaaaaaaaaaaaaaaaaaaaaaaaaaaaaaaaaaaaaaaaaaaaaaaaaaaaaaaaaaaaaaaaaaaaaaaaaaaaaaaaaaaaaaaaaaaaaaaaaaaaaaaaaaaaaaaaaaaaaaaaaaaaaaaaaaaaaaaaaaaaaaa
aaaaaaaaaaaaaaaaaaaaaaaaaaaaaaaaaaahahahahahaaaaaaaaaaaaaaaaaaaaaaaaacacacacacacacacacacacacacacaaaaaaaaaaaaaaaaaaaaaaaaaaaaaaaaaaaaaaaaaaaaaaaaaaaaaa
aaaaaaaaaaaaaaaaaaaaaaaaaaaaaaaaahahahahahahahacacacacacacacacacacacacadaeagaDaeadaeaDagaeadaeagacaaaaaaaaaaaaaaaaaaaaaaaaaaaaaaaaaaaaaaaaaaaaaaaaaaaa
aaaaaaaaaaaaaaaaaaaaaaaaaaaaaaahahaiajamajaiahaebfbgaNaEbhaeagaeaeaeagaeaeaeaeaeaeaeaeaeaeaeaeaeacacaaaaaaaaaaaaaaaaaaaaaaaaaaaaaaaaaaaaaaaaaaaaaaaaaa
aaaaaaaaaaaaaaaaaaaaaaaaaaaaaaahahaRaRaRaRaRahagaeawawawaeaeaeaebpaeaeaeaeaeaeaeaeaeaeaeaeaeaeaeaeacacacacaaaaaaaaaaaaaaaaaaaaaaaaaaaaaaaaaaaaaaaaaaaa
aaaaaaaaaaaaaaaaaaaaaaaaaaaaaaahahaSaRamaRaRaTaeaeaeaeaeaeaeaeaeaeaeaeaeakaeaebqbqbqbqaebnbnaeaeaeaeaeaeacacacacaaaaaaaaaaaaaaaaaaaaaaaaaaaaaaaaaaaaaa
aaaaaaaaaaaaaaaaaaaaaaaaaaaaaaahahaSaRaRamaRahaeaeaeaeaFaeaeaeaeaeaeaeaGaHaeaeaeaeaeaeaebnbraeaeaebsaeaeaeaeaeacacacaaaaaaaaaaaaaaaaaaaaaaaaaaaaaaaaaa
aaaaaaaaaaaaaaaaaaaaaaaaaaaaaaahahaSaRamaRaRahaeaeaealalagaeaeaeaeaeaealalagaeaeaeaeaeaeaealalagaeaeaebtaeaeaeaeaeacabababababaaaaaaaaaaaaaaaaaaaaaaaa
aaaaaaaaaaaaaaaaaaaaaaaaaaaaaaahahaSamaRamaRahaeaeaeaeaeaeaeaeaeaeaeaeaeaeaeaeaeaeaeaeaeaeaeaeaeaebuaeaeaeaeaeacacacaaaaaaaaaaaaaaaaaaaaaaaaaaaaaaaaaa
aaaaaaaaaaaaaaaaaaaaaaaaaaaaaaahahaRamaRaRaRaTaeaeaeaeaeaeaeaeaeaeaeaeaeaeaeaeaeaeaeaeaeaeaeaeaeaeaeaeaeacacacacaaaaaaaaaaaaaaaaaaaaaaaaaaaaaaaaaaaaaa
aaaaaaaaaaaaaaaaaaaaaaaaaaaaaaahahaRaRaRamaRahagaeaeaeaeaeaeaeaeaeaeaeaeaeaeaeaeaeaeaeaeaeaeaeaeaeacacacacaaaaaaaaaaaaaaaaaaaaaaaaaaaaaaaaaaaaaaaaaaaa
aaaaaaaaaaaaaaaaaaaaaaaaaaaaaaahahaiaRaUaUaiahaeaeaeaeaeanaeagaeaDaDagaeaeaeaeaeaeaeaDaDaeaeaeaganacaaaaaaaaaaaaaaaaaaaaaaaaaaaaaaaaaaaaaaaaaaaaaaaaaa
aaaaaaaaaaaaaaaaaaaaaaaaaaaaaaaaahahahahahahahacacacacacanacacacacacacaeaOaganaeaeaeaDagaOaeaeacaoaaaaaaaaaaaaaaaaaaaaaaaaaaaaaaaaaaaaaaaaaaaaaaaaaaaa
aaaaaaaaaaaaaaaaaaaaaaaaaaaaaaaaaaahahahahahaaaaaaaaaaaaaoaaaaaaaaaaacapacacanacapacacacacapacacaoaaaaaaaaaaaaaaaaaaaaaaaaaaaaaaaaaaaaaaaaaaaaaaaaaaaa
aaaaaaaaaaaaaaaaaaaaaaaaaaaaaaaaaaaaaaaaaaaaaaaaaaaaaaaaaoaaaaaaaaaaaaaaaaaaaoaaaaaaaaaaaaaaaaaaaoaaaaaaaaaaaaaaaaaaaaaaaaaaaaaaaaaaaaaaaaaaaaaaaaaaaa
aaaaaaaaaaaaaaaaaaaaaaaaaaaaaaaaaaaaaaaaaaaaaaaaaaaaaaaaaoaaaaaaaaaaaaaaaaaaaoaaaaaaaaaaaaaaaaaaaoaaaaaaaaaaaaaaaaaaaaaaaaaaaaaaaaaaaaaaaaaaaaaaaaaaaa
aaaaaaaaaaaaaaaaaaaaaaaaaaaaaaaaaaaaaaaaaaaaaaaaaaaaaaaaaoaaaaaaaaaaaaaaaaaaaoaaaaaaaaaaaaaaaaaaaoaaaaaaaaaaaaaaaaaaaaaaaaaaaaaaaaaaaaaaaaaaaaaaaaaaaa
aaaaaaaaaaaaaaaaaaaaaaaaaaaaaaaaaaaaaaaaaaaaaaaaaaaaaaaaaoaaaaaaaaaaaaaaaaaaaoaaaaaaaaaaaaaaaaaaaoaaaaaaaaaaaaaaaaaaaaaaaaaaaaaaaaaaaaaaaaaaaaaaaaaaaa
aaaaaaaaaaaaaaaaaaaaaaaaaaaaaaaaaaaaaVaVaVaVaVaVaVaVaVaaaoaaaaaaaaaaaaaaaaaaaoaaaaaaaaaaararararasaqaqaqaqaqaqaqaaaaaaaaaaaaaaaaaaaaaaaaaaaaaaaaaaaaaa
aaaaaaaaaaaaaaaaaaaaaaaaaaaaaaaaaaaVaVaVaVaVaVaVaVaVaVarasarararararararararasararararararatatauasaqaqbibjbkblaqaqaaaaaaaaaaaaaaaaaaaaaaaaaaaaaaaaaaaa
aaaaaaaaaaaaaaaaaaaaaaaaaaaaaaaaaVaVaWaXaWbmaYaYaYaZaVatasatauavauataPauavauasatauavauaPaPatatatataqaqatbvbvbvataqaqaaaaaaaaaaaaaaaaaaaaaaaaaaaaaaaaaa
aaaaaaaaaaaaaaaaaaaaaaaaaaaaaaaaaVaVbabbaWaWaWaWaWaWaVatatatatatatatatatatatatatatatatatatatatatataqatbwatbwatataxaqaqaaaaaaaaaaaaaaaaaaaaaaaaaaaaaaaa
aaaaaaaaaaaaaaaaaaaaaaaaaaaaaaaaaVaVaWbcaWaWaWaWaWaWbdatatatatatataIaIatatazbxatatataIaIatatatatatayatatatatatatatataqaqaaaaaaaaaaaaaaaaaaaaaaaaaaaaaa
aaaaaaaaaaaaaaaaaaaaaaaaaaaaaaaaaVaVaWaWaWaWaWbyaWbeaVauatatatatbzaIatatatatatatatbxatatatatatatataqauatbwatbwatataAaqaqaqaaaaaaaaaaaaaaaaaaaaaaaaaaaa
aaaaaaaaaaaaaaaaaaaaaaaaaaaaaaaaaVaVbAaWaWbBaWaWaWaWaVaBaBatatatatatatauaBaBaBauatatatatatataBaBauaqatatatatatatataAaqaqaqaqaqaqaqaaaaaaaaaaaaaaaaaaaa
aaaaaaaaaaaaaaaaaaaaaaaaaaaaaaaaaVaVaWaWaWaWaWaWaWaWaVaBaBatatatbxatatataBaBaBatatatatatatataBaBauaqatatatatbwatataAaqaqaqaqaqaqaqaaaaaaaaaaaaaaaaaaaa
aaaaaaaaaaaaaaaaaaaaaaaaaaaaaaaaaVaVaWaWaWaWbBaWaWbeaVauatatatatatatatataJaKaLatatatbxatatataQaMataqaubwatatatatatataqaqaqaaaaaaaaaaaaaaaaaaaaaaaaaaaa
aaaaaaaaaaaaaaaaaaaaaaaaaaaaaaaaaVaVbabcaWaWaWaWaWaWbdatatatatatbxatatatatatatbxatatatatatbobCatatayatatatbwatbwatataqaqaaaaaaaaaaaaaaaaaaaaaaaaaaaaaa
aaaaaaaaaaaaaaaaaaaaaaaaaaaaaaaaaVaVaWbcaWaWaWaWbDaWaVatatatatatatataIatatatatatatatatatatboboatataqatatatatatataxaqaqaaaaaaaaaaaaaaaaaaaaaaaaaaaaaaaa
aaaaaaaaaaaaaaaaaaaaaaaaaaaaaaaaaVaVaWbcaWaWaWaWaWaWaVatatatauatauataIauatauaIatauatauaIatatatatataqaqatbwatatataqaqaaaaaaaaaaaaaaaaaaaaaaaaaaaaaaaaaa
aaaaaaaaaaaaaaaaaaaaaaaaaaaaaaaaaaaVaVaVaVaVaVaVaVaVaVararararaCararararaCararararaCarararatatauataqaqatatatataqaqaaaaaaaaaaaaaaaaaaaaaaaaaaaaaaaaaaaa
aaaaaaaaaaaaaaaaaaaaaaaaaaaaaaaaaaaaaVaVaVaVaVaVaVaVaVaaaaaaaaaaaaaaaaaaaaaaaaaaaaaaaaaaarararararaqaqaqaqaqaqaqaaaaaaaaaaaaaaaaaaaaaaaaaaaaaaaaaaaaaa
aaaaaaaaaaaaaaaaaaaaaaaaaaaaaaaaaaaaaaaaaaaaaaaaaaaaaaaaaaaaaaaaaaaaaaaaaaaaaaaaaaaaaaaaaaaaaaaaaaaaaaaaaaaaaaaaaaaaaaaaaaaaaaaaaaaaaaaaaaaaaaaaaaaaaa
aaaaaaaaaaaaaaaaaaaaaaaaaaaaaaaaaaaaaaaaaaaaaaaaaaaaaaaaaaaaaaaaaaaaaaaaaaaaaaaaaaaaaaaaaaaaaaaaaaaaaaaaaaaaaaaaaaaaaaaaaaaaaaaaaaaaaaaaaaaaaaaaaaaaaa
aaaaaaaaaaaaaaaaaaaaaaaaaaaaaaaaaaaaaaaaaaaaaaaaaaaaaaaaaaaaaaaaaaaaaaaaaaaaaaaaaaaaaaaaaaaaaaaaaaaaaaaaaaaaaaaaaaaaaaaaaaaaaaaaaaaaaaaaaaaaaaaaaaaaaa
aaaaaaaaaaaaaaaaaaaaaaaaaaaaaaaaaaaaaaaaaaaaaaaaaaaaaaaaaaaaaaaaaaaaaaaaaaaaaaaaaaaaaaaaaaaaaaaaaaaaaaaaaaaaaaaaaaaaaaaaaaaaaaaaaaaaaaaaaaaaaaaaaaaaaa
aaaaaaaaaaaaaaaaaaaaaaaaaaaaaaaaaaaaaaaaaaaaaaaaaaaaaaaaaaaaaaaaaaaaaaaaaaaaaaaaaaaaaaaaaaaaaaaaaaaaaaaaaaaaaaaaaaaaaaaaaaaaaaaaaaaaaaaaaaaaaaaaaaaaaa
aaaaaaaaaaaaaaaaaaaaaaaaaaaaaaaaaaaaaaaaaaaaaaaaaaaaaaaaaaaaaaaaaaaaaaaaaaaaaaaaaaaaaaaaaaaaaaaaaaaaaaaaaaaaaaaaaaaaaaaaaaaaaaaaaaaaaaaaaaaaaaaaaaaaaa
aaaaaaaaaaaaaaaaaaaaaaaaaaaaaaaaaaaaaaaaaaaaaaaaaaaaaaaaaaaaaaaaaaaaaaaaaaaaaaaaaaaaaaaaaaaaaaaaaaaaaaaaaaaaaaaaaaaaaaaaaaaaaaaaaaaaaaaaaaaaaaaaaaaaaa
aaaaaaaaaaaaaaaaaaaaaaaaaaaaaaaaaaaaaaaaaaaaaaaaaaaaaaaaaaaaaaaaaaaaaaaaaaaaaaaaaaaaaaaaaaaaaaaaaaaaaaaaaaaaaaaaaaaaaaaaaaaaaaaaaaaaaaaaaaaaaaaaaaaaaa
aaaaaaaaaaaaaaaaaaaaaaaaaaaaaaaaaaaaaaaaaaaaaaaaaaaaaaaaaaaaaaaaaaaaaaaaaaaaaaaaaaaaaaaaaaaaaaaaaaaaaaaaaaaaaaaaaaaaaaaaaaaaaaaaaaaaaaaaaaaaaaaaaaaaaa
afaaaaaaaaaaaaaaaaaaaaaaaaaaaaaaaaaaaaaaaaaaaaaaaaaaaaaaaaaaaaaaaaaaaaaaaaaaaaaaaaaaaaaaaaaaaaaaaaaaaaaaaaaaaaaaaaaaaaaaaaaaaaaaaaaaaaaaaaaaaaaaaaaaaa
"}
