"a" = (/turf/floor/dirt,/area/caribbean)
"b" = (/turf/floor/plating/cobblestone/vertical/dark,/area/caribbean)
"c" = (/turf/floor/plating/road,/area/caribbean)
"d" = (/turf/floor/plating/road/yellowline{icon_state = "road_yellowline"; dir = 4},/area/caribbean)
"e" = (/turf/floor/plating/road/yellowline{icon_state = "road_yellowline"; dir = 8},/area/caribbean)
"f" = (/turf/wall/brick,/area/caribbean)
"g" = (/obj/structure/closet/crate/dumpster,/turf/floor/plating/road,/area/caribbean)
"h" = (/obj/structure/props/junk{icon_state = "Junk_5"},/turf/floor/plating/road,/area/caribbean)
"i" = (/obj/structure/props/junk{icon_state = "Junk_2"},/turf/floor/plating/road,/area/caribbean)
"j" = (/obj/structure/props/junk{icon_state = "Junk_3"},/turf/floor/plating/road,/area/caribbean)
"k" = (/obj/covers/marble_wall/classic,/turf/floor/plating/cobblestone/vertical/dark,/area/caribbean)
"l" = (/obj/structure/simple_door/key_door{code = 9919; desc = "The door to the bank."; name = "Bank Door"},/turf/floor/plating/road,/area/caribbean)
"m" = (/turf/wall/stone/marble,/area/caribbean)
"n" = (/turf/wall/cement,/area/caribbean)
"o" = (/turf/floor/wood,/area/caribbean)
"p" = (/obj/covers/marble_wall/classic,/turf/floor/wood,/area/caribbean)
"q" = (/obj/structure/table/modern/retable,/obj/covers/jail/steeljail,/turf/floor/wood,/area/caribbean)
"r" = (/obj/structure/table/modern/retable,/obj/covers/jail/steeljail{icon = 'icons/obj/structures.dmi'; icon_state = "bars_bank"},/turf/floor/wood,/area/caribbean)
"s" = (/obj/covers/marble_wall/classic,/turf/floor/dirt,/area/caribbean)
"t" = (/obj/structure/table/modern/table,/obj/item/weapon/clipboard,/turf/floor/wood,/area/caribbean)
"u" = (/obj/structure/bed/chair/office/light{icon_state = "officechair_white"; dir = 4},/turf/floor/wood,/area/caribbean)
"v" = (/obj/structure/table/modern/table,/obj/structure/computer/nopower,/turf/floor/wood,/area/caribbean)
"w" = (/obj/structure/table/modern/table,/obj/item/weapon/paper_bin,/turf/floor/wood,/area/caribbean)
"x" = (/obj/structure/table/modern/table,/turf/floor/wood,/area/caribbean)
"y" = (/obj/structure/simple_door/key_door{code = 2987; name = "Office"},/turf/floor/wood,/area/caribbean)
"z" = (/obj/structure/table/modern/table,/obj/item/weapon/clipboard,/obj/item/weapon/pen/pencil,/turf/floor/wood,/area/caribbean)
"A" = (/obj/structure/bed/chair/office/light{icon_state = "officechair_white"; dir = 1},/turf/floor/wood,/area/caribbean)
"B" = (/obj/structure/table/modern/retable,/turf/floor/wood,/area/caribbean)
"C" = (/obj/structure/simple_door/key_door{code = 9919; desc = "The door to the bank."; name = "Bank Door"},/turf/floor/wood,/area/caribbean)
"D" = (/obj/structure/bed/chair/wood/bleacher/l{dir = 8},/turf/floor/wood,/area/caribbean)
"E" = (/obj/structure/bed/chair/wood/bleacher{icon_state = "bleacher"; dir = 8},/turf/floor/wood,/area/caribbean)
"F" = (/obj/structure/bed/chair/wood/bleacher/r{icon_state = "bleacher_r"; dir = 8},/turf/floor/wood,/area/caribbean)
"G" = (/turf/floor/plating/road/yellowline,/area/caribbean)
"H" = (/turf/floor/plating/road/yellowline{icon_state = "road_yellowline"; dir = 1},/area/caribbean)

(1,1,1) = {"
bbbbccccdeccccbbbbffffffffffffffffffffffffffffffffffffffffffffffffffffffffffffff
bbbbccccccccccbbbbffffffffffffffffffffffffffffffffffffffffffffffffffffffffffffff
bbbbccccccccccccccccccccccgggghiccccccccccccccccccccccccccccccccccffffffffffffff
bbbbccccdeccccccccccccccccccccccccccccccccccccccccccccccccccccccccffffffffffffff
bbbbccccdeccccccccccccccccccccccccccccccccccccccccccccccccccccccccffffffffffffff
bbbbccccdeccccccccccccccccccccccccccccccccccccccccccccccccccccccccffffffffffffff
bbbbccccdeccccccccccccccccccccccccccccccccccccccccccccccccccccccccffffffffffffff
bbbbccccccccccccccccccccccccccccccggjggcccccccccccccccccccccccccccffffffffffffff
bbbbccccccccccbbbbkkkkkkkkkkkkkkkkkkkkkklkkkkkkkkkkkkkkkkkkkkkkkkkmmmnnnnnnnnnnn
bbbbccccdeccccbbbbkoooooooooooooopoooooooooooooooooooooooooooooooooomnnnnnnnnnnn
bbbbccccdeccccbbbbkoooooooooooooopoooooooooooooooooooooooooooooooooomnnnnnnnnnnn
bbbbccccdeccccbbbbkoooooooooooooopoooooooooooooooooooooooooooooooooomnnnnnnnnnnn
bbbbccccdeccccbbbbkoooooooooooooopoooooooooooooooooooooooooooooooooomnnnnnnnnnnn
bbbbccccccccccbbbbkoooooooooooooopoooooooooooooooooooooooooooooooooomnnnnnnnnnnn
bbbbccccccccccbbbbkoooooooooooooopoooooooooooooooooooooooooooooooooomnnnnnnnnnnn
bbbbccccdeccccbbbbkoooooooooooooopoooooooooooooooooooooooooooooooooomnnnnnnnnnnn
bbbbccccdeccccbbbbkoooooooooooooopoooooooooooooooooooooooooooooooooomnnnnnnnnnnn
bbbbccccdeccccbbbbkoooooooooooooopoooooooooooooooooooooooooooooooooomnnnnnnnnnnn
bbbbccccdeccccbbbbkoooooooooooooopoooooooooooooooooooooooooooooooooomnnnnnnnnnnn
bbbbccccccccccbbbbkoooooooooooooopoooooooooooooooooooooooooooooooooomnnnnnnnnnnn
bbbbccccccccccbbbbkoooooooooooooopoooooooooooooooooooooooooooooooooomnnnnnnnnnnn
bbbbccccdeccccbbbbkoooooooooooooopoooooooooooooooooooooooooooooooooomnnnnnnnnnnn
bbbbccccdeccccbbbbkoooooooooooooopoooooooooooooooooooooooooooooooooomnnnnnnnnnnn
bbbbccccdeccccbbbbkoooooooooooooopoooooooooooooooooooooooooooooooooomnnnnnnnnnnn
bbbbccccdeccccbbbbkooooooooooooooqoooooooooooooooooooooooooooooooooomnnnnnnnnnnn
bbbbccccccccccbbbbkooooooooooooooroooooooooooooooooooooooooooooooooomnnnnnnnnnnn
bbbbccccccccccbbbbkooooooooooooooqoooooooooooooooooooooooooooooooooosooootooooon
bbbbccccdeccccbbbbkoooooooooooooopoooooooooooooooooooooooooooooooooosooouvooooon
bbbbccccdeccccbbbbkoooooooooooooopoooooooooooooooooooooooooooooooooosooowxooooon
bbbbccccdeccccbbbbkoooooooooooooopoooooooooooooooooooooooooooooooooosoooooooooon
bbbbccccdeccccbbbbkooooooooooooooqoooooooooooooooooooooooooooooooooosooooooooooy
bbbbccccccccccbbbbkooooooooooooooroooooooooooooooooooooooooooooooooosoooooooooon
bbbbccccccccccbbbbkooooooooooooooqooooooooooooooooooooooooooooooooooszvxooooxvzn
bbbbccccdeccccbbbbkoooooooooooooopoooooooooooooooooooooooooooooooooosoAwoooowAon
bbbbccccdeccccbbbbkoooooooooooooopoooooooooooooooooooooooooooooooooosoooooooooon
bbbbccccdeccccbbbbkooooooooooooooqoooooooooooooooooooooooooooooooooomnnnnnnnnnnn
bbbbccccdeccccbbbbkooooooooooooooBoooooooooooooooooooooooooooooooooomnnnnnnnnnnn
bbbbccccccccccbbbbkooooooooooooooqoooooooooooooooooooooooooooooooooomnnnnnnnnnnn
bbbbccccccccccbbbbkoooooooooooooopoooooooooooooooooooooooooooooooooomnnnnnnnnnnn
bbbbccccdeccccbbbbkoooooooooooooopoooooooooooooooooooooooooooooooooomnnnnnnnnnnn
bbbbccccdeccccbbbbkoooooooooooooopoooooooooooooooooooooooooooooooooomnnnnnnnnnnn
bbbbccccdeccccbbbbkoooooooooooooopoooooooooooooooooooooooooooooooooomnnnnnnnnnnn
bbbbccccdeccccbbbbkooooooooooooooqoooooooooooooooooooooooooooooooooomnnnnnnnnnnn
bbbbccccccccccbbbbkooooooooooooooroooooooooooooooooooooooooooooooooomnnnnnnnnnnn
bbbbccccccccccbbbbkooooooooooooooqoooooooooooooooooooooooooooooooooomnnnnnnnnnnn
bbbbccccdeccccbbbbkoooooooooooooopoooooooooooooooooooooooooooooooooomnnnnnnnnnnn
bbbbccccdeccccbbbbkoooooooooooooopoooooooooooooooooooooooooooooooooomnnnnnnnnnnn
bbbbccccdeccccbbbbkoooooooooooooopoooooooooooooooooooooooooooooooooomnnnnnnnnnnn
bbbbccccdeccccbbbbkoooooooppppCCppoooooooooooooooooooooooooooooooooomnnnnnnnnnnn
bbbbccccccccccbbbbkooooooopooooooooooooooooooooooooooooooooooooooooomnnnnnnnnnnn
bbbbccccccccccbbbbkooooooDpooooooooooooooooooooooooooooooooooooooooomnnnnnnnnnnn
bbbbccccdeccccbbbbkooooooEpooooooooooooooooooooooooooooooooooooooooomnnnnnnnnnnn
bbbbccccdeccccbbbbkooooooEpooooooooooooooooooooooooooooooooooooooooomnnnnnnnnnnn
bbbbccccdeccccbbbbkooooooEpooooooooooooooooooooooooooooooooooooooooomnnnnnnnnnnn
bbbbccccdeccccbbbbkooooooFpooooooooooooooooooooooooooooooooooooooooomnnnnnnnnnnn
bbbbccccccccccbbbbkooooooopooooooooooooooooooooooooooooooooooooooooomnnnnnnnnnnn
bbbbccccccccccbbbbkkkkkkkkkkkkkkkkkkkkkkkkkkkkkkkkkkkkkkkkkkkkkkkkkkmnnnnnnnnnnn
bbbbccccdeccccbbbbbbbbbbbbbbbbbbbbbbbbbbbbbbbbbbbbbbbbbbbbbbbbbbbbbbbbbbbbbbbbbb
bbbbccccdeccccbbbbbbbbbbbbbbbbbbbbbbbbbbbbbbbbbbbbbbbbbbbbbbbbbbbbbbbbbbbbbbbbbb
bbbbccccdeccccbbbbbbbbbbbbbbbbbbbbbbbbbbbbbbbbbbbbbbbbbbbbbbbbbbbbbbbbbbbbbbbbbb
bbbbccccccccccbbbbbbbbbbbbbbbbbbbbbbbbbbbbbbbbbbbbbbbbbbbbbbbbbbbbbbbbbbbbbbbbbb
cccccccccccccccccccccccccccccccccccccccccccccccccccccccccccccccccccccccccccccccc
cccccccccccccccccccccccccccccccccccccccccccccccccccccccccccccccccccccccccccccccc
cccccccccccccccccccccccccccccccccccccccccccccccccccccccccccccccccccccccccccccccc
cccccccccccccccccccccccccccccccccccccccccccccccccccccccccccccccccccccccccccccccc
GGGGccGGGGccGGGGccGGGGccGGGGccGGGGccGGGGccGGGGccGGGGccGGGGccGGGGccGGGGccGGGGccGG
HHHHccHHHHccHHHHccHHHHccHHHHccHHHHccHHHHccHHHHccHHHHccHHHHccHHHHccHHHHccHHHHccHH
cccccccccccccccccccccccccccccccccccccccccccccccccccccccccccccccccccccccccccccccc
cccccccccccccccccccccccccccccccccccccccccccccccccccccccccccccccccccccccccccccccc
cccccccccccccccccccccccccccccccccccccccccccccccccccccccccccccccccccccccccccccccc
cccccccccccccccccccccccccccccccccccccccccccccccccccccccccccccccccccccccccccccccc
bbbbbbbbbbbbbbbbbbbbbbbbbbbbbbbbbbbbbbbbbbbbbbbbbbbbbbbbbbbbbbbbbbbbbbbbbbbbbbbb
bbbbbbbbbbbbbbbbbbbbbbbbbbbbbbbbbbbbbbbbbbbbbbbbbbbbbbbbbbbbbbbbbbbbbbbbbbbbbbbb
bbbbbbbbbbbbbbbbbbbbbbbbbbbbbbbbbbbbbbbbbbbbbbbbbbbbbbbbbbbbbbbbbbbbbbbbbbbbbbbb
bbbbbbbbbbbbbbbbbbbbbbbbbbbbbbbbbbbbbbbbbbbbbbbbbbbbbbbbbbbbbbbbbbbbbbbbbbbbbbbb
"}

(1,1,2) = {"
aaaaaaaaaaaaaaaaaaaaaaaaaaaaaaaaaaaaaaaaaaaaaaaaaaaaaaaaaaaaaaaaaaaaaaaaaaaaaaaa
aaaaaaaaaaaaaaaaaaaaaaaaaaaaaaaaaaaaaaaaaaaaaaaaaaaaaaaaaaaaaaaaaaaaaaaaaaaaaaaa
aaaaaaaaaaaaaaaaaaaaaaaaaaaaaaaaaaaaaaaaaaaaaaaaaaaaaaaaaaaaaaaaaaaaaaaaaaaaaaaa
aaaaaaaaaaaaaaaaaaaaaaaaaaaaaaaaaaaaaaaaaaaaaaaaaaaaaaaaaaaaaaaaaaaaaaaaaaaaaaaa
aaaaaaaaaaaaaaaaaaaaaaaaaaaaaaaaaaaaaaaaaaaaaaaaaaaaaaaaaaaaaaaaaaaaaaaaaaaaaaaa
aaaaaaaaaaaaaaaaaaaaaaaaaaaaaaaaaaaaaaaaaaaaaaaaaaaaaaaaaaaaaaaaaaaaaaaaaaaaaaaa
aaaaaaaaaaaaaaaaaaaaaaaaaaaaaaaaaaaaaaaaaaaaaaaaaaaaaaaaaaaaaaaaaaaaaaaaaaaaaaaa
aaaaaaaaaaaaaaaaaaaaaaaaaaaaaaaaaaaaaaaaaaaaaaaaaaaaaaaaaaaaaaaaaaaaaaaaaaaaaaaa
aaaaaaaaaaaaaaaaaaaaaaaaaaaaaaaaaaaaaaaaaaaaaaaaaaaaaaaaaaaaaaaaaaaaaaaaaaaaaaaa
aaaaaaaaaaaaaaaaaaaaaaaaaaaaaaaaaaaaaaaaaaaaaaaaaaaaaaaaaaaaaaaaaaaaaaaaaaaaaaaa
aaaaaaaaaaaaaaaaaaaaaaaaaaaaaaaaaaaaaaaaaaaaaaaaaaaaaaaaaaaaaaaaaaaaaaaaaaaaaaaa
aaaaaaaaaaaaaaaaaaaaaaaaaaaaaaaaaaaaaaaaaaaaaaaaaaaaaaaaaaaaaaaaaaaaaaaaaaaaaaaa
aaaaaaaaaaaaaaaaaaaaaaaaaaaaaaaaaaaaaaaaaaaaaaaaaaaaaaaaaaaaaaaaaaaaaaaaaaaaaaaa
aaaaaaaaaaaaaaaaaaaaaaaaaaaaaaaaaaaaaaaaaaaaaaaaaaaaaaaaaaaaaaaaaaaaaaaaaaaaaaaa
aaaaaaaaaaaaaaaaaaaaaaaaaaaaaaaaaaaaaaaaaaaaaaaaaaaaaaaaaaaaaaaaaaaaaaaaaaaaaaaa
aaaaaaaaaaaaaaaaaaaaaaaaaaaaaaaaaaaaaaaaaaaaaaaaaaaaaaaaaaaaaaaaaaaaaaaaaaaaaaaa
aaaaaaaaaaaaaaaaaaaaaaaaaaaaaaaaaaaaaaaaaaaaaaaaaaaaaaaaaaaaaaaaaaaaaaaaaaaaaaaa
aaaaaaaaaaaaaaaaaaaaaaaaaaaaaaaaaaaaaaaaaaaaaaaaaaaaaaaaaaaaaaaaaaaaaaaaaaaaaaaa
aaaaaaaaaaaaaaaaaaaaaaaaaaaaaaaaaaaaaaaaaaaaaaaaaaaaaaaaaaaaaaaaaaaaaaaaaaaaaaaa
aaaaaaaaaaaaaaaaaaaaaaaaaaaaaaaaaaaaaaaaaaaaaaaaaaaaaaaaaaaaaaaaaaaaaaaaaaaaaaaa
aaaaaaaaaaaaaaaaaaaaaaaaaaaaaaaaaaaaaaaaaaaaaaaaaaaaaaaaaaaaaaaaaaaaaaaaaaaaaaaa
aaaaaaaaaaaaaaaaaaaaaaaaaaaaaaaaaaaaaaaaaaaaaaaaaaaaaaaaaaaaaaaaaaaaaaaaaaaaaaaa
aaaaaaaaaaaaaaaaaaaaaaaaaaaaaaaaaaaaaaaaaaaaaaaaaaaaaaaaaaaaaaaaaaaaaaaaaaaaaaaa
aaaaaaaaaaaaaaaaaaaaaaaaaaaaaaaaaaaaaaaaaaaaaaaaaaaaaaaaaaaaaaaaaaaaaaaaaaaaaaaa
aaaaaaaaaaaaaaaaaaaaaaaaaaaaaaaaaaaaaaaaaaaaaaaaaaaaaaaaaaaaaaaaaaaaaaaaaaaaaaaa
aaaaaaaaaaaaaaaaaaaaaaaaaaaaaaaaaaaaaaaaaaaaaaaaaaaaaaaaaaaaaaaaaaaaaaaaaaaaaaaa
aaaaaaaaaaaaaaaaaaaaaaaaaaaaaaaaaaaaaaaaaaaaaaaaaaaaaaaaaaaaaaaaaaaaaaaaaaaaaaaa
aaaaaaaaaaaaaaaaaaaaaaaaaaaaaaaaaaaaaaaaaaaaaaaaaaaaaaaaaaaaaaaaaaaaaaaaaaaaaaaa
aaaaaaaaaaaaaaaaaaaaaaaaaaaaaaaaaaaaaaaaaaaaaaaaaaaaaaaaaaaaaaaaaaaaaaaaaaaaaaaa
aaaaaaaaaaaaaaaaaaaaaaaaaaaaaaaaaaaaaaaaaaaaaaaaaaaaaaaaaaaaaaaaaaaaaaaaaaaaaaaa
aaaaaaaaaaaaaaaaaaaaaaaaaaaaaaaaaaaaaaaaaaaaaaaaaaaaaaaaaaaaaaaaaaaaaaaaaaaaaaaa
aaaaaaaaaaaaaaaaaaaaaaaaaaaaaaaaaaaaaaaaaaaaaaaaaaaaaaaaaaaaaaaaaaaaaaaaaaaaaaaa
aaaaaaaaaaaaaaaaaaaaaaaaaaaaaaaaaaaaaaaaaaaaaaaaaaaaaaaaaaaaaaaaaaaaaaaaaaaaaaaa
aaaaaaaaaaaaaaaaaaaaaaaaaaaaaaaaaaaaaaaaaaaaaaaaaaaaaaaaaaaaaaaaaaaaaaaaaaaaaaaa
aaaaaaaaaaaaaaaaaaaaaaaaaaaaaaaaaaaaaaaaaaaaaaaaaaaaaaaaaaaaaaaaaaaaaaaaaaaaaaaa
aaaaaaaaaaaaaaaaaaaaaaaaaaaaaaaaaaaaaaaaaaaaaaaaaaaaaaaaaaaaaaaaaaaaaaaaaaaaaaaa
aaaaaaaaaaaaaaaaaaaaaaaaaaaaaaaaaaaaaaaaaaaaaaaaaaaaaaaaaaaaaaaaaaaaaaaaaaaaaaaa
aaaaaaaaaaaaaaaaaaaaaaaaaaaaaaaaaaaaaaaaaaaaaaaaaaaaaaaaaaaaaaaaaaaaaaaaaaaaaaaa
aaaaaaaaaaaaaaaaaaaaaaaaaaaaaaaaaaaaaaaaaaaaaaaaaaaaaaaaaaaaaaaaaaaaaaaaaaaaaaaa
aaaaaaaaaaaaaaaaaaaaaaaaaaaaaaaaaaaaaaaaaaaaaaaaaaaaaaaaaaaaaaaaaaaaaaaaaaaaaaaa
aaaaaaaaaaaaaaaaaaaaaaaaaaaaaaaaaaaaaaaaaaaaaaaaaaaaaaaaaaaaaaaaaaaaaaaaaaaaaaaa
aaaaaaaaaaaaaaaaaaaaaaaaaaaaaaaaaaaaaaaaaaaaaaaaaaaaaaaaaaaaaaaaaaaaaaaaaaaaaaaa
aaaaaaaaaaaaaaaaaaaaaaaaaaaaaaaaaaaaaaaaaaaaaaaaaaaaaaaaaaaaaaaaaaaaaaaaaaaaaaaa
aaaaaaaaaaaaaaaaaaaaaaaaaaaaaaaaaaaaaaaaaaaaaaaaaaaaaaaaaaaaaaaaaaaaaaaaaaaaaaaa
aaaaaaaaaaaaaaaaaaaaaaaaaaaaaaaaaaaaaaaaaaaaaaaaaaaaaaaaaaaaaaaaaaaaaaaaaaaaaaaa
aaaaaaaaaaaaaaaaaaaaaaaaaaaaaaaaaaaaaaaaaaaaaaaaaaaaaaaaaaaaaaaaaaaaaaaaaaaaaaaa
aaaaaaaaaaaaaaaaaaaaaaaaaaaaaaaaaaaaaaaaaaaaaaaaaaaaaaaaaaaaaaaaaaaaaaaaaaaaaaaa
aaaaaaaaaaaaaaaaaaaaaaaaaaaaaaaaaaaaaaaaaaaaaaaaaaaaaaaaaaaaaaaaaaaaaaaaaaaaaaaa
aaaaaaaaaaaaaaaaaaaaaaaaaaaaaaaaaaaaaaaaaaaaaaaaaaaaaaaaaaaaaaaaaaaaaaaaaaaaaaaa
aaaaaaaaaaaaaaaaaaaaaaaaaaaaaaaaaaaaaaaaaaaaaaaaaaaaaaaaaaaaaaaaaaaaaaaaaaaaaaaa
aaaaaaaaaaaaaaaaaaaaaaaaaaaaaaaaaaaaaaaaaaaaaaaaaaaaaaaaaaaaaaaaaaaaaaaaaaaaaaaa
aaaaaaaaaaaaaaaaaaaaaaaaaaaaaaaaaaaaaaaaaaaaaaaaaaaaaaaaaaaaaaaaaaaaaaaaaaaaaaaa
aaaaaaaaaaaaaaaaaaaaaaaaaaaaaaaaaaaaaaaaaaaaaaaaaaaaaaaaaaaaaaaaaaaaaaaaaaaaaaaa
aaaaaaaaaaaaaaaaaaaaaaaaaaaaaaaaaaaaaaaaaaaaaaaaaaaaaaaaaaaaaaaaaaaaaaaaaaaaaaaa
aaaaaaaaaaaaaaaaaaaaaaaaaaaaaaaaaaaaaaaaaaaaaaaaaaaaaaaaaaaaaaaaaaaaaaaaaaaaaaaa
aaaaaaaaaaaaaaaaaaaaaaaaaaaaaaaaaaaaaaaaaaaaaaaaaaaaaaaaaaaaaaaaaaaaaaaaaaaaaaaa
aaaaaaaaaaaaaaaaaaaaaaaaaaaaaaaaaaaaaaaaaaaaaaaaaaaaaaaaaaaaaaaaaaaaaaaaaaaaaaaa
aaaaaaaaaaaaaaaaaaaaaaaaaaaaaaaaaaaaaaaaaaaaaaaaaaaaaaaaaaaaaaaaaaaaaaaaaaaaaaaa
aaaaaaaaaaaaaaaaaaaaaaaaaaaaaaaaaaaaaaaaaaaaaaaaaaaaaaaaaaaaaaaaaaaaaaaaaaaaaaaa
aaaaaaaaaaaaaaaaaaaaaaaaaaaaaaaaaaaaaaaaaaaaaaaaaaaaaaaaaaaaaaaaaaaaaaaaaaaaaaaa
aaaaaaaaaaaaaaaaaaaaaaaaaaaaaaaaaaaaaaaaaaaaaaaaaaaaaaaaaaaaaaaaaaaaaaaaaaaaaaaa
aaaaaaaaaaaaaaaaaaaaaaaaaaaaaaaaaaaaaaaaaaaaaaaaaaaaaaaaaaaaaaaaaaaaaaaaaaaaaaaa
aaaaaaaaaaaaaaaaaaaaaaaaaaaaaaaaaaaaaaaaaaaaaaaaaaaaaaaaaaaaaaaaaaaaaaaaaaaaaaaa
aaaaaaaaaaaaaaaaaaaaaaaaaaaaaaaaaaaaaaaaaaaaaaaaaaaaaaaaaaaaaaaaaaaaaaaaaaaaaaaa
aaaaaaaaaaaaaaaaaaaaaaaaaaaaaaaaaaaaaaaaaaaaaaaaaaaaaaaaaaaaaaaaaaaaaaaaaaaaaaaa
aaaaaaaaaaaaaaaaaaaaaaaaaaaaaaaaaaaaaaaaaaaaaaaaaaaaaaaaaaaaaaaaaaaaaaaaaaaaaaaa
aaaaaaaaaaaaaaaaaaaaaaaaaaaaaaaaaaaaaaaaaaaaaaaaaaaaaaaaaaaaaaaaaaaaaaaaaaaaaaaa
aaaaaaaaaaaaaaaaaaaaaaaaaaaaaaaaaaaaaaaaaaaaaaaaaaaaaaaaaaaaaaaaaaaaaaaaaaaaaaaa
aaaaaaaaaaaaaaaaaaaaaaaaaaaaaaaaaaaaaaaaaaaaaaaaaaaaaaaaaaaaaaaaaaaaaaaaaaaaaaaa
aaaaaaaaaaaaaaaaaaaaaaaaaaaaaaaaaaaaaaaaaaaaaaaaaaaaaaaaaaaaaaaaaaaaaaaaaaaaaaaa
aaaaaaaaaaaaaaaaaaaaaaaaaaaaaaaaaaaaaaaaaaaaaaaaaaaaaaaaaaaaaaaaaaaaaaaaaaaaaaaa
aaaaaaaaaaaaaaaaaaaaaaaaaaaaaaaaaaaaaaaaaaaaaaaaaaaaaaaaaaaaaaaaaaaaaaaaaaaaaaaa
aaaaaaaaaaaaaaaaaaaaaaaaaaaaaaaaaaaaaaaaaaaaaaaaaaaaaaaaaaaaaaaaaaaaaaaaaaaaaaaa
aaaaaaaaaaaaaaaaaaaaaaaaaaaaaaaaaaaaaaaaaaaaaaaaaaaaaaaaaaaaaaaaaaaaaaaaaaaaaaaa
aaaaaaaaaaaaaaaaaaaaaaaaaaaaaaaaaaaaaaaaaaaaaaaaaaaaaaaaaaaaaaaaaaaaaaaaaaaaaaaa
"}
