"a" = (/turf/floor/wood,/area/caribbean)
"b" = (/obj/structure/table/modern/table,/obj/structure/computer/nopower,/turf/floor/wood,/area/caribbean)
"d" = (/obj/structure/table/modern/table,/obj/item/weapon/clipboard,/turf/floor/wood,/area/caribbean)
"e" = (/obj/structure/props/junk{icon_state = "Junk_2"},/turf/floor/plating/road,/area/caribbean)
"f" = (/obj/structure/bed/chair/wood/bleacher{icon_state = "bleacher"; dir = 8},/turf/floor/wood,/area/caribbean)
"g" = (/obj/structure/simple_door/key_door{code = 9919; desc = "The door to the bank."; name = "Bank Door"},/turf/floor/wood,/area/caribbean)
"h" = (/obj/structure/multiz/stairs/enter/bottom{dir = 4},/turf/floor/wood,/area/caribbean)
"i" = (/obj/structure/railing/steel{icon_state = "railing0"; dir = 4},/obj/structure/railing/steel,/turf/floor/wood,/area/caribbean)
"j" = (/obj/structure/railing/steel,/turf/floor/wood,/area/caribbean)
"k" = (/obj/structure/railing/steel,/obj/structure/railing/steel{icon_state = "railing0"; dir = 8},/turf/floor/wood,/area/caribbean)
"l" = (/obj/structure/bed/chair/office/light{icon_state = "officechair_white"; dir = 1},/turf/floor/wood,/area/caribbean)
"m" = (/obj/structure/multiz/stairs/enter{dir = 4},/turf/floor/wood,/area/caribbean)
"n" = (/obj/covers/marble_wall/classic,/turf/floor/wood,/area/caribbean)
"o" = (/turf/floor/plating/road/yellowline{icon_state = "road_yellowline"; dir = 4},/area/caribbean)
"p" = (/turf/floor/plating/cobblestone/vertical/dark,/area/caribbean)
"q" = (/obj/structure/bed/chair/wood/bleacher/r{dir = 4},/turf/floor/wood,/area/caribbean)
"r" = (/turf/floor/plating/road,/area/caribbean)
"s" = (/obj/structure/bed/chair/wood/bleacher/l{dir = 4},/turf/floor/wood,/area/caribbean)
"t" = (/obj/structure/table/modern/table,/obj/item/weapon/paper_bin,/turf/floor/wood,/area/caribbean)
"u" = (/obj/structure/table/modern/table,/obj/item/weapon/clipboard,/obj/item/weapon/pen/pencil,/turf/floor/wood,/area/caribbean)
"v" = (/obj/structure/simple_door/key_door{code = 2987; name = "Office"},/turf/floor/wood,/area/caribbean)
"w" = (/turf/wall/brick,/area/caribbean)
"x" = (/turf/floor/plating/road/yellowline,/area/caribbean)
"z" = (/obj/structure/simple_door/key_door/anyone/wood{name = "Bank Door"},/turf/floor/wood,/area/caribbean)
"A" = (/obj/structure/railing/steel{icon_state = "railing0"; dir = 4},/turf/floor/wood,/area/caribbean)
"C" = (/obj/structure/table/modern/retable,/obj/covers/jail/steeljail,/turf/floor/wood,/area/caribbean)
"D" = (/obj/structure/table/modern/retable,/obj/covers/jail/steeljail{icon = 'icons/obj/structures.dmi'; icon_state = "bars_bank"},/turf/floor/wood,/area/caribbean)
"E" = (/turf/floor/plating/road/yellowline{icon_state = "road_yellowline"; dir = 8},/area/caribbean)
"F" = (/obj/structure/closet/crate/bin,/turf/floor/wood,/area/caribbean)
"G" = (/obj/structure/bed/chair/wood/bleacher{dir = 4},/turf/floor/wood,/area/caribbean)
"H" = (/obj/structure/closet/crate/dumpster,/turf/floor/plating/road,/area/caribbean)
"I" = (/obj/covers/marble_wall/classic,/turf/floor/dirt,/area/caribbean)
"J" = (/obj/structure/railing/steel{icon_state = "railing0"; dir = 8},/turf/floor/wood,/area/caribbean)
"K" = (/turf/wall/cement,/area/caribbean)
"N" = (/obj/covers/marble_wall/classic,/turf/floor/plating/cobblestone/vertical/dark,/area/caribbean)
"O" = (/turf/wall/stone/marble,/area/caribbean)
"P" = (/obj/structure/props/junk{icon_state = "Junk_3"},/turf/floor/plating/road,/area/caribbean)
"Q" = (/obj/structure/props/junk{icon_state = "Junk_5"},/turf/floor/plating/road,/area/caribbean)
"R" = (/obj/structure/table/modern/table,/turf/floor/wood,/area/caribbean)
"S" = (/turf/floor/broken_floor,/area/caribbean)
"T" = (/turf/floor/plating/road/yellowline{icon_state = "road_yellowline"; dir = 1},/area/caribbean)
"U" = (/obj/structure/bed/chair/office/light{icon_state = "officechair_white"; dir = 4},/turf/floor/wood,/area/caribbean)
"W" = (/obj/structure/window/clean,/turf/floor/wood,/area/caribbean)
"Y" = (/obj/structure/bed/chair/wood/bleacher/r{dir = 8},/turf/floor/wood,/area/caribbean)
"Z" = (/obj/structure/bed/chair/wood/bleacher/l{dir = 8},/turf/floor/wood,/area/caribbean)

(1,1,1) = {"
pppprrrroErrrrppppwwwwwwwwwwwwwwwwwwwwwwwwwwwwwwwwwwwwwwwwwwwwwwwwwwwwwwwwwwwwww
pppprrrrrrrrrrppppwwwwwwwwwwwwwwwwwwwwwwwwwwwwwwwwwwwwwwwwwwwwwwwwwwwwwwwwwwwwww
pppprrrrrrrrrrrrrrrrrrrrrrHHHHQerrrrrrrrrrrrrrrrrrrrrrrrrrrrrrrrrrwwwwwwwwwwwwww
pppprrrroErrrrrrrrrrrrrrrrrrrrrrrrrrrrrrrrrrrrrrrrrrrrrrrrrrrrrrrrwwwwwwwwwwwwww
pppprrrroErrrrrrrrrrrrrrrrrrrrrrrrrrrrrrrrrrrrrrrrrrrrrrrrrrrrrrrrwwwwwwwwwwwwww
pppprrrroErrrrrrrrrrrrrrrrrrrrrrrrrrrrrrrrrrrrrrrrrrrrrrrrrrrrrrrrwwwwwwwwwwwwww
pppprrrroErrrrrrrrrrrrrrrrrrrrrrrrrrrrrrrrrrrrrrrrrrrrrrrrrrrrrrrrwwwwwwwwwwwwww
pppprrrrrrrrrrrrrrrrrrrrrrrrrrrrrrHHPHHrrrrrrrrrrrrrrrrrrrrrrrrrrrwwwwwwwwwwwwww
pppprrrrrrrrrrppppnnnnnnnnnnnnnnnnnnnnnngnnnnnnnnnnnnnnnnnnnnnnnNNOOOKKKKKKKKKKK
pppprrrroErrrrppppnaaaaahhhhhhhhhnaaaaaaaaaaaaaaaaaaaaaaaaaaaaaaaaaaOKKKKKKKKKKK
pppprrrroErrrrppppnaaaaahhhhhhhhhnaaaaaaaaaaaaaaaaaaaaaaaaaaaaaaaaaaOKKKKKKKKKKK
pppprrrroErrrrppppnaaaaahhhhhhhhhnaaaaaaaaaaaaaaaaaaaaaaaaaaaaaaaaaaOKKKKKKKKKKK
pppprrrroErrrrppppnaaaannnnnnnnnnnaaaaaaaaaaaaaaaaaaaaaaaaaaaaaaaaaaOKKKKKKKKKKK
pppprrrrrrrrrrppppnaaaaaaaaaaaaaanaaaaaaaaaaaaaaaaaaaaaaaaaaaaaaaaaaOKKKKKKKKKKK
pppprrrrrrrrrrppppnaaaaaaaaaaaaaanaaaaaaaaaaaaaaaaaaaaaaaaaaaaaaaaaaOKKKKKKKKKKK
pppprrrroErrrrppppnaaaaaaaaaaaaaanaaaaaaaaaaaaaaaaaaaaaaaaaaaaaaaaaaOKKKKKKKKKKK
pppprrrroErrrrppppzaaaaaaaaaaaaaanaaaaaaaaaaaaaaaaaaaaaaaaaaaaaaaaaaOKKKKKKKKKKK
pppprrrroErrrrppppzaaaaaaaaaaaaaanaaaaaaaaaaaaaaaaaaaaaaaaaaaaaaaaaaOKKKKKKKKKKK
pppprrrroErrrrppppzaaaaaaaaaaaaaanaaaaaaaaaaaaaaaaaaaaaaaaaaaaaaaaaaOKKKKKKKKKKK
pppprrrrrrrrrrppppnFaaaaaaaaaaaaanaaaaaaaaaaaaaaaaaaaaaaaaaaaaaaaaaaOKKKKKKKKKKK
pppprrrrrrrrrrppppnsaaaaaaaaaaaaanaaaaaaaaaaaaaaaaaaaaaaaaaaaaaaaaaaOKKKKKKKKKKK
pppprrrroErrrrppppnGaaaaaaaaaaaaanaaaaaaaaaaaaaaaaaaaaaaaaaaaaaaaaaaOKKKKKKKKKKK
pppprrrroErrrrppppnGaaaaaaaaaajjanaaaaaaaaaaaaaaaaaaaaaaaaaaaaaaaaaaOKKKKKKKKKKK
pppprrrroErrrrppppnGaaaaaaaaaAaaJnaaaaaaaaaaaaaaaaaaaaaaaaaaaaaaaaaaOKKKKKKKKKKK
pppprrrroErrrrppppnqaaaaaaaajiAakCaaaaaaaaaaaaaaaaaaaaaaaaaaaaaaaaaaOKKKKKKKKKKK
pppprrrrrrrrrrppppWaaaaaaaaajjijjDaaaaaaaaaaaaaaaaaaaaaaaaaaaaaaaaaaOKKKKKKKKKKK
pppprrrrrrrrrrppppWaaaaaaaaaaaaaaCaaaaaaaaaaaaaaaaaaaaaaaaaaaaaaaaaaIaaaadaaaaaK
pppprrrroErrrrppppWaaaaaaaaaaaaaanaaaaaaaaaaaaaaaaaaaaaaaaaaaaaaaaaaIaaaUbaaaaaK
pppprrrroErrrrppppnFaaaaaaaaaajjanaaaaaaaaaaaaaaaaaaaaaaaaaaaaaaaaaaIaaatRaaaaaK
pppprrrroErrrrppppnsaaaaaaaaaAaaJnaaaaaaaaaaaaaaaaaaaaaaaaaaaaaaaaaaIaaaaaaaaaaK
pppprrrroErrrrppppnGaaaaaaaajiAakCaaaaaaaaaaaaaaaaaaaaaaaaaaaaaaaaaaIaaaaaaaaaav
pppprrrrrrrrrrppppnGaaaaaaaajjijjDaaaaaaaaaaaaaaaaaaaaaaaaaaaaaaaaaaIaaaaaaaaaaK
pppprrrrrrrrrrppppnGaaaaaaaaaaaaaCaaaaaaaaaaaaaaaaaaaaaaaaaaaaaaaaaaIubRaaaaRbuK
pppprrrroErrrrppppnqaaaaaaaaaaaaanaaaaaaaaaaaaaaaaaaaaaaaaaaaaaaaaaaIaltaaaatlaK
pppprrrroErrrrppppWaaaaaaaaaaajjanaaaaaaaaaaaaaaaaaaaaaaaaaaaaaaaaaaIaaaaaaaaaaK
pppprrrroErrrrppppWaaaaaaaaaaAaaJnaaaaaaaaaaaaaaaaaaaaaaaaaaaaaaaaaaOKKKKKKKKKKK
pppprrrroErrrrppppWaaaaaaaaajiAakCaaaaaaaaaaaaaaaaaaaaaaaaaaaaaaaaaaOKKKKKKKKKKK
pppprrrrrrrrrrppppnFaaaaaaaajjijjDaaaaaaaaaaaaaaaaaaaaaaaaaaaaaaaaaaOKKKKKKKKKKK
pppprrrrrrrrrrppppnsaaaaaaaaaaaaaCaaaaaaaaaaaaaaaaaaaaaaaaaaaaaaaaaaOKKKKKKKKKKK
pppprrrroErrrrppppnGaaaaaaaaaaaaanaaaaaaaaaaaaaaaaaaaaaaaaaaaaaaaaaaOKKKKKKKKKKK
pppprrrroErrrrppppnGaaaaaaaaaajjanaaaaaaaaaaaaaaaaaaaaaaaaaaaaaaaaaaOKKKKKKKKKKK
pppprrrroErrrrppppnGaaaaaaaaaAaaJnaaaaaaaaaaaaaaaaaaaaaaaaaaaaaaaaaaOKKKKKKKKKKK
pppprrrroErrrrppppnqaaaaaaaajiAakCaaaaaaaaaaaaaaaaaaaaaaaaaaaaaaaaaaOKKKKKKKKKKK
pppprrrrrrrrrrppppWaaaaaaaaajjijjDaaaaaaaaaaaaaaaaaaaaaaaaaaaaaaaaaaOKKKKKKKKKKK
pppprrrrrrrrrrppppWaaaaaaaaaaaaaaCaaaaaaaaaaaaaaaaaaaaaaaaaaaaaaaaaaOKKKKKKKKKKK
pppprrrroErrrrppppWaaaaaaaaaaaaaanaaaaaaaaaaaaaaaaaaaaaaaaaaaaaaaaaaOKKKKKKKKKKK
pppprrrroErrrrppppnaaaaaaaaaaaaaanaaaaaaaaaaaaaaaaaaaaaaaaaaaaaaaaaaOKKKKKKKKKKK
pppprrrroErrrrppppnaaaaaaaaaaaaaanaaaaaaaaaaaaaaaaaaaaaaaaaaaaaaaaaaOKKKKKKKKKKK
pppprrrroErrrrppppnaaaaaaannnnggnnaaaaaaaaaaaaaaaaaaaaaaaaaaaaaaaaaaOKKKKKKKKKKK
pppprrrrrrrrrrppppnaaaaaaZnaaaaaaaaaaaaaaaaaaaaaaaaaaaaaaaaaaaaaaaaaOKKKKKKKKKKK
pppprrrrrrrrrrppppnaaaaaafnaaaaaaaaaaaaaaaaaaaaaaaaaaaaaaaaaaaaaaaaaOKKKKKKKKKKK
pppprrrroErrrrppppnaaaaaafnaaaaaaaaaaaaaaaaaaaaaaaaaaaaaaaaaaaaaaaaaOKKKKKKKKKKK
pppprrrroErrrrppppnaaaaaafnaaaaaaaaaaaaaaaaaaaaaaaaaaaaaaaaaaaaaaaaaOKKKKKKKKKKK
pppprrrroErrrrppppnaaaaaafnaaaaaaaaaaaaaaaaaaaaaaaaaaaaaaaaaaaaaaaaaOKKKKKKKKKKK
pppprrrroErrrrppppnaaaaaaYnaaaaaaaaaaaaaaaaaaaaaaaaaaaaaaaaaaaaaaaaaOKKKKKKKKKKK
pppprrrrrrrrrrppppnaaaaaaanaaaaaaaaaaaaaaaaaaaaaaaaaaaaaaaaaaaaaaaaaOKKKKKKKKKKK
pppprrrrrrrrrrppppnnnzzznnnnnnnnnnnnnnnnnnnnnnnnnnnnnnnnnnnnnnnnNNNNOKKKKKKKKKKK
pppprrrroErrrrpppppppppppppppppppppppppppppppppppppppppppppppppppppppppppppppppp
pppprrrroErrrrpppppppppppppppppppppppppppppppppppppppppppppppppppppppppppppppppp
pppprrrroErrrrpppppppppppppppppppppppppppppppppppppppppppppppppppppppppppppppppp
pppprrrrrrrrrrpppppppppppppppppppppppppppppppppppppppppppppppppppppppppppppppppp
rrrrrrrrrrrrrrrrrrrrrrrrrrrrrrrrrrrrrrrrrrrrrrrrrrrrrrrrrrrrrrrrrrrrrrrrrrrrrrrr
rrrrrrrrrrrrrrrrrrrrrrrrrrrrrrrrrrrrrrrrrrrrrrrrrrrrrrrrrrrrrrrrrrrrrrrrrrrrrrrr
rrrrrrrrrrrrrrrrrrrrrrrrrrrrrrrrrrrrrrrrrrrrrrrrrrrrrrrrrrrrrrrrrrrrrrrrrrrrrrrr
rrrrrrrrrrrrrrrrrrrrrrrrrrrrrrrrrrrrrrrrrrrrrrrrrrrrrrrrrrrrrrrrrrrrrrrrrrrrrrrr
xxxxrrxxxxrrxxxxrrxxxxrrxxxxrrxxxxrrxxxxrrxxxxrrxxxxrrxxxxrrxxxxrrxxxxrrxxxxrrxx
TTTTrrTTTTrrTTTTrrTTTTrrTTTTrrTTTTrrTTTTrrTTTTrrTTTTrrTTTTrrTTTTrrTTTTrrTTTTrrTT
rrrrrrrrrrrrrrrrrrrrrrrrrrrrrrrrrrrrrrrrrrrrrrrrrrrrrrrrrrrrrrrrrrrrrrrrrrrrrrrr
rrrrrrrrrrrrrrrrrrrrrrrrrrrrrrrrrrrrrrrrrrrrrrrrrrrrrrrrrrrrrrrrrrrrrrrrrrrrrrrr
rrrrrrrrrrrrrrrrrrrrrrrrrrrrrrrrrrrrrrrrrrrrrrrrrrrrrrrrrrrrrrrrrrrrrrrrrrrrrrrr
rrrrrrrrrrrrrrrrrrrrrrrrrrrrrrrrrrrrrrrrrrrrrrrrrrrrrrrrrrrrrrrrrrrrrrrrrrrrrrrr
pppppppppppppppppppppppppppppppppppppppppppppppppppppppppppppppppppppppppppppppp
pppppppppppppppppppppppppppppppppppppppppppppppppppppppppppppppppppppppppppppppp
pppppppppppppppppppppppppppppppppppppppppppppppppppppppppppppppppppppppppppppppp
pppppppppppppppppppppppppppppppppppppppppppppppppppppppppppppppppppppppppppppppp
"}
(1,1,2) = {"
SSSSSSSSSSSSSSSSSSSSSSSSSSSSSSSSSSSSSSSSSSSSSSSSSSSSSSSSSSSSSSSSSSSSSSSSSSSSSSSS
SSSSSSSSSSSSSSSSSSSSSSSSSSSSSSSSSSSSSSSSSSSSSSSSSSSSSSSSSSSSSSSSSSSSSSSSSSSSSSSS
SSSSSSSSSSSSSSSSSSSSSSSSSSSSSSSSSSSSSSSSSSSSSSSSSSSSSSSSSSSSSSSSSSSSSSSSSSSSSSSS
SSSSSSSSSSSSSSSSSSSSSSSSSSSSSSSSSSSSSSSSSSSSSSSSSSSSSSSSSSSSSSSSSSSSSSSSSSSSSSSS
SSSSSSSSSSSSSSSSSSSSSSSSSSSSSSSSSSSSSSSSSSSSSSSSSSSSSSSSSSSSSSSSSSSSSSSSSSSSSSSS
SSSSSSSSSSSSSSSSSSSSSSSSSSSSSSSSSSSSSSSSSSSSSSSSSSSSSSSSSSSSSSSSSSSSSSSSSSSSSSSS
SSSSSSSSSSSSSSSSSSSSSSSSSSSSSSSSSSSSSSSSSSSSSSSSSSSSSSSSSSSSSSSSSSSSSSSSSSSSSSSS
SSSSSSSSSSSSSSSSSSSSSSSSSSSSSSSSSSSSSSSSSSSSSSSSSSSSSSSSSSSSSSSSSSSSSSSSSSSSSSSS
SSSSSSSSSSSSSSSSSSSSSSSnnnnnnnnnnnnnnnnnWWWnnnWWWnnnWWWnnnWWWnnnWWWnnKKKKKKKKKKK
SSSSSSSSSSSSSSSSSSSSSSSnmmmmmmmmaaaaaaaaaaaaaaaaaaaaaaaaaaaaaaaaaaaanKKKKKKKKKKK
SSSSSSSSSSSSSSSSSSSSSSSnmmmmmmmmaaaaaaaaaaaaaaaaaaaaaaaaaaaaaaaaaaaanKKKKKKKKKKK
SSSSSSSSSSSSSSSSSSSSSSSnmmmmmmmmaaaaaaaaaaaaaaaaaaaaaaaaaaaaaaaaaaaanKKKKKKKKKKK
SSSSSSSSSSSSSSSSSSnnnnnnnnnnnnnnnaaaaaaaaaaaaaaaaaaaaaaaaaaaaaaaaaaanKKKKKKKKKKK
SSSSSSSSSSSSSSSSSSnaaaaaaaaaaaaaaaaaaaaaaaaaaaaaaaaaaaaaaaaaaaaaaaaanKKKKKKKKKKK
SSSSSSSSSSSSSSSSSSnaaaaaaaaaaaaaaaaaaaaaaaaaaaaaaaaaaaaaaaaaaaaaaaaanKKKKKKKKKKK
SSSSSSSSSSSSSSSSSSnaaaaaaaaaaaaaaaaaaaaaaaaaaaaaaaaaaaaaaaaaaaaaaaaanKKKKKKKKKKK
SSSSSSSSSSSSSSSSSSWaaaaaaaaaaaaaaaaaaaaaaaaaaaaaaaaaaaaaaaaaaaaaaaaanKKKKKKKKKKK
SSSSSSSSSSSSSSSSSSWaaaaaaaaaaaaaaaaaaaaaaaaaaaaaaaaaaaaaaaaaaaaaaaaanKKKKKKKKKKK
SSSSSSSSSSSSSSSSSSWaaaaaaaaaaaaaaaaaaaaaaaaaaaaaaaaaaaaaaaaaaaaaaaaanKKKKKKKKKKK
SSSSSSSSSSSSSSSSSSnaaaaaaaaaaaaaaaaaaaaaaaaaaaaaaaaaaaaaaaaaaaaaaaaanKKKKKKKKKKK
SSSSSSSSSSSSSSSSSSnaaaaaaaaaaaaaaaaaaaaaaaaaaaaaaaaaaaaaaaaaaaaaaaaanKKKKKKKKKKK
SSSSSSSSSSSSSSSSSSnaaaaaaaaaaaaaaaaaaaaaaaaaaaaaaaaaaaaaaaaaaaaaaaaanKKKKKKKKKKK
SSSSSSSSSSSSSSSSSSWaaaaaaaaaaaaaaaaaaaaaaaaaaaaaaaaaaaaaaaaaaaaaaaaanKKKKKKKKKKK
SSSSSSSSSSSSSSSSSSWaaaaaaaaaaaaaaaaaaaaaaaaaaaaaaaaaaaaaaaaaaaaaaaaanKKKKKKKKKKK
SSSSSSSSSSSSSSSSSSWaaaaaaaaaaaaaaaaaaaaaaaaaaaaaaaaaaaaaaaaaaaaaaaaanKKKKKKKKKKK
SSSSSSSSSSSSSSSSSSnaaaaaaaaaaaaaaaaaaaaaaaaaaaaaaaaaaaaaaaaaaaaaaaaanKKKKKKKKKKK
SSSSSSSSSSSSSSSSSSnaaaaaaaaaaaaaaaaaaaaaaaaaaaaaaaaaaaaaaaaaaaaaaaaanKKKKKKKKKKK
SSSSSSSSSSSSSSSSSSnaaaaaaaaaaaaaaaaaaaaaaaaaaaaaaaaaaaaaaaaaaaaaaaaanKKKKKKKKKKK
SSSSSSSSSSSSSSSSSSWaaaaaaaaaaaaaaaaaaaaaaaaaaaaaaaaaaaaaaaaaaaaaaaaanKKKKKKKKKKK
SSSSSSSSSSSSSSSSSSWaaaaaaaaaaaaaaaaaaaaaaaaaaaaaaaaaaaaaaaaaaaaaaaaanKKKKKKKKKKK
SSSSSSSSSSSSSSSSSSWaaaaaaaaaaaaaaaaaaaaaaaaaaaaaaaaaaaaaaaaaaaaaaaaanKKKKKKKKKKK
SSSSSSSSSSSSSSSSSSnaaaaaaaaaaaaaaaaaaaaaaaaaaaaaaaaaaaaaaaaaaaaaaaaanKKKKKKKKKKK
SSSSSSSSSSSSSSSSSSnaaaaaaaaaaaaaaaaaaaaaaaaaaaaaaaaaaaaaaaaaaaaaaaaanKKKKKKKKKKK
SSSSSSSSSSSSSSSSSSnaaaaaaaaaaaaaaaaaaaaaaaaaaaaaaaaaaaaaaaaaaaaaaaaanKKKKKKKKKKK
SSSSSSSSSSSSSSSSSSWaaaaaaaaaaaaaaaaaaaaaaaaaaaaaaaaaaaaaaaaaaaaaaaaanKKKKKKKKKKK
SSSSSSSSSSSSSSSSSSWaaaaaaaaaaaaaaaaaaaaaaaaaaaaaaaaaaaaaaaaaaaaaaaaanKKKKKKKKKKK
SSSSSSSSSSSSSSSSSSWaaaaaaaaaaaaaaaaaaaaaaaaaaaaaaaaaaaaaaaaaaaaaaaaanKKKKKKKKKKK
SSSSSSSSSSSSSSSSSSnaaaaaaaaaaaaaaaaaaaaaaaaaaaaaaaaaaaaaaaaaaaaaaaaanKKKKKKKKKKK
SSSSSSSSSSSSSSSSSSnaaaaaaaaaaaaaaaaaaaaaaaaaaaaaaaaaaaaaaaaaaaaaaaaanKKKKKKKKKKK
SSSSSSSSSSSSSSSSSSnaaaaaaaaaaaaaaaaaaaaaaaaaaaaaaaaaaaaaaaaaaaaaaaaanKKKKKKKKKKK
SSSSSSSSSSSSSSSSSSWaaaaaaaaaaaaaaaaaaaaaaaaaaaaaaaaaaaaaaaaaaaaaaaaanKKKKKKKKKKK
SSSSSSSSSSSSSSSSSSWaaaaaaaaaaaaaaaaaaaaaaaaaaaaaaaaaaaaaaaaaaaaaaaaanKKKKKKKKKKK
SSSSSSSSSSSSSSSSSSWaaaaaaaaaaaaaaaaaaaaaaaaaaaaaaaaaaaaaaaaaaaaaaaaanKKKKKKKKKKK
SSSSSSSSSSSSSSSSSSIaaaaaaaaaaaaaaaaaaaaaaaaaaaaaaaaaaaaaaaaaaaaaaaaanKKKKKKKKKKK
SSSSSSSSSSSSSSSSSSIaaaaaaaaaaaaaaaaaaaaaaaaaaaaaaaaaaaaaaaaaaaaaaaaanKKKKKKKKKKK
SSSSSSSSSSSSSSSSSSIaaaaaaaaaaaaaaaaaaaaaaaaaaaaaaaaaaaaaaaaaaaaaaaaanKKKKKKKKKKK
SSSSSSSSSSSSSSSSSSWaaaaaaaaaaaaaaaaaaaaaaaaaaaaaaaaaaaaaaaaaaaaaaaaanKKKKKKKKKKK
SSSSSSSSSSSSSSSSSSWaaaaaaaaaaaaaaaaaaaaaaaaaaaaaaaaaaaaaaaaaaaaaaaaanKKKKKKKKKKK
SSSSSSSSSSSSSSSSSSWaaaaaaaaaaaaaaaaaaaaaaaaaaaaaaaaaaaaaaaaaaaaaaaaanKKKKKKKKKKK
SSSSSSSSSSSSSSSSSSnaaaaaaaaaaaaaaaaaaaaaaaaaaaaaaaaaaaaaaaaaaaaaaaaanKKKKKKKKKKK
SSSSSSSSSSSSSSSSSSnaaaaaaaaaaaaaaaaaaaaaaaaaaaaaaaaaaaaaaaaaaaaaaaaanKKKKKKKKKKK
SSSSSSSSSSSSSSSSSSnaaaaaaaaaaaaaaaaaaaaaaaaaaaaaaaaaaaaaaaaaaaaaaaaanKKKKKKKKKKK
SSSSSSSSSSSSSSSSSSWaaaaaaaaaaaaaaaaaaaaaaaaaaaaaaaaaaaaaaaaaaaaaaaaanKKKKKKKKKKK
SSSSSSSSSSSSSSSSSSWaaaaaaaaaaaaaaaaaaaaaaaaaaaaaaaaaaaaaaaaaaaaaaaaanKKKKKKKKKKK
SSSSSSSSSSSSSSSSSSWaaaaaaaaaaaaaaaaaaaaaaaaaaaaaaaaaaaaaaaaaaaaaaaaanKKKKKKKKKKK
SSSSSSSSSSSSSSSSSSnaaaaaaaaaaaaaaaaaaaaaaaaaaaaaaaaaaaaaaaaaaaaaaaaanKKKKKKKKKKK
SSSSSSSSSSSSSSSSSSnnnWWWnnnWWWnnnWWWnnnWWWnnnWWWnnnWWWnnnWWWnnnWWWnnnKKKKKKKKKKK
SSSSSSSSSSSSSSSSSSSSSSSSSSSSSSSSSSSSSSSSSSSSSSSSSSSSSSSSSSSSSSSSSSSSSSSSSSSSSSSS
SSSSSSSSSSSSSSSSSSSSSSSSSSSSSSSSSSSSSSSSSSSSSSSSSSSSSSSSSSSSSSSSSSSSSSSSSSSSSSSS
SSSSSSSSSSSSSSSSSSSSSSSSSSSSSSSSSSSSSSSSSSSSSSSSSSSSSSSSSSSSSSSSSSSSSSSSSSSSSSSS
SSSSSSSSSSSSSSSSSSSSSSSSSSSSSSSSSSSSSSSSSSSSSSSSSSSSSSSSSSSSSSSSSSSSSSSSSSSSSSSS
SSSSSSSSSSSSSSSSSSSSSSSSSSSSSSSSSSSSSSSSSSSSSSSSSSSSSSSSSSSSSSSSSSSSSSSSSSSSSSSS
SSSSSSSSSSSSSSSSSSSSSSSSSSSSSSSSSSSSSSSSSSSSSSSSSSSSSSSSSSSSSSSSSSSSSSSSSSSSSSSS
SSSSSSSSSSSSSSSSSSSSSSSSSSSSSSSSSSSSSSSSSSSSSSSSSSSSSSSSSSSSSSSSSSSSSSSSSSSSSSSS
SSSSSSSSSSSSSSSSSSSSSSSSSSSSSSSSSSSSSSSSSSSSSSSSSSSSSSSSSSSSSSSSSSSSSSSSSSSSSSSS
SSSSSSSSSSSSSSSSSSSSSSSSSSSSSSSSSSSSSSSSSSSSSSSSSSSSSSSSSSSSSSSSSSSSSSSSSSSSSSSS
SSSSSSSSSSSSSSSSSSSSSSSSSSSSSSSSSSSSSSSSSSSSSSSSSSSSSSSSSSSSSSSSSSSSSSSSSSSSSSSS
SSSSSSSSSSSSSSSSSSSSSSSSSSSSSSSSSSSSSSSSSSSSSSSSSSSSSSSSSSSSSSSSSSSSSSSSSSSSSSSS
SSSSSSSSSSSSSSSSSSSSSSSSSSSSSSSSSSSSSSSSSSSSSSSSSSSSSSSSSSSSSSSSSSSSSSSSSSSSSSSS
SSSSSSSSSSSSSSSSSSSSSSSSSSSSSSSSSSSSSSSSSSSSSSSSSSSSSSSSSSSSSSSSSSSSSSSSSSSSSSSS
SSSSSSSSSSSSSSSSSSSSSSSSSSSSSSSSSSSSSSSSSSSSSSSSSSSSSSSSSSSSSSSSSSSSSSSSSSSSSSSS
SSSSSSSSSSSSSSSSSSSSSSSSSSSSSSSSSSSSSSSSSSSSSSSSSSSSSSSSSSSSSSSSSSSSSSSSSSSSSSSS
SSSSSSSSSSSSSSSSSSSSSSSSSSSSSSSSSSSSSSSSSSSSSSSSSSSSSSSSSSSSSSSSSSSSSSSSSSSSSSSS
SSSSSSSSSSSSSSSSSSSSSSSSSSSSSSSSSSSSSSSSSSSSSSSSSSSSSSSSSSSSSSSSSSSSSSSSSSSSSSSS
SSSSSSSSSSSSSSSSSSSSSSSSSSSSSSSSSSSSSSSSSSSSSSSSSSSSSSSSSSSSSSSSSSSSSSSSSSSSSSSS
"}
(1,1,3) = {"
SSSSSSSSSSSSSSSSSSSSSSSSSSSSSSSSSSSSSSSSSSSSSSSSSSSSSSSSSSSSSSSSSSSSSSSSSSSSSSSS
SSSSSSSSSSSSSSSSSSSSSSSSSSSSSSSSSSSSSSSSSSSSSSSSSSSSSSSSSSSSSSSSSSSSSSSSSSSSSSSS
SSSSSSSSSSSSSSSSSSSSSSSSSSSSSSSSSSSSSSSSSSSSSSSSSSSSSSSSSSSSSSSSSSSSSSSSSSSSSSSS
SSSSSSSSSSSSSSSSSSSSSSSSSSSSSSSSSSSSSSSSSSSSSSSSSSSSSSSSSSSSSSSSSSSSSSSSSSSSSSSS
SSSSSSSSSSSSSSSSSSSSSSSSSSSSSSSSSSSSSSSSSSSSSSSSSSSSSSSSSSSSSSSSSSSSSSSSSSSSSSSS
SSSSSSSSSSSSSSSSSSSSSSSSSSSSSSSSSSSSSSSSSSSSSSSSSSSSSSSSSSSSSSSSSSSSSSSSSSSSSSSS
SSSSSSSSSSSSSSSSSSSSSSSSSSSSSSSSSSSSSSSSSSSSSSSSSSSSSSSSSSSSSSSSSSSSSSSSSSSSSSSS
SSSSSSSSSSSSSSSSSSSSSSSSSSSSSSSSSSSSSSSSSSSSSSSSSSSSSSSSSSSSSSSSSSSSSSSSSSSSSSSS
SSSSSSSSSSSSSSSSSSSSSSSSSSSSSSSSSSSSSSSSSSSSSSSSSSSSSSSSSSSSSSSSSSSSSSSSSSSSSSSS
SSSSSSSSSSSSSSSSSSSSSSSSSSSSSSSSSSSSSSSSSSSSSSSSSSSSSSSSSSSSSSSSSSSSSSSSSSSSSSSS
SSSSSSSSSSSSSSSSSSSSSSSSSSSSSSSSSSSSSSSSSSSSSSSSSSSSSSSSSSSSSSSSSSSSSSSSSSSSSSSS
SSSSSSSSSSSSSSSSSSSSSSSSSSSSSSSSSSSSSSSSSSSSSSSSSSSSSSSSSSSSSSSSSSSSSSSSSSSSSSSS
SSSSSSSSSSSSSSSSSSSSSSSSSSSSSSSSSSSSSSSSSSSSSSSSSSSSSSSSSSSSSSSSSSSSSSSSSSSSSSSS
SSSSSSSSSSSSSSSSSSSSSSSSSSSSSSSSSSSSSSSSSSSSSSSSSSSSSSSSSSSSSSSSSSSSSSSSSSSSSSSS
SSSSSSSSSSSSSSSSSSSSSSSSSSSSSSSSSSSSSSSSSSSSSSSSSSSSSSSSSSSSSSSSSSSSSSSSSSSSSSSS
SSSSSSSSSSSSSSSSSSSSSSSSSSSSSSSSSSSSSSSSSSSSSSSSSSSSSSSSSSSSSSSSSSSSSSSSSSSSSSSS
SSSSSSSSSSSSSSSSSSSSSSSSSSSSSSSSSSSSSSSSSSSSSSSSSSSSSSSSSSSSSSSSSSSSSSSSSSSSSSSS
SSSSSSSSSSSSSSSSSSSSSSSSSSSSSSSSSSSSSSSSSSSSSSSSSSSSSSSSSSSSSSSSSSSSSSSSSSSSSSSS
SSSSSSSSSSSSSSSSSSSSSSSSSSSSSSSSSSSSSSSSSSSSSSSSSSSSSSSSSSSSSSSSSSSSSSSSSSSSSSSS
SSSSSSSSSSSSSSSSSSSSSSSSSSSSSSSSSSSSSSSSSSSSSSSSSSSSSSSSSSSSSSSSSSSSSSSSSSSSSSSS
SSSSSSSSSSSSSSSSSSSSSSSSSSSSSSSSSSSSSSSSSSSSSSSSSSSSSSSSSSSSSSSSSSSSSSSSSSSSSSSS
SSSSSSSSSSSSSSSSSSSSSSSSSSSSSSSSSSSSSSSSSSSSSSSSSSSSSSSSSSSSSSSSSSSSSSSSSSSSSSSS
SSSSSSSSSSSSSSSSSSSSSSSSSSSSSSSSSSSSSSSSSSSSSSSSSSSSSSSSSSSSSSSSSSSSSSSSSSSSSSSS
SSSSSSSSSSSSSSSSSSSSSSSSSSSSSSSSSSSSSSSSSSSSSSSSSSSSSSSSSSSSSSSSSSSSSSSSSSSSSSSS
SSSSSSSSSSSSSSSSSSSSSSSSSSSSSSSSSSSSSSSSSSSSSSSSSSSSSSSSSSSSSSSSSSSSSSSSSSSSSSSS
SSSSSSSSSSSSSSSSSSSSSSSSSSSSSSSSSSSSSSSSSSSSSSSSSSSSSSSSSSSSSSSSSSSSSSSSSSSSSSSS
SSSSSSSSSSSSSSSSSSSSSSSSSSSSSSSSSSSSSSSSSSSSSSSSSSSSSSSSSSSSSSSSSSSSSSSSSSSSSSSS
SSSSSSSSSSSSSSSSSSSSSSSSSSSSSSSSSSSSSSSSSSSSSSSSSSSSSSSSSSSSSSSSSSSSSSSSSSSSSSSS
SSSSSSSSSSSSSSSSSSSSSSSSSSSSSSSSSSSSSSSSSSSSSSSSSSSSSSSSSSSSSSSSSSSSSSSSSSSSSSSS
SSSSSSSSSSSSSSSSSSSSSSSSSSSSSSSSSSSSSSSSSSSSSSSSSSSSSSSSSSSSSSSSSSSSSSSSSSSSSSSS
SSSSSSSSSSSSSSSSSSSSSSSSSSSSSSSSSSSSSSSSSSSSSSSSSSSSSSSSSSSSSSSSSSSSSSSSSSSSSSSS
SSSSSSSSSSSSSSSSSSSSSSSSSSSSSSSSSSSSSSSSSSSSSSSSSSSSSSSSSSSSSSSSSSSSSSSSSSSSSSSS
SSSSSSSSSSSSSSSSSSSSSSSSSSSSSSSSSSSSSSSSSSSSSSSSSSSSSSSSSSSSSSSSSSSSSSSSSSSSSSSS
SSSSSSSSSSSSSSSSSSSSSSSSSSSSSSSSSSSSSSSSSSSSSSSSSSSSSSSSSSSSSSSSSSSSSSSSSSSSSSSS
SSSSSSSSSSSSSSSSSSSSSSSSSSSSSSSSSSSSSSSSSSSSSSSSSSSSSSSSSSSSSSSSSSSSSSSSSSSSSSSS
SSSSSSSSSSSSSSSSSSSSSSSSSSSSSSSSSSSSSSSSSSSSSSSSSSSSSSSSSSSSSSSSSSSSSSSSSSSSSSSS
SSSSSSSSSSSSSSSSSSSSSSSSSSSSSSSSSSSSSSSSSSSSSSSSSSSSSSSSSSSSSSSSSSSSSSSSSSSSSSSS
SSSSSSSSSSSSSSSSSSSSSSSSSSSSSSSSSSSSSSSSSSSSSSSSSSSSSSSSSSSSSSSSSSSSSSSSSSSSSSSS
SSSSSSSSSSSSSSSSSSSSSSSSSSSSSSSSSSSSSSSSSSSSSSSSSSSSSSSSSSSSSSSSSSSSSSSSSSSSSSSS
SSSSSSSSSSSSSSSSSSSSSSSSSSSSSSSSSSSSSSSSSSSSSSSSSSSSSSSSSSSSSSSSSSSSSSSSSSSSSSSS
SSSSSSSSSSSSSSSSSSSSSSSSSSSSSSSSSSSSSSSSSSSSSSSSSSSSSSSSSSSSSSSSSSSSSSSSSSSSSSSS
SSSSSSSSSSSSSSSSSSSSSSSSSSSSSSSSSSSSSSSSSSSSSSSSSSSSSSSSSSSSSSSSSSSSSSSSSSSSSSSS
SSSSSSSSSSSSSSSSSSSSSSSSSSSSSSSSSSSSSSSSSSSSSSSSSSSSSSSSSSSSSSSSSSSSSSSSSSSSSSSS
SSSSSSSSSSSSSSSSSSSSSSSSSSSSSSSSSSSSSSSSSSSSSSSSSSSSSSSSSSSSSSSSSSSSSSSSSSSSSSSS
SSSSSSSSSSSSSSSSSSSSSSSSSSSSSSSSSSSSSSSSSSSSSSSSSSSSSSSSSSSSSSSSSSSSSSSSSSSSSSSS
SSSSSSSSSSSSSSSSSSSSSSSSSSSSSSSSSSSSSSSSSSSSSSSSSSSSSSSSSSSSSSSSSSSSSSSSSSSSSSSS
SSSSSSSSSSSSSSSSSSSSSSSSSSSSSSSSSSSSSSSSSSSSSSSSSSSSSSSSSSSSSSSSSSSSSSSSSSSSSSSS
SSSSSSSSSSSSSSSSSSSSSSSSSSSSSSSSSSSSSSSSSSSSSSSSSSSSSSSSSSSSSSSSSSSSSSSSSSSSSSSS
SSSSSSSSSSSSSSSSSSSSSSSSSSSSSSSSSSSSSSSSSSSSSSSSSSSSSSSSSSSSSSSSSSSSSSSSSSSSSSSS
SSSSSSSSSSSSSSSSSSSSSSSSSSSSSSSSSSSSSSSSSSSSSSSSSSSSSSSSSSSSSSSSSSSSSSSSSSSSSSSS
SSSSSSSSSSSSSSSSSSSSSSSSSSSSSSSSSSSSSSSSSSSSSSSSSSSSSSSSSSSSSSSSSSSSSSSSSSSSSSSS
SSSSSSSSSSSSSSSSSSSSSSSSSSSSSSSSSSSSSSSSSSSSSSSSSSSSSSSSSSSSSSSSSSSSSSSSSSSSSSSS
SSSSSSSSSSSSSSSSSSSSSSSSSSSSSSSSSSSSSSSSSSSSSSSSSSSSSSSSSSSSSSSSSSSSSSSSSSSSSSSS
SSSSSSSSSSSSSSSSSSSSSSSSSSSSSSSSSSSSSSSSSSSSSSSSSSSSSSSSSSSSSSSSSSSSSSSSSSSSSSSS
SSSSSSSSSSSSSSSSSSSSSSSSSSSSSSSSSSSSSSSSSSSSSSSSSSSSSSSSSSSSSSSSSSSSSSSSSSSSSSSS
SSSSSSSSSSSSSSSSSSSSSSSSSSSSSSSSSSSSSSSSSSSSSSSSSSSSSSSSSSSSSSSSSSSSSSSSSSSSSSSS
SSSSSSSSSSSSSSSSSSSSSSSSSSSSSSSSSSSSSSSSSSSSSSSSSSSSSSSSSSSSSSSSSSSSSSSSSSSSSSSS
SSSSSSSSSSSSSSSSSSSSSSSSSSSSSSSSSSSSSSSSSSSSSSSSSSSSSSSSSSSSSSSSSSSSSSSSSSSSSSSS
SSSSSSSSSSSSSSSSSSSSSSSSSSSSSSSSSSSSSSSSSSSSSSSSSSSSSSSSSSSSSSSSSSSSSSSSSSSSSSSS
SSSSSSSSSSSSSSSSSSSSSSSSSSSSSSSSSSSSSSSSSSSSSSSSSSSSSSSSSSSSSSSSSSSSSSSSSSSSSSSS
SSSSSSSSSSSSSSSSSSSSSSSSSSSSSSSSSSSSSSSSSSSSSSSSSSSSSSSSSSSSSSSSSSSSSSSSSSSSSSSS
SSSSSSSSSSSSSSSSSSSSSSSSSSSSSSSSSSSSSSSSSSSSSSSSSSSSSSSSSSSSSSSSSSSSSSSSSSSSSSSS
SSSSSSSSSSSSSSSSSSSSSSSSSSSSSSSSSSSSSSSSSSSSSSSSSSSSSSSSSSSSSSSSSSSSSSSSSSSSSSSS
SSSSSSSSSSSSSSSSSSSSSSSSSSSSSSSSSSSSSSSSSSSSSSSSSSSSSSSSSSSSSSSSSSSSSSSSSSSSSSSS
SSSSSSSSSSSSSSSSSSSSSSSSSSSSSSSSSSSSSSSSSSSSSSSSSSSSSSSSSSSSSSSSSSSSSSSSSSSSSSSS
SSSSSSSSSSSSSSSSSSSSSSSSSSSSSSSSSSSSSSSSSSSSSSSSSSSSSSSSSSSSSSSSSSSSSSSSSSSSSSSS
SSSSSSSSSSSSSSSSSSSSSSSSSSSSSSSSSSSSSSSSSSSSSSSSSSSSSSSSSSSSSSSSSSSSSSSSSSSSSSSS
SSSSSSSSSSSSSSSSSSSSSSSSSSSSSSSSSSSSSSSSSSSSSSSSSSSSSSSSSSSSSSSSSSSSSSSSSSSSSSSS
SSSSSSSSSSSSSSSSSSSSSSSSSSSSSSSSSSSSSSSSSSSSSSSSSSSSSSSSSSSSSSSSSSSSSSSSSSSSSSSS
SSSSSSSSSSSSSSSSSSSSSSSSSSSSSSSSSSSSSSSSSSSSSSSSSSSSSSSSSSSSSSSSSSSSSSSSSSSSSSSS
SSSSSSSSSSSSSSSSSSSSSSSSSSSSSSSSSSSSSSSSSSSSSSSSSSSSSSSSSSSSSSSSSSSSSSSSSSSSSSSS
SSSSSSSSSSSSSSSSSSSSSSSSSSSSSSSSSSSSSSSSSSSSSSSSSSSSSSSSSSSSSSSSSSSSSSSSSSSSSSSS
SSSSSSSSSSSSSSSSSSSSSSSSSSSSSSSSSSSSSSSSSSSSSSSSSSSSSSSSSSSSSSSSSSSSSSSSSSSSSSSS
SSSSSSSSSSSSSSSSSSSSSSSSSSSSSSSSSSSSSSSSSSSSSSSSSSSSSSSSSSSSSSSSSSSSSSSSSSSSSSSS
SSSSSSSSSSSSSSSSSSSSSSSSSSSSSSSSSSSSSSSSSSSSSSSSSSSSSSSSSSSSSSSSSSSSSSSSSSSSSSSS
"}
