//MAP CONVERTED BY dmm2tgm.py THIS HEADER COMMENT PREVENTS RECONVERSION, DO NOT REMOVE
"aH" = (
/obj/structure/simple_door/key_door/civ{
	name = "store";
	unique_door_name = "store"
	},
/turf/floor/plating/concrete,
/area/caribbean)
"aR" = (
/obj/structure/table/modern/table,
/obj/item/kitchen/plate,
/turf/floor/carpet/greencarpet,
/area/caribbean)
"bo" = (
/turf/floor/dirt,
/area/caribbean)
"bs" = (
/turf/wall/brick,
/area/caribbean)
"bw" = (
/obj/structure/simple_door/key_door/civ{
	name = "backdoor";
	unique_door_name = "backdoor"
	},
/turf/floor/wood,
/area/caribbean)
"bH" = (
/obj/structure/table/rack/shelf/wooden,
/obj/structure/props/bong{
	color = "#ff00ff"
	},
/turf/floor/plating/concrete,
/area/caribbean)
"bL" = (
/obj/structure/props/junk{
	icon_state = "Junk_10"
	},
/turf/floor/plating/road,
/area/caribbean)
"bS" = (
/turf/floor/plating/road,
/area/caribbean)
"ch" = (
/obj/item/flashlight/lamp/oldlamp,
/turf/floor/carpet/greencarpet,
/area/caribbean)
"cr" = (
/obj/structure/bed/chair/comfy/green{
	dir = 8
	},
/turf/floor/carpet/greencarpet,
/area/caribbean)
"cv" = (
/obj/structure/bed/chair/comfy/fancy_sofa/l{
	dir = 1
	},
/obj/effect/floor_decal/spline/fancy/wood{
	dir = 8
	},
/turf/floor/wood,
/area/caribbean)
"cJ" = (
/turf/floor/plating/road/whiteline,
/area/caribbean)
"cL" = (
/obj/structure/window/classic/metal,
/obj/structure/barricade/horizontal,
/obj/structure/curtain/closed/green,
/turf/floor/plating/concrete,
/area/caribbean)
"df" = (
/obj/structure/table/rack/shelf/wooden,
/obj/item/weapon/storage/fancy/cigar/full,
/turf/floor/plating/concrete,
/area/caribbean)
"dw" = (
/obj/structure/table/rack/shelf/wooden,
/turf/floor/wood,
/area/caribbean)
"dC" = (
/obj/structure/table/rack/shelf/wooden,
/turf/floor/plating/concrete,
/area/caribbean)
"eG" = (
/obj/structure/multiz/ladder/ww2/stairsup,
/turf/floor/wood,
/area/caribbean)
"eI" = (
/turf/floor/wood,
/area/caribbean)
"go" = (
/obj/structure/sink{
	dir = 1;
	icon_state = "sink";
	pixel_y = 18;
	layer = 4
	},
/obj/structure/mirror{
	pixel_y = 30
	},
/turf/floor/plating/marble/grid,
/area/caribbean)
"gU" = (
/obj/structure/props/junk{
	icon_state = "Junk_4"
	},
/obj/effect/decal/cleanable/vomit/bloody,
/turf/floor/plating/road,
/area/caribbean)
"gZ" = (
/obj/structure/vehicleparts/frame/car/van/lf{
	color = "#333333"
	},
/obj/structure/vehicleparts/movement/reversed{
	broken = 1
	},
/turf/floor/plating/road,
/area/caribbean)
"hk" = (
/obj/structure/vehicleparts/frame/car/van/lfc{
	color = "#333333"
	},
/obj/structure/bed/chair/drivers/car/dark{
	color = "#333333"
	},
/obj/structure/vehicleparts/axis/car{
	color = "#444444";
	speedlist = list(7,5,4,2.5,1.8);
	name = "swat van"
	},
/turf/floor/plating/road,
/area/caribbean)
"iF" = (
/obj/structure/bed/chair/comfy/fancy_sofa/r,
/turf/floor/plating/concrete,
/area/caribbean)
"iZ" = (
/obj/structure/table/rack/shelf,
/obj/item/weapon/flame/lighter,
/obj/item/weapon/flame/lighter,
/turf/floor/plating/concrete,
/area/caribbean)
"jP" = (
/obj/structure/table/rack/shelf/wooden,
/obj/item/weapon/storage/fancy/cigarettes/marlboro,
/turf/floor/plating/concrete,
/area/caribbean)
"kM" = (
/obj/structure/closet/fridge,
/obj/item/weapon/reagent_containers/food/snacks/pizzacheesesliced,
/obj/item/weapon/reagent_containers/food/snacks/gyro,
/obj/item/weapon/reagent_containers/food/snacks/gyro,
/turf/floor/carpet/greencarpet,
/area/caribbean)
"ln" = (
/obj/structure/table/rack/shelf/wooden,
/obj/item/weapon/storage/fancy/cigarettes/randompack,
/turf/floor/plating/concrete,
/area/caribbean)
"ls" = (
/obj/structure/closet/crate/ww2,
/obj/item/clothing/mask/gas/swat,
/obj/item/clothing/mask/gas/swat,
/obj/item/clothing/head/helmet/swat,
/obj/item/clothing/head/helmet/swat,
/obj/item/clothing/under/swat,
/obj/item/clothing/under/swat,
/obj/item/clothing/suit/swat,
/obj/item/clothing/suit/swat,
/obj/item/clothing/gloves/thick/swat,
/obj/item/clothing/gloves/thick/swat,
/obj/item/clothing/glasses/sunglasses,
/obj/item/clothing/glasses/sunglasses,
/turf/floor/plating/road,
/area/caribbean)
"lt" = (
/obj/structure/vehicleparts/frame/car/van/rfc{
	color = "#333333"
	},
/obj/structure/bed/chair/carseat/right/dark{
	color = "#333333"
	},
/turf/floor/plating/road,
/area/caribbean)
"lD" = (
/obj/effect/floor_decal/spline/fancy/wood{
	dir = 1
	},
/turf/floor/wood,
/area/caribbean)
"mF" = (
/obj/structure/table/rack/shelf/wooden,
/obj/item/weapon/storage/fancy/cigarettes/luckystrike,
/turf/floor/plating/concrete,
/area/caribbean)
"nM" = (
/obj/structure/closet/crate/ww2,
/obj/item/weapon/grenade/flashbang,
/obj/item/weapon/grenade/flashbang,
/obj/item/weapon/grenade/flashbang,
/obj/item/weapon/grenade/flashbang,
/obj/item/weapon/grenade/coldwar/stinger,
/obj/item/weapon/grenade/coldwar/stinger,
/obj/item/weapon/grenade/coldwar/stinger,
/obj/item/weapon/grenade/coldwar/stinger,
/turf/floor/plating/road,
/area/caribbean)
"oo" = (
/obj/structure/simple_door/key_door/anyone/singledoor/privacy,
/turf/floor/carpet/greencarpet,
/area/caribbean)
"oD" = (
/obj/structure/props/junk{
	icon_state = "mailbox"
	},
/turf/floor/plating/road,
/area/caribbean)
"oJ" = (
/obj/structure/bed/chair/comfy/fancy_sofa/l,
/turf/floor/plating/concrete,
/area/caribbean)
"pk" = (
/obj/structure/table/rack/shelf,
/obj/structure/props/bong{
	color = "#0000ff"
	},
/turf/floor/plating/concrete,
/area/caribbean)
"pl" = (
/turf/floor/plating/concrete,
/area/caribbean)
"py" = (
/obj/structure/table/rack/shelf/wooden,
/obj/item/clothing/under/coldwar/hippie,
/obj/item/clothing/suit/pimpsuit,
/obj/item/clothing/head/pimphat,
/obj/item/clothing/mask/necklace/christian/gold,
/turf/floor/plating/concrete,
/area/caribbean)
"pJ" = (
/obj/covers/wood/stairs{
	dir = 1
	},
/turf/floor/wood,
/area/caribbean)
"pM" = (
/obj/structure/props/junk{
	icon_state = "Junk_4"
	},
/obj/effect/decal/cleanable/vomit,
/turf/floor/plating/road,
/area/caribbean)
"pR" = (
/obj/covers/brick_wall,
/turf/wall/brick,
/area/caribbean)
"sp" = (
/obj/structure/vehicleparts/frame/car/right/metal{
	color = "#333333"
	},
/turf/floor/plating/road,
/area/caribbean)
"sA" = (
/obj/structure/sink/kitchen{
	dir = 4;
	pixel_x = -14
	},
/turf/floor/carpet/greencarpet,
/area/caribbean)
"sJ" = (
/obj/structure/props/junk{
	icon_state = "Junk_11"
	},
/turf/floor/plating/road,
/area/caribbean)
"sM" = (
/obj/structure/closet/crate/ww2,
/obj/item/ammo_magazine/p90,
/obj/item/ammo_magazine/p90,
/obj/item/ammo_magazine/p90,
/obj/item/weapon/gun/projectile/submachinegun/p90,
/obj/item/weapon/gun/projectile/submachinegun/p90,
/obj/item/weapon/gun/projectile/submachinegun/p90,
/turf/floor/plating/road,
/area/caribbean)
"tW" = (
/obj/structure/table/rack/shelf,
/obj/structure/props/hookah,
/turf/floor/plating/concrete,
/area/caribbean)
"tY" = (
/obj/structure/table/rack/shelf,
/obj/item/weapon/storage/fancy/cigarettes,
/turf/floor/plating/concrete,
/area/caribbean)
"uW" = (
/obj/covers/brick_wall,
/obj/covers/vault,
/turf/wall/brick,
/area/caribbean)
"wg" = (
/obj/structure/table/modern,
/turf/floor/plating/concrete,
/area/caribbean)
"wk" = (
/obj/structure/TV/grandfather,
/turf/floor/wood,
/area/caribbean)
"wB" = (
/obj/structure/props/junk,
/obj/effect/decal/cleanable/urine,
/turf/floor/plating/road,
/area/caribbean)
"xb" = (
/obj/structure/table/rack/shelf,
/obj/structure/props/bong{
	color = "#00ff00"
	},
/turf/floor/plating/concrete,
/area/caribbean)
"yS" = (
/obj/structure/simple_door/key_door/anyone/doubledoor/steel,
/obj/effect/floor_decal/spline/fancy{
	dir = 4
	},
/turf/floor/wood,
/area/caribbean)
"zA" = (
/obj/structure/table/modern,
/obj/structure/closet/crate/cash_register,
/obj/item/stack/money/real/fifty{
	name = "dollars";
	desc = "Dollar bills."
	},
/turf/floor/plating/concrete,
/area/caribbean)
"zM" = (
/obj/structure/table/rack/shelf,
/obj/structure/props/bong,
/turf/floor/plating/concrete,
/area/caribbean)
"zR" = (
/turf/floor/carpet/greencarpet,
/area/caribbean)
"Ce" = (
/turf/floor/plating/marble/grid,
/area/caribbean)
"CB" = (
/obj/structure/vehicleparts/frame/car/van/rf{
	color = "#333333"
	},
/obj/structure/vehicleparts/movement/reversed{
	broken = 1
	},
/turf/floor/plating/road,
/area/caribbean)
"CF" = (
/obj/structure/curtain/open/green,
/turf/floor/wood,
/area/caribbean)
"DW" = (
/obj/structure/table/glass,
/obj/structure/TV,
/turf/floor/wood,
/area/caribbean)
"EG" = (
/obj/structure/sign/exit,
/turf/wall/brick,
/area/caribbean)
"Fc" = (
/obj/structure/toilet{
	pixel_y = 14
	},
/turf/floor/plating/marble/grid,
/area/caribbean)
"Fs" = (
/obj/structure/curtain/open/green,
/turf/floor/plating/concrete,
/area/caribbean)
"Gu" = (
/obj/structure/multiz/ladder/ww2/stairsdown,
/turf/floor/wood,
/area/caribbean)
"GT" = (
/obj/structure/vehicleparts/frame/car/van/rb{
	color = "#333333"
	},
/obj/structure/vehicleparts/movement/reversed{
	broken = 1
	},
/turf/floor/plating/road,
/area/caribbean)
"HB" = (
/obj/structure/table/modern/table,
/obj/item/weapon/reagent_containers/food/snacks/jellysandwich,
/turf/floor/carpet/greencarpet,
/area/caribbean)
"HK" = (
/obj/structure/table/modern/table,
/turf/floor/carpet/greencarpet,
/area/caribbean)
"Id" = (
/obj/structure/props/junk,
/turf/floor/plating/road,
/area/caribbean)
"Ij" = (
/obj/structure/vehicleparts/frame/car/left/metal{
	color = "#333333"
	},
/turf/floor/plating/road,
/area/caribbean)
"LI" = (
/obj/structure/vehicleparts/frame/car/van/lb{
	color = "#333333"
	},
/obj/structure/vehicleparts/movement/reversed{
	broken = 1
	},
/turf/floor/plating/road,
/area/caribbean)
"Mp" = (
/obj/structure/curtain/open/green,
/obj/effect/floor_decal/spline/fancy,
/turf/floor/plating/concrete,
/area/caribbean)
"Nd" = (
/obj/structure/table/glass,
/obj/structure/props/bong,
/obj/item/weapon/flame/lighter/random,
/turf/floor/wood,
/area/caribbean)
"OV" = (
/obj/structure/closet/crate/bin{
	pixel_y = 10;
	name = "trashbin"
	},
/turf/floor/plating/marble/grid,
/area/caribbean)
"Qr" = (
/obj/structure/table/modern,
/obj/structure/props/bong,
/turf/floor/plating/concrete,
/area/caribbean)
"Tb" = (
/obj/structure/table/rack/shelf,
/obj/structure/props/bong{
	color = "#ff0000"
	},
/turf/floor/plating/concrete,
/area/caribbean)
"Tp" = (
/obj/structure/table/rack/shelf,
/obj/structure/props/bong{
	color = "#2f4f4f"
	},
/turf/floor/plating/concrete,
/area/caribbean)
"Ts" = (
/obj/structure/table/rack/shelf,
/obj/item/weapon/storage/fancy/cigar/full,
/turf/floor/plating/concrete,
/area/caribbean)
"Un" = (
/obj/structure/bed/chair/comfy/fancy_sofa/r{
	dir = 8
	},
/turf/floor/carpet/greencarpet,
/area/caribbean)
"Ut" = (
/obj/structure/bed/chair/office/light{
	dir = 8;
	icon_state = "officechair_white"
	},
/turf/floor/plating/concrete,
/area/caribbean)
"UD" = (
/obj/structure/bed/chair/comfy/fancy_sofa/r{
	dir = 1
	},
/obj/effect/floor_decal/spline/fancy/wood{
	dir = 4
	},
/turf/floor/wood,
/area/caribbean)
"Va" = (
/obj/structure/closet/crate/bin,
/turf/floor/carpet/greencarpet,
/area/caribbean)
"Vx" = (
/obj/structure/potted_plant{
	dir = 9;
	icon_state = "plant-39";
	icon = 'icons/obj/flora/plants.dmi'
	},
/turf/floor/plating/concrete,
/area/caribbean)
"VH" = (
/obj/structure/potted_plant{
	dir = 9;
	icon_state = "plant-39";
	icon = 'icons/obj/flora/plants.dmi';
	pixel_y = 16;
	pixel_x = -8;
	layer = 4
	},
/turf/floor/wood,
/area/caribbean)
"WK" = (
/obj/structure/simple_door/key_door/anyone/singledoor/privacy,
/turf/floor/plating/marble/grid,
/area/caribbean)
"WV" = (
/obj/structure/bed/chair/comfy/fancy_sofa/l{
	dir = 8
	},
/turf/floor/carpet/greencarpet,
/area/caribbean)
"XD" = (
/obj/effect/autoassembler,
/turf/floor/plating/road,
/area/caribbean)
"XQ" = (
/obj/structure/props/junk{
	icon_state = "Junk_4"
	},
/turf/floor/plating/road,
/area/caribbean)
"YW" = (
/obj/structure/props/junk{
	icon_state = "Junk_7"
	},
/obj/effect/decal/cleanable/urine,
/turf/floor/plating/road,
/area/caribbean)
"Zf" = (
/obj/covers/cobblestone/stairs,
/turf/floor/wood,
/area/caribbean)

(1,1,1) = {"
bS
bS
bS
bS
bS
bS
bS
bS
bS
bS
bS
bS
bS
bS
bS
bS
bS
pR
uW
uW
uW
uW
uW
uW
uW
uW
uW
uW
uW
uW
uW
uW
uW
uW
uW
uW
bs
bS
bS
bS
"}
(2,1,1) = {"
bS
bS
bS
bS
XD
bS
bS
bS
bS
bS
bS
bS
bS
bS
bS
bS
bS
pR
uW
uW
uW
uW
uW
uW
uW
uW
uW
uW
uW
uW
uW
uW
uW
uW
uW
uW
bs
bS
bS
bS
"}
(3,1,1) = {"
bS
bS
nM
GT
sp
lt
CB
bS
bS
bS
bS
bS
bS
bS
bS
bS
bS
pR
uW
uW
uW
uW
uW
uW
uW
uW
uW
uW
uW
uW
uW
uW
uW
uW
uW
uW
bs
bS
bS
bS
"}
(4,1,1) = {"
bS
bS
bS
LI
Ij
hk
gZ
bS
bS
bS
bS
bS
bS
bS
bS
bS
bS
pR
pR
pR
pR
pR
pR
pR
pR
pR
pR
pR
pR
pR
pR
pR
pR
pR
pR
pR
bs
bS
bS
bS
"}
(5,1,1) = {"
bS
bS
bS
bS
bS
bS
bS
bS
bS
bS
bS
bS
bS
bS
bS
bS
bS
bS
bS
bS
Id
bS
bS
bS
bS
bS
bS
bS
bS
bS
bS
bS
bS
bS
bS
XQ
YW
bS
bS
bS
"}
(6,1,1) = {"
bS
bS
bS
bS
bS
XD
bS
bS
bS
bS
bS
bS
bS
bS
bS
bS
bS
bS
bS
bS
bS
bS
bS
bS
bS
bS
bS
bS
bS
bS
bS
bS
bS
bS
bS
bS
bS
bS
bS
bS
"}
(7,1,1) = {"
bS
bS
bS
bS
GT
sp
lt
CB
bS
bS
bS
bS
bS
bS
bS
bS
bS
bS
bS
bS
bS
bS
bS
bS
bS
bS
bS
bS
bS
bS
bS
bS
bS
bS
bS
bS
bS
bS
bS
bS
"}
(8,1,1) = {"
bS
bS
bS
sM
LI
Ij
hk
gZ
bS
bS
bS
bS
bS
bS
bS
bS
bS
bs
bs
bs
bs
bs
bs
bs
bs
bs
bs
bs
bs
bs
bs
bs
bs
bs
bs
bs
bs
bS
bS
bS
"}
(9,1,1) = {"
bS
bS
bS
bS
bS
bS
bS
bS
bS
bS
bS
bS
bS
bS
bS
bS
bS
bs
py
pk
pl
tW
pl
pl
wg
pl
pl
bs
dC
bH
bs
eI
eI
eI
eI
eI
bs
bS
bS
bS
"}
(10,1,1) = {"
bS
bS
bS
XD
bS
bS
bS
bS
bS
bS
bS
bS
bS
bS
bS
bS
bS
cL
pl
Tb
pl
zM
pl
pl
wg
pl
pl
bs
pl
pl
Mp
eI
eI
eI
eI
eI
bs
sJ
bS
bS
"}
(11,1,1) = {"
bS
ls
GT
sp
lt
CB
bS
bS
bS
bS
bS
bS
bS
bS
bS
bS
bS
cL
pl
tY
pl
xb
pl
pl
pl
pl
pl
bs
pl
pl
Mp
eI
eI
eI
eI
eI
bs
bS
bS
bS
"}
(12,1,1) = {"
bS
bS
LI
Ij
hk
gZ
bS
bS
bS
bS
bS
bS
bS
bS
bS
bS
bS
bs
pl
tW
pl
Tp
pl
pl
wg
pl
pl
bs
pl
mF
bs
eI
eI
eI
eI
eI
EG
bS
bS
bS
"}
(13,1,1) = {"
bS
bS
bS
bS
bS
bS
bS
bS
bS
bS
bS
bS
bS
bS
bS
bS
bS
aH
pl
pl
pl
pl
pl
pl
zA
pl
pl
bs
pl
jP
bs
eI
eI
eI
eI
eI
bw
bS
bS
bS
"}
(14,1,1) = {"
cJ
bS
cJ
bS
cJ
bS
cJ
bS
cJ
bS
cJ
bS
bS
bS
bS
bS
bS
aH
pl
pl
pl
pl
pl
pl
wg
pl
pl
bs
pl
dC
bs
eI
eI
eI
eI
eI
bs
bS
bS
bS
"}
(15,1,1) = {"
cJ
bS
cJ
bS
cJ
bS
cJ
bS
cJ
bS
cJ
bS
bS
bS
bS
bS
bS
bs
Vx
pl
pl
pl
pl
pl
wg
pl
pl
Fs
pl
ln
bs
eI
eI
eI
eI
eI
bs
bS
bS
bS
"}
(16,1,1) = {"
cJ
bS
cJ
bS
cJ
bS
cJ
bS
cJ
bS
cJ
bS
bS
bS
bS
bS
bS
cL
iF
pl
pl
pl
pl
pl
wg
pl
pl
Fs
pl
df
bs
eI
eI
eI
eI
eI
bs
bS
bS
bS
"}
(17,1,1) = {"
cJ
bS
cJ
bS
cJ
bS
cJ
bS
cJ
bS
cJ
bS
bS
bS
bS
bS
bS
cL
oJ
pl
pl
iZ
Ts
pl
Qr
Ut
pl
bs
pl
dC
bs
eI
eI
eI
eI
eI
bs
bS
bS
bS
"}
(18,1,1) = {"
pR
pR
pR
pR
pR
pR
pR
pR
pR
pR
pR
pR
oD
bS
bS
bs
bs
bs
bs
yS
yS
bs
bs
bs
bs
bs
oo
bs
bs
bs
bs
bs
bs
bs
eI
eI
bs
bS
bS
bS
"}
(19,1,1) = {"
uW
uW
uW
uW
uW
uW
uW
uW
uW
uW
uW
pR
bS
bS
bS
bs
wk
eI
pJ
eI
eI
bs
OV
Ce
bs
HB
zR
Va
HK
sA
kM
aR
HK
bs
eI
eI
bs
bS
bS
bS
"}
(20,1,1) = {"
uW
uW
uW
uW
uW
uW
uW
uW
uW
uW
uW
pR
bS
bS
bS
bs
eI
eI
pJ
eI
eI
bs
Fc
Ce
bs
cr
zR
zR
zR
zR
zR
zR
zR
oo
eI
eI
bs
bS
bS
bS
"}
(21,1,1) = {"
uW
uW
uW
uW
uW
uW
uW
uW
uW
uW
uW
pR
bS
bS
bS
bs
DW
eI
cv
lD
eI
bs
go
Ce
WK
zR
zR
zR
ch
cr
cr
WV
Un
bs
eI
eI
bs
bS
bS
bS
"}
(22,1,1) = {"
uW
uW
uW
uW
uW
uW
uW
uW
uW
uW
uW
pR
bS
bS
bS
bs
Nd
eI
UD
lD
eI
bs
bs
bs
bs
bs
bs
bs
bs
bs
bs
bs
bs
bs
eI
eI
bs
bS
bS
bS
"}
(23,1,1) = {"
uW
uW
uW
uW
uW
uW
uW
uW
uW
uW
uW
pR
bS
bS
bS
bs
eI
eI
pJ
eI
eI
eI
eI
eI
eI
eI
eI
eI
eI
eI
eI
eI
eI
eI
eI
eI
bs
bS
bS
bS
"}
(24,1,1) = {"
uW
uW
uW
uW
uW
uW
uW
uW
uW
uW
uW
pR
bS
bS
bS
bs
VH
eI
pJ
eI
eI
eI
eI
eI
eI
eI
eI
eI
eI
eI
eI
eI
eI
eI
eI
eI
bs
bS
bS
bS
"}
(25,1,1) = {"
uW
uW
uW
uW
uW
uW
uW
uW
uW
uW
uW
pR
bS
bS
bS
bs
bs
bs
bs
bs
bs
eI
bs
bs
bs
CF
CF
bs
bs
bs
eI
bs
bs
bs
bs
bs
bs
bS
bS
bS
"}
(26,1,1) = {"
uW
uW
uW
uW
uW
uW
uW
uW
uW
uW
uW
pR
bS
bS
bS
bs
eG
eG
Zf
Zf
eI
eI
eI
bs
dw
eI
eI
dw
bs
eI
eI
eI
Zf
Zf
Gu
Gu
bs
bS
bS
bS
"}
(27,1,1) = {"
uW
uW
uW
uW
uW
uW
uW
uW
uW
uW
uW
pR
bS
bS
bS
bs
eG
eG
Zf
Zf
eI
eI
eI
bs
dw
eI
eI
dw
bs
eI
eI
eI
Zf
Zf
Gu
Gu
bs
bS
bS
bS
"}
(28,1,1) = {"
uW
uW
uW
uW
uW
uW
uW
uW
uW
uW
uW
pR
pM
bS
bS
bs
bs
bs
bs
bs
bs
bs
bs
bs
bs
bs
bs
bs
bs
bs
bs
bs
bs
bs
bs
bs
bs
bS
bS
bS
"}
(29,1,1) = {"
uW
uW
uW
uW
uW
uW
uW
uW
uW
uW
uW
pR
bS
bS
bS
bS
bS
bS
gU
bL
bS
bS
bS
bS
bS
bS
bS
bS
bS
bS
bS
bS
bS
bS
bS
bS
bS
bS
bS
bS
"}
(30,1,1) = {"
uW
uW
uW
uW
uW
uW
uW
uW
uW
uW
uW
pR
bS
bS
bS
bS
bS
bS
bS
bS
bS
bS
bS
bS
bS
bS
bS
bS
bS
bS
bS
bS
bS
bS
bS
bS
bS
bS
bS
bS
"}
(31,1,1) = {"
uW
uW
uW
uW
uW
uW
uW
uW
uW
uW
uW
pR
bS
bS
bS
bS
bS
bS
bS
bS
bS
bS
bS
bS
bS
bS
bS
bS
bS
bS
bS
bS
bS
bS
bS
bS
bS
bS
bS
bS
"}
(32,1,1) = {"
uW
uW
uW
uW
uW
uW
uW
uW
uW
uW
uW
pR
bS
bS
gU
pR
pR
pR
pR
pR
pR
pR
pR
pR
pR
pR
pR
pR
pR
pR
pR
pR
pR
pR
pR
pR
pR
bS
bS
bS
"}
(33,1,1) = {"
uW
uW
uW
uW
uW
uW
uW
uW
uW
uW
uW
pR
bS
bS
sJ
pR
uW
uW
uW
uW
uW
uW
uW
uW
uW
uW
uW
uW
uW
uW
uW
uW
uW
uW
uW
uW
pR
bS
bS
bS
"}
(34,1,1) = {"
uW
uW
uW
uW
uW
uW
uW
uW
uW
uW
uW
pR
bS
bS
bS
pR
uW
uW
uW
uW
uW
uW
uW
uW
uW
uW
uW
uW
uW
uW
uW
uW
uW
uW
uW
uW
pR
bS
bS
bS
"}
(35,1,1) = {"
uW
uW
uW
uW
uW
uW
uW
uW
uW
uW
uW
pR
bS
bS
bS
pR
uW
uW
uW
uW
uW
uW
uW
uW
uW
uW
uW
uW
uW
uW
uW
uW
uW
uW
uW
uW
pR
bS
bS
bS
"}
(36,1,1) = {"
uW
uW
uW
uW
uW
uW
uW
uW
uW
uW
uW
pR
bS
bS
bS
pR
uW
uW
uW
uW
uW
uW
uW
uW
uW
uW
uW
uW
uW
uW
uW
uW
uW
uW
uW
uW
pR
bS
bS
bS
"}
(37,1,1) = {"
uW
uW
uW
uW
uW
uW
uW
uW
uW
uW
uW
pR
bS
bS
bS
pR
uW
uW
uW
uW
uW
uW
uW
uW
uW
uW
uW
uW
uW
uW
uW
uW
uW
uW
uW
uW
pR
bS
wB
bL
"}
(38,1,1) = {"
uW
uW
uW
uW
uW
uW
uW
uW
uW
uW
uW
pR
bS
bS
bS
pR
uW
uW
uW
uW
uW
uW
uW
uW
uW
uW
uW
uW
uW
uW
uW
uW
uW
uW
uW
uW
pR
bS
bS
bL
"}
(39,1,1) = {"
uW
uW
uW
uW
uW
uW
uW
uW
uW
uW
uW
pR
bS
bS
bS
pR
uW
uW
uW
uW
uW
uW
uW
uW
uW
uW
uW
uW
uW
uW
uW
uW
uW
uW
uW
uW
pR
bS
bS
bS
"}
(40,1,1) = {"
uW
uW
uW
uW
uW
uW
uW
uW
uW
uW
uW
pR
bS
bS
bS
pR
uW
uW
uW
uW
uW
uW
uW
uW
uW
uW
uW
uW
uW
uW
uW
uW
uW
uW
uW
uW
pR
bS
bS
bS
"}

(1,1,2) = {"
bo
bo
bo
bo
bo
bo
bo
bo
bo
bo
bo
bo
bo
bo
bo
bo
bo
bo
bo
bo
bo
bo
bo
bo
bo
bo
bo
bo
bo
bo
bo
bo
bo
bo
bo
bo
bo
bo
bo
bo
"}
(2,1,2) = {"
bo
bo
bo
bo
bo
bo
bo
bo
bo
bo
bo
bo
bo
bo
bo
bo
bo
bo
bo
bo
bo
bo
bo
bo
bo
bo
bo
bo
bo
bo
bo
bo
bo
bo
bo
bo
bo
bo
bo
bo
"}
(3,1,2) = {"
bo
bo
bo
bo
bo
bo
bo
bo
bo
bo
bo
bo
bo
bo
bo
bo
bo
bo
bo
bo
bo
bo
bo
bo
bo
bo
bo
bo
bo
bo
bo
bo
bo
bo
bo
bo
bo
bo
bo
bo
"}
(4,1,2) = {"
bo
bo
bo
bo
bo
bo
bo
bo
bo
bo
bo
bo
bo
bo
bo
bo
bo
bo
bo
bo
bo
bo
bo
bo
bo
bo
bo
bo
bo
bo
bo
bo
bo
bo
bo
bo
bo
bo
bo
bo
"}
(5,1,2) = {"
bo
bo
bo
bo
bo
bo
bo
bo
bo
bo
bo
bo
bo
bo
bo
bo
bo
bo
bo
bo
bo
bo
bo
bo
bo
bo
bo
bo
bo
bo
bo
bo
bo
bo
bo
bo
bo
bo
bo
bo
"}
(6,1,2) = {"
bo
bo
bo
bo
bo
bo
bo
bo
bo
bo
bo
bo
bo
bo
bo
bo
bo
bo
bo
bo
bo
bo
bo
bo
bo
bo
bo
bo
bo
bo
bo
bo
bo
bo
bo
bo
bo
bo
bo
bo
"}
(7,1,2) = {"
bo
bo
bo
bo
bo
bo
bo
bo
bo
bo
bo
bo
bo
bo
bo
bo
bo
bo
bo
bo
bo
bo
bo
bo
bo
bo
bo
bo
bo
bo
bo
bo
bo
bo
bo
bo
bo
bo
bo
bo
"}
(8,1,2) = {"
bo
bo
bo
bo
bo
bo
bo
bo
bo
bo
bo
bo
bo
bo
bo
bo
bo
bo
bo
bo
bo
bo
bo
bo
bo
bo
bo
bo
bo
bo
bo
bo
bo
bo
bo
bo
bo
bo
bo
bo
"}
(9,1,2) = {"
bo
bo
bo
bo
bo
bo
bo
bo
bo
bo
bo
bo
bo
bo
bo
bo
bo
bo
bo
bo
bo
bo
bo
bo
bo
bo
bo
bo
bo
bo
bo
bo
bo
bo
bo
bo
bo
bo
bo
bo
"}
(10,1,2) = {"
bo
bo
bo
bo
bo
bo
bo
bo
bo
bo
bo
bo
bo
bo
bo
bo
bo
bo
bo
bo
bo
bo
bo
bo
bo
bo
bo
bo
bo
bo
bo
bo
bo
bo
bo
bo
bo
bo
bo
bo
"}
(11,1,2) = {"
bo
bo
bo
bo
bo
bo
bo
bo
bo
bo
bo
bo
bo
bo
bo
bo
bo
bo
bo
bo
bo
bo
bo
bo
bo
bo
bo
bo
bo
bo
bo
bo
bo
bo
bo
bo
bo
bo
bo
bo
"}
(12,1,2) = {"
bo
bo
bo
bo
bo
bo
bo
bo
bo
bo
bo
bo
bo
bo
bo
bo
bo
bo
bo
bo
bo
bo
bo
bo
bo
bo
bo
bo
bo
bo
bo
bo
bo
bo
bo
bo
bo
bo
bo
bo
"}
(13,1,2) = {"
bo
bo
bo
bo
bo
bo
bo
bo
bo
bo
bo
bo
bo
bo
bo
bo
bo
bo
bo
bo
bo
bo
bo
bo
bo
bo
bo
bo
bo
bo
bo
bo
bo
bo
bo
bo
bo
bo
bo
bo
"}
(14,1,2) = {"
bo
bo
bo
bo
bo
bo
bo
bo
bo
bo
bo
bo
bo
bo
bo
bo
bo
bo
bo
bo
bo
bo
bo
bo
bo
bo
bo
bo
bo
bo
bo
bo
bo
bo
bo
bo
bo
bo
bo
bo
"}
(15,1,2) = {"
bo
bo
bo
bo
bo
bo
bo
bo
bo
bo
bo
bo
bo
bo
bo
bo
bo
bo
bo
bo
bo
bo
bo
bo
bo
bo
bo
bo
bo
bo
bo
bo
bo
bo
bo
bo
bo
bo
bo
bo
"}
(16,1,2) = {"
bo
bo
bo
bo
bo
bo
bo
bo
bo
bo
bo
bo
bo
bo
bo
bo
bo
bo
bo
bo
bo
bo
bo
bo
bo
bo
bo
bo
bo
bo
bo
bo
bo
bo
bo
bo
bo
bo
bo
bo
"}
(17,1,2) = {"
bo
bo
bo
bo
bo
bo
bo
bo
bo
bo
bo
bo
bo
bo
bo
bo
bo
bo
bo
bo
bo
bo
bo
bo
bo
bo
bo
bo
bo
bo
bo
bo
bo
bo
bo
bo
bo
bo
bo
bo
"}
(18,1,2) = {"
bo
bo
bo
bo
bo
bo
bo
bo
bo
bo
bo
bo
bo
bo
bo
bo
bo
bo
bo
bo
bo
bo
bo
bo
bo
bo
bo
bo
bo
bo
bo
bo
bo
bo
bo
bo
bo
bo
bo
bo
"}
(19,1,2) = {"
bo
bo
bo
bo
bo
bo
bo
bo
bo
bo
bo
bo
bo
bo
bo
bo
bo
bo
bo
bo
bo
bo
bo
bo
bo
bo
bo
bo
bo
bo
bo
bo
bo
bo
bo
bo
bo
bo
bo
bo
"}
(20,1,2) = {"
bo
bo
bo
bo
bo
bo
bo
bo
bo
bo
bo
bo
bo
bo
bo
bo
bo
bo
bo
bo
bo
bo
bo
bo
bo
bo
bo
bo
bo
bo
bo
bo
bo
bo
bo
bo
bo
bo
bo
bo
"}
(21,1,2) = {"
bo
bo
bo
bo
bo
bo
bo
bo
bo
bo
bo
bo
bo
bo
bo
bo
bo
bo
bo
bo
bo
bo
bo
bo
bo
bo
bo
bo
bo
bo
bo
bo
bo
bo
bo
bo
bo
bo
bo
bo
"}
(22,1,2) = {"
bo
bo
bo
bo
bo
bo
bo
bo
bo
bo
bo
bo
bo
bo
bo
bo
bo
bo
bo
bo
bo
bo
bo
bo
bo
bo
bo
bo
bo
bo
bo
bo
bo
bo
bo
bo
bo
bo
bo
bo
"}
(23,1,2) = {"
bo
bo
bo
bo
bo
bo
bo
bo
bo
bo
bo
bo
bo
bo
bo
bo
bo
bo
bo
bo
bo
bo
bo
bo
bo
bo
bo
bo
bo
bo
bo
bo
bo
bo
bo
bo
bo
bo
bo
bo
"}
(24,1,2) = {"
bo
bo
bo
bo
bo
bo
bo
bo
bo
bo
bo
bo
bo
bo
bo
bo
bo
bo
bo
bo
bo
bo
bo
bo
bo
bo
bo
bo
bo
bo
bo
bo
bo
bo
bo
bo
bo
bo
bo
bo
"}
(25,1,2) = {"
bo
bo
bo
bo
bo
bo
bo
bo
bo
bo
bo
bo
bo
bo
bo
bo
bo
bo
bo
bo
bo
bo
bo
bo
bo
bo
bo
bo
bo
bo
bo
bo
bo
bo
bo
bo
bo
bo
bo
bo
"}
(26,1,2) = {"
bo
bo
bo
bo
bo
bo
bo
bo
bo
bo
bo
bo
bo
bo
bo
bo
bo
bo
bo
bo
bo
bo
bo
bo
bo
bo
bo
bo
bo
bo
bo
bo
bo
bo
bo
bo
bo
bo
bo
bo
"}
(27,1,2) = {"
bo
bo
bo
bo
bo
bo
bo
bo
bo
bo
bo
bo
bo
bo
bo
bo
bo
bo
bo
bo
bo
bo
bo
bo
bo
bo
bo
bo
bo
bo
bo
bo
bo
bo
bo
bo
bo
bo
bo
bo
"}
(28,1,2) = {"
bo
bo
bo
bo
bo
bo
bo
bo
bo
bo
bo
bo
bo
bo
bo
bo
bo
bo
bo
bo
bo
bo
bo
bo
bo
bo
bo
bo
bo
bo
bo
bo
bo
bo
bo
bo
bo
bo
bo
bo
"}
(29,1,2) = {"
bo
bo
bo
bo
bo
bo
bo
bo
bo
bo
bo
bo
bo
bo
bo
bo
bo
bo
bo
bo
bo
bo
bo
bo
bo
bo
bo
bo
bo
bo
bo
bo
bo
bo
bo
bo
bo
bo
bo
bo
"}
(30,1,2) = {"
bo
bo
bo
bo
bo
bo
bo
bo
bo
bo
bo
bo
bo
bo
bo
bo
bo
bo
bo
bo
bo
bo
bo
bo
bo
bo
bo
bo
bo
bo
bo
bo
bo
bo
bo
bo
bo
bo
bo
bo
"}
(31,1,2) = {"
bo
bo
bo
bo
bo
bo
bo
bo
bo
bo
bo
bo
bo
bo
bo
bo
bo
bo
bo
bo
bo
bo
bo
bo
bo
bo
bo
bo
bo
bo
bo
bo
bo
bo
bo
bo
bo
bo
bo
bo
"}
(32,1,2) = {"
bo
bo
bo
bo
bo
bo
bo
bo
bo
bo
bo
bo
bo
bo
bo
bo
bo
bo
bo
bo
bo
bo
bo
bo
bo
bo
bo
bo
bo
bo
bo
bo
bo
bo
bo
bo
bo
bo
bo
bo
"}
(33,1,2) = {"
bo
bo
bo
bo
bo
bo
bo
bo
bo
bo
bo
bo
bo
bo
bo
bo
bo
bo
bo
bo
bo
bo
bo
bo
bo
bo
bo
bo
bo
bo
bo
bo
bo
bo
bo
bo
bo
bo
bo
bo
"}
(34,1,2) = {"
bo
bo
bo
bo
bo
bo
bo
bo
bo
bo
bo
bo
bo
bo
bo
bo
bo
bo
bo
bo
bo
bo
bo
bo
bo
bo
bo
bo
bo
bo
bo
bo
bo
bo
bo
bo
bo
bo
bo
bo
"}
(35,1,2) = {"
bo
bo
bo
bo
bo
bo
bo
bo
bo
bo
bo
bo
bo
bo
bo
bo
bo
bo
bo
bo
bo
bo
bo
bo
bo
bo
bo
bo
bo
bo
bo
bo
bo
bo
bo
bo
bo
bo
bo
bo
"}
(36,1,2) = {"
bo
bo
bo
bo
bo
bo
bo
bo
bo
bo
bo
bo
bo
bo
bo
bo
bo
bo
bo
bo
bo
bo
bo
bo
bo
bo
bo
bo
bo
bo
bo
bo
bo
bo
bo
bo
bo
bo
bo
bo
"}
(37,1,2) = {"
bo
bo
bo
bo
bo
bo
bo
bo
bo
bo
bo
bo
bo
bo
bo
bo
bo
bo
bo
bo
bo
bo
bo
bo
bo
bo
bo
bo
bo
bo
bo
bo
bo
bo
bo
bo
bo
bo
bo
bo
"}
(38,1,2) = {"
bo
bo
bo
bo
bo
bo
bo
bo
bo
bo
bo
bo
bo
bo
bo
bo
bo
bo
bo
bo
bo
bo
bo
bo
bo
bo
bo
bo
bo
bo
bo
bo
bo
bo
bo
bo
bo
bo
bo
bo
"}
(39,1,2) = {"
bo
bo
bo
bo
bo
bo
bo
bo
bo
bo
bo
bo
bo
bo
bo
bo
bo
bo
bo
bo
bo
bo
bo
bo
bo
bo
bo
bo
bo
bo
bo
bo
bo
bo
bo
bo
bo
bo
bo
bo
"}
(40,1,2) = {"
bo
bo
bo
bo
bo
bo
bo
bo
bo
bo
bo
bo
bo
bo
bo
bo
bo
bo
bo
bo
bo
bo
bo
bo
bo
bo
bo
bo
bo
bo
bo
bo
bo
bo
bo
bo
bo
bo
bo
bo
"}

(1,1,3) = {"
bo
bo
bo
bo
bo
bo
bo
bo
bo
bo
bo
bo
bo
bo
bo
bo
bo
bo
bo
bo
bo
bo
bo
bo
bo
bo
bo
bo
bo
bo
bo
bo
bo
bo
bo
bo
bo
bo
bo
bo
"}
(2,1,3) = {"
bo
bo
bo
bo
bo
bo
bo
bo
bo
bo
bo
bo
bo
bo
bo
bo
bo
bo
bo
bo
bo
bo
bo
bo
bo
bo
bo
bo
bo
bo
bo
bo
bo
bo
bo
bo
bo
bo
bo
bo
"}
(3,1,3) = {"
bo
bo
bo
bo
bo
bo
bo
bo
bo
bo
bo
bo
bo
bo
bo
bo
bo
bo
bo
bo
bo
bo
bo
bo
bo
bo
bo
bo
bo
bo
bo
bo
bo
bo
bo
bo
bo
bo
bo
bo
"}
(4,1,3) = {"
bo
bo
bo
bo
bo
bo
bo
bo
bo
bo
bo
bo
bo
bo
bo
bo
bo
bo
bo
bo
bo
bo
bo
bo
bo
bo
bo
bo
bo
bo
bo
bo
bo
bo
bo
bo
bo
bo
bo
bo
"}
(5,1,3) = {"
bo
bo
bo
bo
bo
bo
bo
bo
bo
bo
bo
bo
bo
bo
bo
bo
bo
bo
bo
bo
bo
bo
bo
bo
bo
bo
bo
bo
bo
bo
bo
bo
bo
bo
bo
bo
bo
bo
bo
bo
"}
(6,1,3) = {"
bo
bo
bo
bo
bo
bo
bo
bo
bo
bo
bo
bo
bo
bo
bo
bo
bo
bo
bo
bo
bo
bo
bo
bo
bo
bo
bo
bo
bo
bo
bo
bo
bo
bo
bo
bo
bo
bo
bo
bo
"}
(7,1,3) = {"
bo
bo
bo
bo
bo
bo
bo
bo
bo
bo
bo
bo
bo
bo
bo
bo
bo
bo
bo
bo
bo
bo
bo
bo
bo
bo
bo
bo
bo
bo
bo
bo
bo
bo
bo
bo
bo
bo
bo
bo
"}
(8,1,3) = {"
bo
bo
bo
bo
bo
bo
bo
bo
bo
bo
bo
bo
bo
bo
bo
bo
bo
bo
bo
bo
bo
bo
bo
bo
bo
bo
bo
bo
bo
bo
bo
bo
bo
bo
bo
bo
bo
bo
bo
bo
"}
(9,1,3) = {"
bo
bo
bo
bo
bo
bo
bo
bo
bo
bo
bo
bo
bo
bo
bo
bo
bo
bo
bo
bo
bo
bo
bo
bo
bo
bo
bo
bo
bo
bo
bo
bo
bo
bo
bo
bo
bo
bo
bo
bo
"}
(10,1,3) = {"
bo
bo
bo
bo
bo
bo
bo
bo
bo
bo
bo
bo
bo
bo
bo
bo
bo
bo
bo
bo
bo
bo
bo
bo
bo
bo
bo
bo
bo
bo
bo
bo
bo
bo
bo
bo
bo
bo
bo
bo
"}
(11,1,3) = {"
bo
bo
bo
bo
bo
bo
bo
bo
bo
bo
bo
bo
bo
bo
bo
bo
bo
bo
bo
bo
bo
bo
bo
bo
bo
bo
bo
bo
bo
bo
bo
bo
bo
bo
bo
bo
bo
bo
bo
bo
"}
(12,1,3) = {"
bo
bo
bo
bo
bo
bo
bo
bo
bo
bo
bo
bo
bo
bo
bo
bo
bo
bo
bo
bo
bo
bo
bo
bo
bo
bo
bo
bo
bo
bo
bo
bo
bo
bo
bo
bo
bo
bo
bo
bo
"}
(13,1,3) = {"
bo
bo
bo
bo
bo
bo
bo
bo
bo
bo
bo
bo
bo
bo
bo
bo
bo
bo
bo
bo
bo
bo
bo
bo
bo
bo
bo
bo
bo
bo
bo
bo
bo
bo
bo
bo
bo
bo
bo
bo
"}
(14,1,3) = {"
bo
bo
bo
bo
bo
bo
bo
bo
bo
bo
bo
bo
bo
bo
bo
bo
bo
bo
bo
bo
bo
bo
bo
bo
bo
bo
bo
bo
bo
bo
bo
bo
bo
bo
bo
bo
bo
bo
bo
bo
"}
(15,1,3) = {"
bo
bo
bo
bo
bo
bo
bo
bo
bo
bo
bo
bo
bo
bo
bo
bo
bo
bo
bo
bo
bo
bo
bo
bo
bo
bo
bo
bo
bo
bo
bo
bo
bo
bo
bo
bo
bo
bo
bo
bo
"}
(16,1,3) = {"
bo
bo
bo
bo
bo
bo
bo
bo
bo
bo
bo
bo
bo
bo
bo
bo
bo
bo
bo
bo
bo
bo
bo
bo
bo
bo
bo
bo
bo
bo
bo
bo
bo
bo
bo
bo
bo
bo
bo
bo
"}
(17,1,3) = {"
bo
bo
bo
bo
bo
bo
bo
bo
bo
bo
bo
bo
bo
bo
bo
bo
bo
bo
bo
bo
bo
bo
bo
bo
bo
bo
bo
bo
bo
bo
bo
bo
bo
bo
bo
bo
bo
bo
bo
bo
"}
(18,1,3) = {"
bo
bo
bo
bo
bo
bo
bo
bo
bo
bo
bo
bo
bo
bo
bo
bo
bo
bo
bo
bo
bo
bo
bo
bo
bo
bo
bo
bo
bo
bo
bo
bo
bo
bo
bo
bo
bo
bo
bo
bo
"}
(19,1,3) = {"
bo
bo
bo
bo
bo
bo
bo
bo
bo
bo
bo
bo
bo
bo
bo
bo
bo
bo
bo
bo
bo
bo
bo
bo
bo
bo
bo
bo
bo
bo
bo
bo
bo
bo
bo
bo
bo
bo
bo
bo
"}
(20,1,3) = {"
bo
bo
bo
bo
bo
bo
bo
bo
bo
bo
bo
bo
bo
bo
bo
bo
bo
bo
bo
bo
bo
bo
bo
bo
bo
bo
bo
bo
bo
bo
bo
bo
bo
bo
bo
bo
bo
bo
bo
bo
"}
(21,1,3) = {"
bo
bo
bo
bo
bo
bo
bo
bo
bo
bo
bo
bo
bo
bo
bo
bo
bo
bo
bo
bo
bo
bo
bo
bo
bo
bo
bo
bo
bo
bo
bo
bo
bo
bo
bo
bo
bo
bo
bo
bo
"}
(22,1,3) = {"
bo
bo
bo
bo
bo
bo
bo
bo
bo
bo
bo
bo
bo
bo
bo
bo
bo
bo
bo
bo
bo
bo
bo
bo
bo
bo
bo
bo
bo
bo
bo
bo
bo
bo
bo
bo
bo
bo
bo
bo
"}
(23,1,3) = {"
bo
bo
bo
bo
bo
bo
bo
bo
bo
bo
bo
bo
bo
bo
bo
bo
bo
bo
bo
bo
bo
bo
bo
bo
bo
bo
bo
bo
bo
bo
bo
bo
bo
bo
bo
bo
bo
bo
bo
bo
"}
(24,1,3) = {"
bo
bo
bo
bo
bo
bo
bo
bo
bo
bo
bo
bo
bo
bo
bo
bo
bo
bo
bo
bo
bo
bo
bo
bo
bo
bo
bo
bo
bo
bo
bo
bo
bo
bo
bo
bo
bo
bo
bo
bo
"}
(25,1,3) = {"
bo
bo
bo
bo
bo
bo
bo
bo
bo
bo
bo
bo
bo
bo
bo
bo
bo
bo
bo
bo
bo
bo
bo
bo
bo
bo
bo
bo
bo
bo
bo
bo
bo
bo
bo
bo
bo
bo
bo
bo
"}
(26,1,3) = {"
bo
bo
bo
bo
bo
bo
bo
bo
bo
bo
bo
bo
bo
bo
bo
bo
bo
bo
bo
bo
bo
bo
bo
bo
bo
bo
bo
bo
bo
bo
bo
bo
bo
bo
bo
bo
bo
bo
bo
bo
"}
(27,1,3) = {"
bo
bo
bo
bo
bo
bo
bo
bo
bo
bo
bo
bo
bo
bo
bo
bo
bo
bo
bo
bo
bo
bo
bo
bo
bo
bo
bo
bo
bo
bo
bo
bo
bo
bo
bo
bo
bo
bo
bo
bo
"}
(28,1,3) = {"
bo
bo
bo
bo
bo
bo
bo
bo
bo
bo
bo
bo
bo
bo
bo
bo
bo
bo
bo
bo
bo
bo
bo
bo
bo
bo
bo
bo
bo
bo
bo
bo
bo
bo
bo
bo
bo
bo
bo
bo
"}
(29,1,3) = {"
bo
bo
bo
bo
bo
bo
bo
bo
bo
bo
bo
bo
bo
bo
bo
bo
bo
bo
bo
bo
bo
bo
bo
bo
bo
bo
bo
bo
bo
bo
bo
bo
bo
bo
bo
bo
bo
bo
bo
bo
"}
(30,1,3) = {"
bo
bo
bo
bo
bo
bo
bo
bo
bo
bo
bo
bo
bo
bo
bo
bo
bo
bo
bo
bo
bo
bo
bo
bo
bo
bo
bo
bo
bo
bo
bo
bo
bo
bo
bo
bo
bo
bo
bo
bo
"}
(31,1,3) = {"
bo
bo
bo
bo
bo
bo
bo
bo
bo
bo
bo
bo
bo
bo
bo
bo
bo
bo
bo
bo
bo
bo
bo
bo
bo
bo
bo
bo
bo
bo
bo
bo
bo
bo
bo
bo
bo
bo
bo
bo
"}
(32,1,3) = {"
bo
bo
bo
bo
bo
bo
bo
bo
bo
bo
bo
bo
bo
bo
bo
bo
bo
bo
bo
bo
bo
bo
bo
bo
bo
bo
bo
bo
bo
bo
bo
bo
bo
bo
bo
bo
bo
bo
bo
bo
"}
(33,1,3) = {"
bo
bo
bo
bo
bo
bo
bo
bo
bo
bo
bo
bo
bo
bo
bo
bo
bo
bo
bo
bo
bo
bo
bo
bo
bo
bo
bo
bo
bo
bo
bo
bo
bo
bo
bo
bo
bo
bo
bo
bo
"}
(34,1,3) = {"
bo
bo
bo
bo
bo
bo
bo
bo
bo
bo
bo
bo
bo
bo
bo
bo
bo
bo
bo
bo
bo
bo
bo
bo
bo
bo
bo
bo
bo
bo
bo
bo
bo
bo
bo
bo
bo
bo
bo
bo
"}
(35,1,3) = {"
bo
bo
bo
bo
bo
bo
bo
bo
bo
bo
bo
bo
bo
bo
bo
bo
bo
bo
bo
bo
bo
bo
bo
bo
bo
bo
bo
bo
bo
bo
bo
bo
bo
bo
bo
bo
bo
bo
bo
bo
"}
(36,1,3) = {"
bo
bo
bo
bo
bo
bo
bo
bo
bo
bo
bo
bo
bo
bo
bo
bo
bo
bo
bo
bo
bo
bo
bo
bo
bo
bo
bo
bo
bo
bo
bo
bo
bo
bo
bo
bo
bo
bo
bo
bo
"}
(37,1,3) = {"
bo
bo
bo
bo
bo
bo
bo
bo
bo
bo
bo
bo
bo
bo
bo
bo
bo
bo
bo
bo
bo
bo
bo
bo
bo
bo
bo
bo
bo
bo
bo
bo
bo
bo
bo
bo
bo
bo
bo
bo
"}
(38,1,3) = {"
bo
bo
bo
bo
bo
bo
bo
bo
bo
bo
bo
bo
bo
bo
bo
bo
bo
bo
bo
bo
bo
bo
bo
bo
bo
bo
bo
bo
bo
bo
bo
bo
bo
bo
bo
bo
bo
bo
bo
bo
"}
(39,1,3) = {"
bo
bo
bo
bo
bo
bo
bo
bo
bo
bo
bo
bo
bo
bo
bo
bo
bo
bo
bo
bo
bo
bo
bo
bo
bo
bo
bo
bo
bo
bo
bo
bo
bo
bo
bo
bo
bo
bo
bo
bo
"}
(40,1,3) = {"
bo
bo
bo
bo
bo
bo
bo
bo
bo
bo
bo
bo
bo
bo
bo
bo
bo
bo
bo
bo
bo
bo
bo
bo
bo
bo
bo
bo
bo
bo
bo
bo
bo
bo
bo
bo
bo
bo
bo
bo
"}
