//MAP CONVERTED BY dmm2tgm.py THIS HEADER COMMENT PREVENTS RECONVERSION, DO NOT REMOVE
"cB" = (
/obj/structure/table/wood,
/obj/item/weapon/reagent_containers/food/drinks/clay/largeclaypitcher/gold,
/turf/floor/wood,
/area/caribbean)
"de" = (
/turf/floor/dirt/dust,
/area/caribbean)
"di" = (
/turf/floor/winter,
/area/caribbean)
"eo" = (
/obj/effect/landmark{
	icon_state = "x3";
	name = "JoinLateGR"
	},
/turf/floor/winter,
/area/caribbean)
"eI" = (
/obj/effect/landmark{
	name = "JoinLateRO"
	},
/turf/floor/dirt/dust,
/area/caribbean)
"gS" = (
/turf/floor/beach/water/deep,
/area/caribbean)
"iE" = (
/obj/structure/wild/smallbush/winter,
/turf/floor/winter,
/area/caribbean)
"iO" = (
/obj/covers/wood,
/turf/floor/beach/water/deep,
/area/caribbean)
"jR" = (
/turf/floor/beach/water/ice,
/area/caribbean)
"jY" = (
/obj/structure/simple_door/key_door/anyone/nordic,
/turf/floor/wood,
/area/caribbean)
"kg" = (
/obj/covers/stone_wall/brick/archway{
	dir = 1
	},
/obj/structure/window/barrier/railing/stone,
/turf/floor/beach/water,
/area/caribbean)
"kp" = (
/obj/covers/repairedfloor,
/turf/floor/beach/water,
/area/caribbean)
"kU" = (
/obj/covers/stone_wall/brick/archway,
/obj/structure/window/barrier/railing/stone{
	dir = 1;
	icon_state = "stone"
	},
/turf/floor/beach/water/deep,
/area/caribbean)
"nO" = (
/obj/structure/closet/crate/empty,
/obj/item/weapon/material/sword/longsword/iron,
/obj/item/weapon/material/sword/longsword/iron,
/obj/item/weapon/material/sword/longsword/iron,
/turf/floor/wood,
/area/caribbean)
"oe" = (
/obj/effect/landmark{
	icon_state = "x3";
	name = "JoinLateGRK"
	},
/turf/floor/winter,
/area/caribbean)
"rG" = (
/obj/item/stack/material/straw,
/obj/effect/landmark{
	name = "JoinLateRO"
	},
/turf/floor/dirt/dust,
/area/caribbean)
"rZ" = (
/obj/structure/table/wood,
/obj/item/weapon/reagent_containers/food/drinks/bottle/small/mead,
/turf/floor/wood,
/area/caribbean)
"so" = (
/obj/structure/table/wood,
/obj/item/weapon/reagent_containers/food/snacks/tomatosoup,
/turf/floor/wood,
/area/caribbean)
"sx" = (
/obj/covers/repairedfloor,
/turf/floor/beach/water/ice,
/area/caribbean)
"tb" = (
/obj/structure/closet/crate/arrows/iron,
/turf/floor/winter,
/area/caribbean)
"vw" = (
/obj/structure/table/wood,
/obj/item/weapon/reagent_containers/food/drinks/drinkingglass/wood,
/turf/floor/wood,
/area/caribbean)
"yw" = (
/obj/structure/closet/crate/empty,
/obj/effect/decal/cleanable/cobweb{
	dir = 4
	},
/obj/item/weapon/material/sword/broadsword,
/obj/item/weapon/material/sword/broadsword,
/obj/item/weapon/material/sword/broadsword,
/turf/floor/wood,
/area/caribbean)
"zF" = (
/obj/structure/bed/chair/wood{
	dir = 8
	},
/turf/floor/wood,
/area/caribbean)
"Eh" = (
/turf/floor/winter/grass,
/area/caribbean)
"Eq" = (
/obj/covers/wood,
/turf/floor/beach/water/ice,
/area/caribbean)
"EZ" = (
/obj/item/stack/material/straw,
/turf/floor/dirt/dust,
/area/caribbean)
"FF" = (
/obj/structure/wild/tree/live_tree/pine/snow,
/turf/floor/winter,
/area/caribbean)
"Ga" = (
/obj/structure/vehicle/carriage,
/turf/floor/winter,
/area/caribbean)
"Ge" = (
/obj/structure/curtain/leather/open,
/turf/floor/dirt/dust,
/area/caribbean)
"Gf" = (
/obj/structure/closet/crate/empty,
/obj/item/weapon/material/sword/armingsword/iron,
/obj/item/weapon/material/sword/armingsword/iron,
/obj/item/weapon/material/sword/armingsword/iron,
/turf/floor/wood,
/area/caribbean)
"Gq" = (
/obj/structure/closet/crate/chest,
/obj/item/stack/money/goldcoin,
/turf/floor/wood,
/area/caribbean)
"Hb" = (
/obj/covers/repairedfloor,
/turf/floor/beach/water/deep,
/area/caribbean)
"Jh" = (
/obj/covers/stone_wall/brick,
/turf/wall/stone/stonebrick,
/area/caribbean)
"JW" = (
/obj/structure/closet/crate/arrows/iron,
/turf/floor/wood,
/area/caribbean)
"Kj" = (
/obj/structure/closet/crate/empty,
/obj/effect/decal/cleanable/cobweb2,
/obj/item/clothing/suit/armor/ancient/chainmail,
/obj/item/clothing/suit/armor/ancient/chainmail,
/obj/item/clothing/suit/armor/ancient/chainmail,
/obj/item/clothing/head/helmet/medieval/viking,
/obj/item/clothing/head/helmet/medieval/viking,
/obj/item/clothing/head/helmet/medieval/viking,
/obj/item/weapon/shield/iron,
/obj/item/weapon/shield/iron,
/obj/item/weapon/shield/iron,
/turf/floor/wood,
/area/caribbean)
"KH" = (
/obj/covers/stone_wall/brick/archway,
/obj/structure/window/barrier/railing/stone{
	dir = 1;
	icon_state = "stone"
	},
/turf/floor/beach/water,
/area/caribbean)
"LL" = (
/obj/structure/oven/fireplace,
/turf/floor/winter,
/area/caribbean)
"Mn" = (
/obj/structure/table/wood,
/obj/item/weapon/reagent_containers/food/snacks/mushroomsoup,
/turf/floor/wood,
/area/caribbean)
"NI" = (
/obj/structure/table/wood,
/obj/item/weapon/reagent_containers/food/snacks/flatbread,
/turf/floor/wood,
/area/caribbean)
"Pc" = (
/obj/structure/bed/chair/wood{
	dir = 4
	},
/turf/floor/wood,
/area/caribbean)
"PQ" = (
/turf/floor/wood,
/area/caribbean)
"QE" = (
/obj/structure/wild/smallbush/winter,
/turf/floor/winter/grass,
/area/caribbean)
"QR" = (
/obj/structure/closet/crate/chest,
/obj/effect/decal/cleanable/dirt,
/turf/floor/wood,
/area/caribbean)
"RJ" = (
/obj/structure/table/wood,
/turf/floor/wood,
/area/caribbean)
"RM" = (
/obj/structure/table/wood,
/obj/item/weapon/reagent_containers/food/snacks/meatpie,
/turf/floor/wood,
/area/caribbean)
"RQ" = (
/obj/structure/curtain/leather/open,
/turf/floor/wood,
/area/caribbean)
"TU" = (
/obj/covers/wood,
/turf/floor/beach/water,
/area/caribbean)
"Uw" = (
/turf/floor/beach/water,
/area/caribbean)
"Vz" = (
/obj/covers/repairedfloor,
/turf/floor/winter,
/area/caribbean)
"VO" = (
/mob/living/simple_animal/horse/black,
/turf/floor/winter,
/area/caribbean)
"We" = (
/obj/covers/wood_wall/nordic,
/turf/wall/wood,
/area/caribbean)
"WP" = (
/obj/structure/table/wood,
/obj/item/stack/money/goldvaluables,
/turf/floor/wood,
/area/caribbean)
"WT" = (
/obj/structure/closet/crate/empty,
/obj/effect/decal/cleanable/dirt,
/obj/item/weapon/gun/projectile/bow/shortbow,
/obj/item/weapon/gun/projectile/bow/shortbow,
/obj/item/weapon/gun/projectile/bow/longbow,
/obj/item/weapon/gun/projectile/bow/longbow,
/obj/item/weapon/storage/backpack/quiver/medieval,
/obj/item/weapon/storage/backpack/quiver/medieval,
/turf/floor/wood,
/area/caribbean)
"Yu" = (
/obj/covers/wood_wall/nordic,
/obj/item/flashlight/torch/on/unlimited,
/turf/wall/wood,
/area/caribbean)
"Ze" = (
/obj/covers/stone_wall/brick/archway{
	dir = 1
	},
/obj/structure/window/barrier/railing/stone,
/turf/floor/beach/water/deep,
/area/caribbean)

(1,1,1) = {"
di
di
di
di
di
di
di
di
di
di
di
di
di
di
di
di
di
di
di
di
di
di
di
di
di
di
di
di
di
di
di
di
di
di
di
di
di
di
di
di
di
di
di
di
di
di
di
di
di
di
di
di
di
di
di
di
di
di
di
di
di
di
di
di
di
di
di
di
di
di
di
di
di
di
di
di
di
di
di
di
"}
(2,1,1) = {"
di
di
di
di
di
di
di
di
di
di
di
di
di
di
di
FF
di
di
di
di
di
di
di
di
di
di
di
di
di
di
di
di
di
di
di
di
di
di
di
di
di
di
di
di
di
di
di
di
di
di
di
di
di
di
di
di
di
di
di
di
di
di
di
di
di
di
di
di
di
di
di
di
di
di
tb
di
di
di
di
di
"}
(3,1,1) = {"
di
di
di
FF
di
di
di
di
di
di
di
di
di
di
di
di
di
di
di
di
di
di
di
di
di
di
di
di
di
di
di
di
di
di
di
di
di
di
di
di
di
di
di
di
di
di
di
di
di
di
di
di
di
di
di
di
di
di
di
di
di
di
di
di
di
di
di
di
di
di
di
di
di
di
di
di
di
di
di
di
"}
(4,1,1) = {"
di
di
di
di
di
di
di
di
di
di
di
di
di
di
di
di
di
di
di
di
di
di
di
di
di
FF
di
di
di
di
di
di
di
di
di
di
di
di
di
di
di
di
di
di
di
di
di
di
di
di
di
di
di
di
FF
di
di
di
di
di
di
di
di
di
di
FF
di
di
di
di
di
di
di
di
di
di
di
di
di
di
"}
(5,1,1) = {"
di
di
di
di
di
di
di
di
FF
di
di
di
di
di
di
di
di
di
di
di
di
di
di
di
di
di
di
di
di
di
di
di
FF
di
di
di
di
di
di
di
di
di
di
di
di
di
FF
di
di
di
di
di
di
di
di
di
di
di
di
di
di
di
di
di
di
di
di
di
di
di
di
di
FF
di
eo
eo
eo
di
di
di
"}
(6,1,1) = {"
di
di
di
di
di
di
di
di
di
di
di
iE
di
di
di
di
di
di
di
di
di
di
di
di
di
di
di
di
di
di
di
di
di
di
di
di
di
di
FF
di
di
di
di
di
di
di
di
di
di
di
di
di
di
di
di
di
di
di
di
di
di
di
di
di
di
di
di
di
di
di
di
di
di
di
eo
eo
eo
di
di
di
"}
(7,1,1) = {"
di
di
di
di
di
di
di
di
di
di
di
di
di
di
di
di
di
iE
di
di
di
di
di
di
di
di
di
di
di
di
di
di
di
di
di
di
di
di
di
di
di
di
di
di
di
di
di
di
di
di
di
di
di
di
di
di
FF
di
di
di
di
di
di
di
di
di
di
di
di
di
di
di
di
di
eo
eo
eo
di
di
di
"}
(8,1,1) = {"
di
di
FF
FF
di
di
di
di
di
di
di
di
di
di
di
di
di
di
di
di
di
FF
di
di
di
di
di
di
di
di
di
di
di
di
di
di
di
di
di
di
di
di
di
di
di
di
di
di
di
di
di
di
di
di
di
di
di
di
di
di
di
di
di
FF
di
di
di
Ga
di
VO
di
VO
di
di
eo
eo
eo
di
di
di
"}
(9,1,1) = {"
di
di
di
di
di
di
di
FF
di
di
di
di
di
di
di
di
di
di
di
di
di
di
di
di
di
di
di
di
di
di
di
di
di
di
di
di
di
di
di
di
di
di
di
di
di
di
di
di
di
di
di
FF
di
di
di
di
di
di
di
di
di
di
di
di
di
di
di
di
di
VO
di
VO
di
di
di
oe
di
di
di
di
"}
(10,1,1) = {"
di
di
di
di
di
di
di
di
di
di
di
di
di
FF
di
di
di
di
di
di
di
di
di
di
di
di
di
di
di
di
di
di
di
di
di
di
di
di
di
di
di
di
di
di
di
di
di
di
di
di
di
di
di
di
di
di
di
di
di
di
di
di
di
di
di
di
di
di
di
di
di
di
di
di
di
LL
di
di
di
di
"}
(11,1,1) = {"
di
di
di
di
di
di
di
di
di
di
di
di
di
di
di
di
di
di
di
di
di
di
iE
di
di
di
di
di
di
di
di
di
Eh
Eh
di
di
di
di
di
di
di
di
di
di
di
di
di
di
di
di
di
di
di
di
di
di
di
di
di
di
di
di
di
di
di
di
di
di
di
di
FF
di
di
di
di
di
di
di
di
di
"}
(12,1,1) = {"
di
di
FF
di
di
di
di
di
di
di
di
di
di
di
di
di
di
di
di
di
di
di
di
di
di
di
di
di
di
FF
di
di
di
Eh
Eh
Eh
di
di
di
iE
iE
di
di
FF
di
di
di
di
di
di
di
di
di
di
di
Eh
di
di
FF
di
di
di
di
di
di
di
di
di
di
di
di
di
di
di
di
di
FF
di
di
di
"}
(13,1,1) = {"
di
di
di
di
Eh
di
FF
di
di
di
di
di
di
di
di
di
di
di
di
di
di
di
di
di
di
di
di
di
di
di
di
di
di
di
Eh
Eh
di
di
FF
di
di
di
di
di
di
di
di
di
di
di
di
di
di
di
Eh
Eh
di
di
di
di
di
di
di
di
di
di
di
di
di
di
di
di
di
di
di
di
di
di
di
di
"}
(14,1,1) = {"
di
di
di
di
Eh
di
di
di
di
di
FF
di
di
di
di
di
di
di
di
FF
di
di
di
di
di
di
di
di
di
di
di
di
di
di
di
di
di
di
FF
di
di
di
di
di
di
di
di
di
di
di
di
FF
di
di
Eh
Eh
di
di
di
di
di
di
di
di
di
di
di
di
di
di
di
di
di
di
di
di
di
di
di
di
"}
(15,1,1) = {"
di
di
di
di
Eh
di
di
di
di
di
di
di
di
di
di
di
di
di
di
di
di
di
di
di
Eh
di
di
di
di
di
di
di
di
di
di
di
di
di
di
di
di
di
di
di
di
di
di
di
di
di
di
di
di
di
di
Eh
Eh
di
di
di
di
di
di
di
di
di
di
di
di
di
di
di
di
di
di
di
di
di
di
di
"}
(16,1,1) = {"
di
di
di
di
Eh
di
di
di
di
di
di
di
di
di
di
di
di
di
di
di
di
di
di
di
Eh
Eh
di
di
di
di
di
di
di
di
di
di
di
di
di
di
di
di
di
di
di
di
di
di
di
di
iE
di
di
di
di
di
di
di
di
di
di
di
di
di
FF
di
di
di
di
di
di
di
di
di
di
di
di
di
di
di
"}
(17,1,1) = {"
di
di
FF
di
di
di
di
di
di
di
di
di
di
di
di
di
di
di
di
di
di
di
di
di
Eh
QE
di
di
di
di
di
di
di
di
di
di
di
di
di
di
di
di
di
di
di
di
di
di
di
di
di
di
di
di
di
di
di
di
di
di
di
di
di
di
di
di
di
Eh
di
di
di
di
di
di
di
di
di
di
di
di
"}
(18,1,1) = {"
di
di
di
di
di
di
di
di
di
FF
di
di
di
di
di
FF
di
di
di
di
di
di
di
di
di
Eh
Eh
di
di
di
di
FF
di
di
di
di
di
di
di
di
di
di
di
di
di
FF
di
di
di
di
di
di
di
di
di
di
di
di
di
di
di
di
di
di
di
di
di
di
di
di
di
di
di
FF
di
di
di
di
di
di
"}
(19,1,1) = {"
di
di
di
di
di
di
di
di
di
di
di
di
di
di
di
di
di
di
di
di
di
di
di
di
di
di
Eh
di
di
di
di
di
di
di
di
di
di
di
di
di
di
di
di
di
di
di
di
di
di
di
di
di
di
di
di
di
di
di
di
di
di
di
di
di
di
di
di
di
di
di
di
di
di
FF
di
di
FF
di
di
di
"}
(20,1,1) = {"
di
di
di
di
di
di
FF
di
di
di
di
di
di
di
di
di
di
di
di
di
di
di
FF
di
di
di
di
di
di
di
di
di
di
di
di
di
di
di
di
di
di
di
di
di
di
di
di
di
di
di
di
di
di
di
di
di
FF
di
di
di
di
di
di
di
di
di
di
di
di
di
di
di
di
di
di
di
di
di
di
di
"}
(21,1,1) = {"
di
di
di
di
di
di
di
di
di
di
di
di
di
di
di
di
di
di
di
di
di
di
di
di
di
di
di
iE
di
di
di
di
di
di
di
di
di
di
di
di
di
di
di
di
di
di
di
di
di
FF
di
di
di
di
di
di
di
di
di
di
di
di
di
di
di
di
di
FF
di
di
di
di
di
di
di
di
di
di
di
di
"}
(22,1,1) = {"
di
di
di
di
di
di
di
di
di
di
FF
di
di
di
di
di
di
di
di
di
di
di
di
di
di
di
di
di
di
di
di
di
di
di
di
di
di
FF
di
di
di
di
di
di
di
di
di
di
di
di
di
di
di
di
di
di
di
di
di
di
di
di
di
di
di
di
di
di
di
di
di
di
di
di
di
di
di
di
di
di
"}
(23,1,1) = {"
di
di
di
di
di
di
di
di
di
di
di
di
di
di
di
di
di
di
di
di
di
di
di
di
iE
di
di
di
di
di
di
di
di
di
di
di
di
di
di
di
di
di
di
di
di
di
di
di
di
di
di
di
di
di
di
di
di
di
di
di
di
di
di
di
di
di
di
di
di
di
di
di
FF
di
di
di
di
di
di
di
"}
(24,1,1) = {"
di
di
di
di
di
di
di
di
di
di
di
di
di
di
di
di
di
di
di
di
di
di
di
di
di
di
di
di
di
di
di
di
di
FF
di
di
di
di
di
di
di
di
di
di
di
FF
di
di
di
di
di
di
di
di
di
di
di
di
di
di
di
di
FF
di
di
di
di
di
di
di
di
di
di
di
di
di
di
di
di
di
"}
(25,1,1) = {"
jR
jR
jR
di
di
di
di
di
di
di
di
di
di
di
di
FF
di
di
di
di
di
di
di
di
di
di
FF
di
di
di
di
di
di
di
di
di
di
di
di
di
di
di
di
di
di
di
di
di
di
di
di
di
di
FF
di
di
di
di
di
di
di
di
di
di
di
di
di
di
di
di
di
di
di
di
di
di
FF
di
di
di
"}
(26,1,1) = {"
jR
jR
jR
jR
jR
jR
di
di
di
di
di
di
di
di
di
di
di
di
di
di
di
di
di
di
di
di
di
di
di
di
di
di
di
di
di
di
di
di
di
di
di
di
di
di
di
di
di
di
di
di
di
di
di
di
di
di
di
di
FF
di
di
di
di
di
di
di
di
di
di
di
FF
di
di
di
di
di
di
di
di
di
"}
(27,1,1) = {"
gS
gS
jR
jR
jR
jR
jR
jR
di
di
di
di
di
di
di
di
di
di
di
di
di
di
di
di
di
di
di
di
di
di
di
di
di
di
di
di
di
di
di
di
di
di
di
di
di
di
di
di
di
di
di
di
di
di
di
di
di
di
di
di
di
di
di
di
di
di
di
di
di
di
di
di
di
di
di
di
di
di
di
di
"}
(28,1,1) = {"
gS
gS
gS
gS
jR
jR
jR
jR
jR
jR
di
di
di
di
di
di
di
di
di
di
FF
di
di
di
di
di
di
di
di
di
di
di
di
di
di
di
di
di
di
di
di
di
di
di
di
di
di
di
di
di
di
di
di
di
FF
di
di
di
di
di
di
di
di
di
FF
di
di
di
di
di
di
di
di
di
di
di
di
di
di
di
"}
(29,1,1) = {"
gS
gS
gS
gS
gS
gS
jR
jR
jR
jR
jR
jR
jR
jR
di
di
di
di
di
di
di
di
di
di
di
di
di
di
di
di
di
di
di
di
di
di
di
di
di
di
di
di
di
di
di
di
di
di
di
di
di
di
di
di
di
di
di
di
di
di
di
di
di
di
di
di
di
di
di
di
di
di
FF
di
di
di
di
di
di
di
"}
(30,1,1) = {"
gS
gS
gS
gS
gS
gS
gS
gS
gS
jR
jR
jR
Uw
Uw
Uw
Uw
di
di
di
di
di
di
di
di
di
di
di
di
di
di
di
di
di
di
di
di
di
di
FF
di
di
di
di
di
di
di
di
di
di
di
di
di
di
di
di
di
di
di
di
di
di
di
di
di
di
di
di
di
di
di
di
di
di
di
di
di
di
di
di
di
"}
(31,1,1) = {"
gS
gS
gS
gS
gS
gS
gS
gS
gS
gS
gS
gS
gS
gS
Uw
Uw
Uw
Uw
Uw
di
di
di
di
di
di
di
di
di
di
di
di
FF
di
di
di
di
di
di
di
di
di
di
di
di
di
FF
di
di
di
di
iE
di
di
di
di
di
di
di
di
di
FF
di
di
di
di
di
di
di
di
di
di
di
Eh
Eh
Eh
di
di
di
di
di
"}
(32,1,1) = {"
gS
gS
gS
gS
gS
gS
gS
gS
gS
gS
gS
gS
gS
gS
gS
gS
gS
Uw
Uw
Uw
Uw
di
di
di
di
di
di
di
di
di
di
di
di
di
di
di
di
di
di
di
di
di
di
di
di
di
di
di
di
di
di
di
di
di
di
di
di
di
di
di
di
di
di
di
di
di
di
di
di
di
di
di
Eh
di
di
di
di
di
di
di
"}
(33,1,1) = {"
Uw
Uw
gS
gS
gS
gS
gS
gS
gS
gS
gS
gS
gS
gS
gS
gS
gS
gS
gS
gS
Uw
Uw
Uw
di
di
di
di
di
di
di
di
di
di
di
di
di
di
di
di
di
di
di
di
di
di
di
di
di
Eh
di
di
di
di
di
di
di
di
di
di
di
di
di
di
di
di
di
di
di
di
di
di
Eh
di
di
di
di
di
di
di
di
"}
(34,1,1) = {"
di
Uw
Uw
Uw
Uw
gS
gS
gS
gS
gS
gS
gS
gS
gS
gS
gS
gS
gS
gS
gS
gS
gS
Uw
Uw
Uw
di
di
di
di
di
di
di
di
di
di
di
di
di
di
di
di
di
di
di
di
di
di
di
Eh
di
di
di
di
di
di
di
di
di
di
FF
di
di
di
di
di
di
di
di
FF
di
di
di
di
di
di
di
di
di
di
di
"}
(35,1,1) = {"
di
di
di
Uw
Uw
Uw
Uw
Uw
gS
gS
gS
gS
gS
gS
gS
gS
gS
gS
gS
gS
gS
gS
gS
Uw
Uw
Uw
Uw
di
di
di
di
di
di
di
di
di
di
di
di
di
di
di
di
di
di
di
di
di
di
di
di
di
di
di
di
di
di
di
di
di
di
di
FF
di
di
di
di
di
di
di
di
di
di
di
di
FF
di
di
di
di
"}
(36,1,1) = {"
di
di
di
di
di
di
Uw
Uw
Uw
Uw
gS
gS
gS
gS
gS
gS
gS
gS
gS
gS
gS
gS
gS
gS
gS
gS
Uw
Uw
Uw
Uw
di
di
di
di
di
di
di
di
di
di
di
di
di
di
di
di
di
di
di
di
di
di
di
di
di
di
di
di
di
di
di
di
di
di
di
di
di
di
di
di
di
di
di
di
di
di
di
di
di
di
"}
(37,1,1) = {"
di
di
di
di
di
di
di
di
Uw
Uw
Uw
gS
gS
gS
gS
gS
gS
gS
gS
gS
gS
gS
gS
gS
gS
gS
gS
gS
gS
Uw
Uw
di
di
di
di
di
di
FF
di
di
di
di
di
di
di
FF
di
di
di
di
di
di
di
FF
di
di
di
di
di
di
di
di
di
di
di
di
di
di
di
di
di
di
di
di
di
di
di
di
di
di
"}
(38,1,1) = {"
di
di
di
di
di
di
di
di
di
di
Uw
Uw
Uw
jR
jR
jR
gS
gS
gS
gS
gS
gS
gS
gS
gS
gS
gS
gS
gS
gS
Uw
Uw
di
di
di
di
di
di
di
di
di
di
di
di
di
di
di
di
di
di
di
di
di
di
di
di
di
di
di
di
di
di
di
di
di
di
di
di
di
di
di
di
di
di
di
di
di
di
di
di
"}
(39,1,1) = {"
di
di
di
di
di
di
di
di
di
di
di
di
Uw
Uw
jR
jR
jR
jR
jR
jR
jR
gS
gS
gS
gS
gS
gS
gS
gS
gS
gS
Uw
Uw
di
di
di
di
di
di
di
di
di
di
di
di
di
di
di
di
di
di
di
di
di
di
di
di
di
di
di
di
di
di
di
di
di
di
FF
di
di
di
di
FF
di
di
di
di
di
di
di
"}
(40,1,1) = {"
di
di
di
di
di
di
di
di
di
di
di
di
di
di
di
di
di
jR
jR
jR
jR
jR
jR
jR
gS
gS
gS
gS
gS
gS
gS
gS
Uw
Jh
Eq
Eq
sx
Jh
di
di
di
di
di
di
di
di
di
di
di
di
di
di
di
di
di
di
di
FF
di
di
di
di
di
di
di
di
di
di
di
di
di
di
di
di
di
di
di
di
di
di
"}
(41,1,1) = {"
di
di
di
di
di
di
di
di
di
di
di
di
di
di
di
di
di
di
di
jR
jR
jR
jR
jR
jR
gS
gS
gS
gS
gS
gS
gS
gS
Ze
jR
Eq
kp
KH
di
di
di
di
di
di
di
di
di
di
di
di
di
di
di
di
di
di
di
di
di
di
di
di
di
di
di
di
di
di
di
di
di
di
di
di
di
di
di
di
di
di
"}
(42,1,1) = {"
di
di
di
di
di
di
di
di
di
di
di
di
di
di
di
di
di
di
di
di
di
di
jR
jR
jR
gS
gS
gS
gS
gS
gS
gS
gS
Ze
Hb
iO
iO
KH
Uw
Uw
di
di
di
di
di
di
di
di
di
di
di
di
di
di
di
di
di
di
di
di
di
di
di
FF
di
di
di
di
di
di
di
di
di
di
di
di
iE
di
di
di
"}
(43,1,1) = {"
di
di
di
di
di
di
di
di
di
di
di
di
di
di
di
di
di
di
di
di
di
di
di
di
Uw
Uw
Uw
gS
gS
gS
gS
gS
gS
Jh
gS
gS
Hb
Jh
Uw
Uw
Uw
Uw
di
di
di
di
di
di
di
di
di
di
di
di
di
di
di
di
di
di
di
di
di
di
di
di
di
di
di
di
di
di
di
FF
di
di
di
di
di
di
"}
(44,1,1) = {"
di
di
di
di
Eh
Eh
di
di
di
di
di
di
di
di
di
di
di
di
di
di
di
di
di
di
di
di
Uw
Uw
Uw
Uw
gS
gS
gS
Ze
gS
gS
gS
kU
gS
gS
gS
Uw
Uw
di
di
di
di
di
di
di
FF
di
di
di
di
di
di
di
di
di
di
di
di
di
di
di
di
di
di
di
di
di
di
FF
di
di
di
di
di
di
"}
(45,1,1) = {"
di
di
Eh
Eh
Eh
di
di
di
di
di
di
di
di
di
di
di
di
di
di
di
di
di
di
di
di
di
di
di
di
di
Uw
Uw
gS
Jh
gS
gS
gS
Jh
gS
gS
gS
gS
Uw
Uw
di
di
di
di
di
di
di
di
di
di
di
di
di
di
di
di
di
di
di
di
di
di
FF
di
di
di
di
di
di
di
di
di
di
di
di
di
"}
(46,1,1) = {"
di
Eh
Eh
Eh
Eh
di
di
di
di
di
di
di
di
di
di
di
di
di
di
di
di
di
di
di
di
di
di
di
di
di
di
Uw
Uw
kg
TU
iO
gS
kU
gS
gS
gS
gS
gS
Uw
Uw
di
di
di
di
di
di
di
di
di
di
di
di
di
FF
di
di
di
di
di
di
di
di
di
di
di
di
di
di
di
di
di
di
di
di
di
"}
(47,1,1) = {"
di
di
di
di
di
di
di
di
di
di
di
di
di
di
di
di
di
di
di
di
di
di
di
di
di
di
di
di
di
di
di
di
di
kg
TU
kp
Hb
kU
gS
gS
gS
gS
gS
gS
Uw
jR
di
di
di
di
di
di
di
di
di
di
di
di
di
di
di
di
di
Eh
Eh
di
di
di
di
di
di
di
di
di
di
di
di
FF
di
di
"}
(48,1,1) = {"
di
di
di
di
di
di
di
di
di
di
di
di
di
di
di
di
di
di
di
di
di
di
di
di
di
di
di
di
di
di
di
di
di
Jh
Vz
Vz
Uw
Jh
Uw
gS
gS
gS
gS
gS
gS
jR
jR
di
di
di
di
di
di
di
di
di
di
di
di
di
di
di
di
Eh
Eh
di
di
di
di
di
di
di
di
di
iE
di
di
di
di
di
"}
(49,1,1) = {"
di
di
di
di
di
di
di
di
di
di
di
di
di
di
di
di
di
di
di
di
di
di
di
di
di
di
di
di
di
di
di
di
di
di
di
di
di
di
Uw
Uw
gS
gS
gS
gS
gS
gS
jR
jR
di
di
di
di
di
di
di
di
di
di
di
di
di
FF
di
Eh
Eh
di
di
di
di
di
di
di
di
di
di
di
di
di
di
di
"}
(50,1,1) = {"
di
di
di
di
di
di
di
di
di
di
di
di
di
di
di
di
di
di
di
di
di
di
di
di
di
di
di
di
di
di
di
di
di
di
di
di
di
di
di
Uw
Uw
gS
gS
gS
gS
gS
jR
jR
jR
di
di
di
di
di
di
di
di
di
di
di
di
di
di
iE
di
di
di
di
FF
di
di
di
FF
di
di
di
di
di
di
di
"}
(51,1,1) = {"
di
di
di
di
di
di
di
di
di
di
di
di
di
di
di
di
di
di
di
di
di
di
di
di
di
di
di
di
di
di
di
di
di
di
di
di
di
di
di
di
di
jR
gS
gS
gS
gS
gS
jR
jR
jR
di
di
di
di
di
di
iE
di
di
di
di
di
di
iE
di
di
di
di
di
di
di
di
di
di
di
di
di
di
di
di
"}
(52,1,1) = {"
di
di
di
di
di
di
di
di
di
di
di
di
di
di
di
di
di
di
di
di
di
di
di
di
di
di
di
di
di
di
di
di
di
di
di
di
di
di
di
di
di
jR
jR
jR
gS
gS
gS
gS
gS
jR
jR
di
di
di
di
di
di
di
di
di
di
di
di
di
di
di
di
di
di
di
di
di
di
di
di
di
di
di
di
di
"}
(53,1,1) = {"
di
di
di
di
di
di
di
di
di
di
di
di
di
di
di
di
di
di
di
Eh
Eh
Eh
Eh
di
di
di
di
di
di
di
di
di
di
di
di
di
di
di
di
di
di
di
di
jR
jR
gS
gS
gS
gS
gS
jR
jR
jR
di
di
di
di
di
di
di
di
di
di
di
di
di
FF
di
di
di
di
di
di
di
FF
di
di
FF
di
di
"}
(54,1,1) = {"
di
di
di
di
di
di
di
di
di
di
di
We
We
We
We
We
We
We
We
We
We
We
We
We
We
We
We
di
di
di
di
di
di
di
di
di
di
di
di
di
di
di
di
di
jR
jR
gS
gS
gS
gS
gS
jR
jR
jR
di
di
di
di
di
di
di
FF
di
di
di
di
di
di
di
di
di
di
di
di
di
di
di
di
di
di
"}
(55,1,1) = {"
di
di
di
di
di
di
di
di
di
di
We
Yu
EZ
eI
rG
eI
rG
de
We
PQ
PQ
We
Gq
PQ
WT
JW
Yu
We
di
di
di
di
di
di
di
di
di
di
di
di
di
di
di
di
di
jR
jR
gS
gS
gS
gS
gS
jR
jR
jR
di
di
di
di
di
di
di
di
di
di
di
di
di
di
di
di
di
di
di
di
di
di
di
di
di
"}
(56,1,1) = {"
di
di
di
di
di
di
di
di
di
We
We
EZ
de
eI
eI
eI
eI
de
Ge
PQ
PQ
RQ
PQ
PQ
PQ
PQ
yw
We
We
Eh
di
di
di
di
di
di
di
di
di
di
di
di
di
di
di
di
jR
jR
gS
gS
gS
gS
gS
gS
jR
jR
di
di
di
di
di
di
di
di
di
di
di
di
di
di
di
di
di
di
di
di
di
di
di
di
"}
(57,1,1) = {"
di
di
di
di
di
di
di
di
We
Yu
EZ
de
de
eI
eI
rG
eI
de
We
PQ
PQ
We
Kj
Gf
nO
PQ
PQ
QR
Yu
We
Eh
di
di
di
di
di
di
di
di
di
di
di
di
di
di
di
di
jR
jR
gS
gS
gS
gS
gS
gS
jR
jR
di
di
di
di
di
di
di
di
di
di
di
di
di
di
FF
di
di
di
di
di
di
di
di
"}
(58,1,1) = {"
di
di
di
di
di
di
di
We
We
We
We
Yu
We
We
We
We
We
We
Yu
RQ
RQ
Yu
We
We
We
We
Yu
We
We
We
We
di
di
di
di
di
di
di
di
di
di
di
di
di
di
di
di
di
jR
jR
jR
Uw
gS
gS
gS
gS
jR
jR
jR
di
di
di
di
di
di
di
di
di
di
di
di
di
di
di
di
di
di
FF
di
di
"}
(59,1,1) = {"
di
di
di
di
di
di
di
jY
PQ
PQ
PQ
PQ
PQ
PQ
PQ
PQ
PQ
PQ
PQ
PQ
PQ
PQ
PQ
PQ
PQ
PQ
PQ
PQ
PQ
PQ
jY
di
di
di
di
di
di
di
di
di
di
di
di
di
di
di
di
di
di
di
jR
jR
Uw
gS
gS
gS
gS
gS
Uw
Uw
Uw
di
di
di
di
di
di
FF
di
di
di
di
di
di
di
di
di
di
di
di
"}
(60,1,1) = {"
di
di
di
di
di
di
di
jY
PQ
PQ
PQ
PQ
PQ
PQ
Pc
Pc
Pc
Pc
Pc
Pc
Pc
Pc
Pc
Pc
PQ
PQ
PQ
PQ
PQ
PQ
jY
di
di
di
di
di
di
di
di
di
di
di
di
di
di
di
di
di
di
di
di
jR
jR
gS
gS
gS
gS
gS
gS
gS
Uw
Uw
di
di
di
di
di
di
di
di
di
di
di
FF
di
di
di
di
di
FF
"}
(61,1,1) = {"
di
di
di
di
di
di
di
We
We
PQ
PQ
PQ
PQ
PQ
RJ
WP
WP
rZ
NI
RJ
cB
so
NI
RM
PQ
PQ
PQ
PQ
PQ
We
We
di
di
di
di
di
di
di
di
di
di
di
di
di
di
di
di
di
di
di
di
di
jR
jR
Uw
gS
gS
gS
gS
gS
gS
gS
jR
di
di
di
di
di
di
FF
di
di
di
di
di
di
di
di
di
di
"}
(62,1,1) = {"
di
di
di
di
di
di
di
di
We
We
PQ
PQ
PQ
PQ
NI
RJ
RM
RJ
vw
RM
Mn
WP
vw
RJ
PQ
PQ
PQ
PQ
We
We
di
di
di
di
di
di
di
di
di
di
di
di
di
di
di
di
di
di
di
di
di
di
di
jR
jR
gS
gS
gS
gS
gS
gS
gS
jR
jR
di
di
di
di
di
di
di
di
di
di
di
di
di
di
di
di
"}
(63,1,1) = {"
di
di
di
di
di
di
di
di
di
We
We
PQ
PQ
PQ
zF
zF
zF
zF
zF
zF
zF
zF
zF
zF
PQ
PQ
PQ
We
We
di
di
di
di
di
di
di
di
di
di
di
di
di
di
di
di
di
di
di
di
di
di
di
di
di
jR
jR
gS
gS
gS
gS
gS
gS
gS
jR
jR
di
di
di
di
di
di
di
di
di
di
di
di
di
di
di
"}
(64,1,1) = {"
di
di
di
di
di
di
di
di
di
di
We
Yu
PQ
PQ
PQ
PQ
PQ
PQ
PQ
PQ
PQ
PQ
PQ
PQ
PQ
PQ
Yu
We
di
di
di
di
di
di
di
di
di
di
di
di
di
di
di
di
di
di
di
di
di
di
di
di
di
di
di
jR
Uw
gS
gS
gS
gS
gS
gS
gS
jR
di
di
di
di
di
di
di
di
di
FF
di
di
FF
di
di
"}
(65,1,1) = {"
di
di
di
di
di
di
di
di
di
di
di
We
We
We
We
We
We
We
Yu
We
We
Yu
We
We
We
We
We
di
di
di
di
di
di
di
di
di
di
di
di
di
di
di
di
di
di
di
di
di
di
di
di
di
di
di
di
jR
jR
jR
gS
gS
gS
gS
gS
gS
jR
jR
di
di
di
di
di
di
di
di
di
di
di
di
di
di
"}
(66,1,1) = {"
di
di
di
di
di
di
di
di
di
di
di
di
Eh
Eh
Eh
di
di
di
di
di
di
di
di
di
di
di
di
di
di
di
di
di
di
di
di
di
di
di
di
di
di
di
di
di
di
di
di
di
di
di
di
di
di
di
di
di
di
jR
gS
gS
gS
gS
gS
gS
jR
jR
di
di
di
FF
di
di
di
di
di
di
di
di
di
di
"}
(67,1,1) = {"
di
di
di
di
di
di
di
di
di
di
di
di
di
di
di
di
di
di
di
di
di
di
di
di
di
di
di
di
di
di
di
Eh
Eh
Eh
di
di
di
di
di
di
di
di
di
di
di
di
di
di
di
di
di
di
di
di
di
di
di
jR
jR
gS
gS
gS
gS
gS
gS
jR
jR
di
di
di
di
di
di
di
di
di
di
di
di
di
"}
(68,1,1) = {"
di
di
di
di
di
di
di
di
di
di
di
di
di
di
di
di
di
di
di
di
di
di
di
di
di
di
di
di
di
di
di
di
Eh
Eh
di
di
di
di
di
di
di
di
di
di
di
di
di
di
di
di
di
di
di
di
di
di
di
di
jR
jR
gS
gS
gS
gS
gS
gS
jR
jR
di
di
di
FF
di
di
di
di
di
FF
di
di
"}
(69,1,1) = {"
di
di
di
di
di
di
di
di
di
di
di
di
di
di
di
di
di
di
di
di
di
di
di
di
di
di
di
di
di
di
di
di
di
Eh
di
di
di
di
di
di
di
di
di
di
di
di
di
di
di
di
di
di
di
di
di
di
di
di
di
jR
Uw
gS
gS
gS
gS
gS
jR
jR
di
di
di
di
di
di
di
di
di
di
di
di
"}
(70,1,1) = {"
di
di
di
di
di
di
di
di
di
di
di
di
di
di
di
di
di
di
di
di
di
di
di
di
di
di
di
di
di
di
di
di
di
di
di
di
di
di
di
di
di
di
di
di
di
di
di
di
di
di
di
di
di
di
di
di
di
di
di
jR
Uw
Uw
gS
gS
gS
gS
jR
jR
jR
di
di
di
di
di
FF
di
di
di
di
di
"}
(71,1,1) = {"
di
di
di
di
di
di
di
di
di
di
di
di
di
di
di
di
di
di
di
di
di
di
di
di
di
di
di
di
di
di
di
di
di
di
di
di
di
di
di
di
di
di
di
di
di
di
di
di
di
di
di
di
di
di
di
di
di
di
di
di
di
Uw
gS
gS
gS
gS
gS
jR
jR
di
di
di
di
di
di
di
di
di
di
di
"}
(72,1,1) = {"
di
di
di
di
di
di
di
di
di
di
di
di
di
di
di
di
di
di
di
di
di
di
di
di
di
di
di
di
di
di
di
di
di
di
di
di
di
di
di
di
di
di
di
di
di
di
di
di
di
di
di
di
di
di
di
di
di
di
di
di
di
Uw
gS
gS
gS
gS
gS
jR
jR
di
di
di
di
di
di
di
di
di
di
di
"}
(73,1,1) = {"
di
di
di
di
di
di
di
di
di
di
di
di
di
di
di
di
di
di
di
di
di
di
di
di
di
di
di
di
di
di
di
di
di
di
di
di
di
di
di
di
di
di
di
di
di
di
di
di
di
di
di
di
di
di
di
di
di
di
di
di
di
di
Uw
gS
gS
gS
gS
jR
jR
di
di
di
di
di
di
di
di
di
FF
di
"}
(74,1,1) = {"
di
di
di
di
di
di
di
di
di
di
di
di
di
di
di
di
di
di
di
di
di
di
di
di
di
di
di
di
di
di
di
di
di
di
di
di
di
di
di
di
di
di
di
di
di
di
di
di
di
di
di
di
Eh
Eh
Eh
di
di
di
di
di
di
di
Uw
gS
gS
gS
gS
gS
jR
jR
di
di
di
di
FF
di
di
di
di
di
"}
(75,1,1) = {"
di
di
di
di
di
di
di
di
di
di
di
di
di
di
di
di
di
di
di
di
di
di
di
di
di
di
di
di
di
di
di
di
di
di
di
di
di
di
di
di
di
di
di
di
di
di
di
di
di
di
di
di
Eh
Eh
Eh
Eh
di
di
di
di
di
di
di
Uw
gS
gS
gS
gS
Uw
jR
di
di
di
di
di
di
di
di
di
di
"}
(76,1,1) = {"
di
di
di
di
di
di
di
di
di
di
di
di
di
di
di
di
di
di
di
di
di
di
di
di
di
di
di
di
di
di
di
di
di
di
di
di
di
di
di
di
di
di
di
di
di
di
di
di
di
di
di
di
Eh
Eh
Eh
Eh
di
di
di
di
di
di
di
Uw
gS
gS
gS
gS
gS
Uw
di
di
di
di
di
di
di
di
di
di
"}
(77,1,1) = {"
di
di
di
di
di
di
di
di
di
di
di
di
di
di
di
di
di
di
di
di
di
di
di
di
di
di
di
di
di
di
di
di
di
di
di
di
di
di
di
di
di
di
di
di
di
di
di
di
di
di
di
di
di
di
di
Eh
Eh
di
di
di
di
di
di
Uw
gS
gS
gS
gS
gS
Uw
di
di
di
di
di
di
di
di
di
di
"}
(78,1,1) = {"
di
di
di
di
di
di
di
di
di
di
di
di
di
di
di
di
di
di
di
di
di
di
di
di
di
di
di
di
di
di
di
di
di
di
di
di
di
di
di
di
di
di
di
di
di
di
di
di
di
di
di
di
di
di
di
di
di
di
di
di
di
di
di
di
Uw
gS
gS
gS
gS
Uw
di
di
di
FF
di
di
FF
di
di
di
"}
(79,1,1) = {"
di
di
di
di
di
di
di
di
di
di
di
di
di
di
di
di
di
di
di
di
di
di
di
di
di
di
di
di
di
di
di
di
di
di
di
di
di
di
di
di
di
di
di
di
di
di
di
di
di
di
di
di
di
di
di
di
di
di
di
di
di
di
di
di
Uw
Uw
gS
gS
gS
Uw
Uw
di
di
di
di
di
di
di
di
di
"}
(80,1,1) = {"
di
di
di
di
di
di
di
di
di
di
di
di
di
di
di
di
di
di
di
di
di
di
di
di
di
di
di
di
di
di
di
di
di
di
di
di
di
di
di
di
di
di
di
di
di
di
di
di
di
di
di
di
di
di
di
di
di
di
di
di
di
di
di
di
di
Uw
Uw
gS
gS
Uw
Uw
di
di
di
di
di
di
di
di
di
"}
