"aA" = (/obj/structure/machinery/sub_physical/coolant_pump{pump_id = 1; is_primary = TRUE}, /turf/floor/sub_deck, /area/submarine)
"aB" = (/obj/structure/machinery/sub_physical/coolant_pump{pump_id = 2; is_primary = FALSE}, /turf/floor/sub_deck, /area/submarine)
"aC" = (/obj/structure/machinery/sub_physical/steam_turbine, /turf/floor/sub_deck, /area/submarine)
"aD" = (/obj/structure/machinery/sub_physical/diesel_engine, /turf/floor/sub_deck, /area/submarine)
"aE" = (/obj/structure/sub_physical/equipment_storage, /turf/floor/sub_deck, /area/submarine)
"aa" = (/turf/floor/beach/water/deep/saltwater/underwater, /area/submarine/extern)
"ab" = (/turf/wall/sub_hull, /area/submarine)
"ac" = (/turf/wall/sub_bulkhead, /area/submarine)
"ad" = (/turf/floor/sub_deck, /area/submarine)
"ae" = (/obj/map_metadata/subcom13, /turf/wall/sub_hull, /area/submarine)
"af" = (/obj/effect/landmark{name = "JoinLateSub"}, /turf/floor/sub_deck, /area/submarine)
"ag" = (/obj/structure/machinery/sub_control/maneuver_panel, /turf/floor/sub_deck, /area/submarine)
"ah" = (/obj/structure/machinery/sub_control/sonar_panel, /turf/floor/sub_deck, /area/submarine)
"ai" = (/obj/structure/machinery/sub_control/radar_panel, /turf/floor/sub_deck, /area/submarine)
"aj" = (/obj/structure/machinery/sub_control/weapons_panel, /turf/floor/sub_deck, /area/submarine)
"ak" = (/obj/structure/machinery/sub_control/radio_console, /turf/floor/sub_deck, /area/submarine)
"al" = (/obj/structure/machinery/sub_control/misc_systems, /turf/floor/sub_deck, /area/submarine)
"am" = (/obj/structure/machinery/sub_control/compartment_panel, /turf/floor/sub_deck, /area/submarine)
"an" = (/obj/structure/machinery/sub_physical/torpedo_tube{tube_id = 1}, /turf/floor/sub_deck, /area/submarine)
"ao" = (/obj/structure/machinery/sub_physical/torpedo_tube{tube_id = 2}, /turf/floor/sub_deck, /area/submarine)
"ap" = (/obj/structure/machinery/sub_physical/torpedo_tube{tube_id = 3}, /turf/floor/sub_deck, /area/submarine)
"aq" = (/obj/structure/machinery/sub_physical/torpedo_tube{tube_id = 4}, /turf/floor/sub_deck, /area/submarine)
"ar" = (/obj/structure/machinery/sub_physical/bilge_pump, /turf/floor/sub_deck, /area/submarine)
"as" = (/obj/structure/machinery/sub_physical/vent_duct, /turf/floor/sub_deck, /area/submarine)
"at" = (/obj/structure/bed/bunk, /turf/floor/sub_deck, /area/submarine)
"au" = (/obj/structure/machinery/sub_physical/galley, /turf/floor/sub_deck, /area/submarine)
"av" = (/obj/structure/machinery/sub_physical/scrubber, /turf/floor/sub_deck, /area/submarine)
"aw" = (/obj/structure/machinery/sub_physical/fuel_storage, /turf/floor/sub_deck, /area/submarine)
"ax" = (/obj/structure/machinery/sub_physical/ballast_valve, /turf/floor/sub_deck, /area/submarine)
"ay" = (/obj/structure/machinery/sub_physical/reactor_core{id = 1}, /turf/floor/sub_deck, /area/submarine)
"az" = (/obj/structure/machinery/sub_physical/reactor_core{id = 2}, /turf/floor/sub_deck, /area/submarine)

(1,1,1) = {"
abababababababababababababababababababababababababababababababababababababababababababababababababababababababababab
abababababababababababababababababababababababababababababababababababababababababababababababababababababababababab
ababadadadadadadacadadadadadadacadadadamadadadacadadadasadadacadadadadacadadadadadadacadadadadadadadacasadadadadadad
ababadadadadadadacadadadadadadacadadadaladadadacadadadadadadacadadadadacadadadadadatacadadadadadadadacadadadadadadas
ababadadadaqadadacadadadadadadacadajadadadakadacadadadadadadacadadadadacadatadadadadacadadadadadadavacadadadadadadad
ababadaoadadadadacadadaradadadacadadadadadadadacadadadadadadacadadadadacadadadadadadacadadadawadadadacadaBadadadadad
ababadadadadadadacadadadadadadacadadadagadadadacadadafauadadacadadadadacadadadatadadacadadadadadadadacadadadadadadaD
ababadadadapadadacadadadasadadacadahadadadaiadacadadadadadadacadadadadacadadatadadadacadadadadadadadacadadadadaAaCad
ababadanadadadadacadadadadaxadacadadadadadadadacadadadadadadacadadadadacadadadadadadacadadawadadadadacadadazadadadad
ababadadaEadadadacadadadadadadacadadadadadadadacadadadadadadacadadadadacadadadadadadacadadadadadadadacadayadadadadad
ababadadadadadadacadadadadadadacadadadadadadadacadadadadadadacadadadadacadadadadadadacadadadadadadadacadadadadadadad
ababadadadadadadacadadadadadadacadadadadadadadacadadadadadadacadadadadacadadadadadadacadadadadadadadacadadadadadadad
abababababababababababababababababababababababababababababababababababababababababababababababababababababababababab
aeababababababababababababababababababababababababababababababababababababababababababababababababababababababababab
"}
