"aa" = (/obj/covers/shipwindow,/turf/wall/sub_bulkhead/sub_shielding{opacity = 0},/area/caribbean/sea/underwater)
"ab" = (/turf/floor/beach/water/deep/saltwater/underwater,/area/caribbean/sea/underwater)
"ac" = (/obj/structure/curtain/medical,/turf/floor/sub_deck/medical_bay,/area/caribbean/sea/underwater)
"ad" = (/obj/structure/table/modern,/obj/item/weapon/storage/firstaid/combat/modern,/obj/item/weapon/storage/firstaid/combat/modern,/obj/item/weapon/storage/firstaid/adv,/obj/item/weapon/storage/firstaid/adv,/turf/floor/sub_deck/medical_bay,/area/caribbean/sea/underwater)
"ae" = (/obj/map_metadata/subcom13,/turf/floor/beach/water/deep/saltwater/underwater,/area/caribbean/sea/underwater)
"af" = (/turf/floor/sub_deck/operations,/area/caribbean/sea/underwater)
"ag" = (/obj/structure/lamp/lamp_small/alwayson/sub,/obj/structure/lamp/lamp_small/alwayson/red/emergency,/turf/floor/sub_deck/operations,/area/caribbean/sea/underwater)
"ah" = (/turf/floor/sub_deck/engine_room,/area/caribbean/sea/underwater)
"ai" = (/obj/structure/sign/custom/metallic{name = "Operations Room"},/turf/wall/sub_bulkhead,/area/caribbean/sea/underwater)
"aj" = (/obj/structure/medicalbed,/obj/item/weapon/bedsheet/medical,/obj/structure/lamp/lamp_small/alwayson/sub,/obj/structure/lamp/lamp_small/alwayson/red/emergency,/turf/floor/sub_deck/medical_bay,/area/caribbean/sea/underwater)
"ak" = (/obj/item/weapon/torpedo,/obj/item/weapon/torpedo,/obj/structure/table/rack/shelf,/turf/floor/sub_deck/storage,/area/caribbean/sea/underwater)
"al" = (/obj/structure/lamp/lamp_small/alwayson/sub{dir = 8},/turf/floor/sub_deck/rear_corridor,/area/caribbean/sea/underwater)
"am" = (/obj/structure/machinery/sub_physical/coolant_pump{pump_id = 1; is_primary = 1},/obj/structure/lamp/lamp_small/alwayson/sub{dir = 1},/obj/structure/lamp/lamp_small/alwayson/red/emergency{dir = 1},/obj/covers/steelplating,/turf/floor/sub_deck/reactor_room,/area/caribbean/sea/underwater)
"an" = (/turf/wall/sub_hull,/area/caribbean/sea/underwater)
"ao" = (/obj/covers/steelplating,/turf/floor/sub_deck/reactor_room,/area/caribbean/sea/underwater)
"ap" = (/obj/structure/lamp/lamp_small/alwayson/sub,/turf/floor/sub_deck/central_corridor,/area/caribbean/sea/underwater)
"aq" = (/obj/structure/machinery/sub_physical/galley,/turf/floor/sub_deck/galley,/area/caribbean/sea/underwater)
"ar" = (/turf/floor/sub_deck/medical_bay,/area/caribbean/sea/underwater)
"as" = (/obj/structure/machinery/sub_physical/coolant_pump{pump_id = 1; is_primary = 1},/obj/structure/lamp/lamp_small/alwayson/sub,/obj/structure/lamp/lamp_small/alwayson/red/emergency,/obj/covers/steelplating,/turf/floor/sub_deck/reactor_room,/area/caribbean/sea/underwater)
"at" = (/obj/structure/machinery/sub_physical/breach_sealant/engine_room,/turf/floor/sub_deck/engine_room,/area/caribbean/sea/underwater)
"au" = (/turf/wall/sub_bulkhead/sub_shielding,/area/caribbean/sea/underwater)
"av" = (/obj/structure/machinery/sub_control/radar_panel,/obj/structure/table/modern/retable,/turf/floor/sub_deck/operations,/area/caribbean/sea/underwater)
"aw" = (/turf/floor/sub_deck/forward_torpedo,/area/caribbean/sea/underwater)
"ay" = (/turf/wall/sub_bulkhead,/area/caribbean/sea/underwater)
"az" = (/obj/structure/bed/chair/steel/alt/green{dir = 8},/turf/floor/sub_deck/operations,/area/caribbean/sea/underwater)
"aA" = (/obj/structure/bed/chair/steel/alt/green{dir = 4},/turf/floor/sub_deck/operations,/area/caribbean/sea/underwater)
"aB" = (/obj/structure/simple_door/blast,/turf/floor/sub_deck/engine_room,/area/caribbean/sea/underwater)
"aC" = (/obj/structure/machinery/sub_physical/scrubber,/turf/floor/sub_deck/operations,/area/caribbean/sea/underwater)
"aD" = (/obj/item/weapon/stool,/turf/floor/sub_deck/galley,/area/caribbean/sea/underwater)
"aE" = (/obj/structure/closet/cabinet/extinguisher_cabinet,/turf/wall/sub_bulkhead,/area/caribbean/sea/underwater)
"be" = (/obj/structure/lamp/lamp_small/alwayson/sub{dir = 1},/obj/structure/lamp/lamp_small/alwayson/red/emergency{dir = 1},/obj/covers/invisible,/turf/floor/sub_deck/engine_room,/area/caribbean/sea/underwater)
"bG" = (/obj/structure/simple_door/blast,/turf/floor/sub_deck/central_corridor,/area/caribbean/sea/underwater)
"cf" = (/obj/item/weapon/torpedo,/obj/structure/table/rack/shelf,/obj/item/weapon/torpedo,/turf/floor/sub_deck/forward_torpedo,/area/caribbean/sea/underwater)
"cn" = (/obj/structure/bed/chair/steel/alt/blue,/turf/floor/sub_deck/operations,/area/caribbean/sea/underwater)
"dz" = (/obj/item/weapon/storage/toolbox/emergency,/turf/floor/sub_deck/storage,/area/caribbean/sea/underwater)
"ej" = (/obj/structure/vending/submarine_emergency,/turf/floor/sub_deck/engine_room,/area/caribbean/sea/underwater)
"eA" = (/obj/structure/simple_door/blast,/turf/floor/sub_deck/medical_bay,/area/caribbean/sea/underwater)
"eI" = (/obj/structure/lamp/lamp_small/alwayson/sub,/obj/structure/lamp/lamp_small/alwayson/red/emergency,/obj/covers/steelplating,/turf/floor/sub_deck/reactor_room,/area/caribbean/sea/underwater)
"fX" = (/obj/structure/lamp/lamp_small/alwayson/sub{dir = 1},/turf/floor/sub_deck/operations,/area/caribbean/sea/underwater)
"gf" = (/obj/structure/table/modern/retable,/obj/item/weapon/paper,/obj/item/weapon/paper,/obj/item/weapon/paper,/obj/item/weapon/pen,/turf/floor/sub_deck/operations,/area/caribbean/sea/underwater)
"hm" = (/obj/structure/table/modern/retable,/obj/item/weapon/paper,/obj/item/weapon/paper_bin/empty,/obj/item/weapon/pen/blue,/turf/floor/sub_deck/operations,/area/caribbean/sea/underwater)
"hv" = (/obj/structure/lamp/lamp_small/alwayson/sub,/obj/structure/lamp/lamp_small/alwayson/red/emergency,/turf/floor/sub_deck/rear_corridor,/area/caribbean/sea/underwater)
"hx" = (/obj/structure/machinery/sub_physical/bilge_pump,/turf/floor/sub_deck/operations,/area/caribbean/sea/underwater)
"hG" = (/obj/structure/lamp/lamp_small/alwayson/sub{dir = 1},/obj/structure/lamp/lamp_small/alwayson/red/emergency{dir = 1},/turf/floor/sub_deck/operations,/area/caribbean/sea/underwater)
"hL" = (/obj/structure/machinery/sub_physical/vent_duct/fwd_torpedo,/turf/floor/sub_deck/forward_torpedo,/area/caribbean/sea/underwater)
"iu" = (/obj/structure/medicalbed,/obj/item/weapon/bedsheet/medical,/turf/floor/sub_deck/medical_bay,/area/caribbean/sea/underwater)
"jN" = (/obj/structure/lamp/lamp_small/alwayson/sub{dir = 1},/obj/structure/lamp/lamp_small/alwayson/red/emergency{dir = 1},/turf/floor/sub_deck/medical_bay,/area/caribbean/sea/underwater)
"kB" = (/turf/floor/sub_deck/rear_corridor,/area/caribbean/sea/underwater)
"kI" = (/obj/structure/closet/cabinet/extinguisher_cabinet,/turf/wall/sub_hull,/area/caribbean/sea/underwater)
"kM" = (/obj/structure/vending/submarine_emergency,/turf/floor/sub_deck/medical_bay,/area/caribbean/sea/underwater)
"lc" = (/obj/structure/machinery/sub_physical/bilge_pump,/turf/floor/sub_deck/storage,/area/caribbean/sea/underwater)
"lP" = (/turf/floor/sub_deck/storage,/area/caribbean/sea/underwater)
"mn" = (/obj/structure/lamp/lamp_small/alwayson/sub,/turf/floor/sub_deck/medical_bay,/area/caribbean/sea/underwater)
"mD" = (/obj/structure/vending/submarine_emergency,/turf/floor/sub_deck/forward_torpedo,/area/caribbean/sea/underwater)
"nM" = (/obj/structure/bed/chair/steel/alt/green{dir = 1},/turf/floor/sub_deck/operations,/area/caribbean/sea/underwater)
"oy" = (/obj/structure/machinery/sub_physical/torpedo_tube{tube_id = 3},/turf/floor/sub_deck/forward_torpedo,/area/caribbean/sea/underwater)
"oP" = (/obj/structure/machinery/sub_physical/bilge_pump,/turf/floor/sub_deck/engine_room,/area/caribbean/sea/underwater)
"oQ" = (/obj/structure/table/modern/retable,/obj/structure/lamp/lamp_small/alwayson/sub{dir = 1},/turf/floor/sub_deck/galley,/area/caribbean/sea/underwater)
"rI" = (/obj/structure/lamp/lamp_small/alwayson/sub{dir = 4},/obj/structure/lamp/lamp_small/alwayson/red/emergency{dir = 4},/turf/floor/sub_deck/operations,/area/caribbean/sea/underwater)
"sF" = (/obj/structure/vending/submarine_emergency,/turf/floor/sub_deck/galley,/area/caribbean/sea/underwater)
"sH" = (/obj/structure/machinery/sub_physical/bilge_pump,/turf/floor/sub_deck/rear_corridor,/area/caribbean/sea/underwater)
"sO" = (/obj/structure/vending/submarine_emergency,/turf/floor/sub_deck/rear_corridor,/area/caribbean/sea/underwater)
"ts" = (/obj/structure/machinery/sub_physical/reactor_core{id = 2},/obj/covers/steelplating,/turf/floor/sub_deck/reactor_room,/area/caribbean/sea/underwater)
"tR" = (/obj/structure/machinery/sub_physical/vent_duct/galley,/turf/floor/sub_deck/galley,/area/caribbean/sea/underwater)
"uc" = (/obj/structure/lamp/lamp_small/alwayson/sub{dir = 1},/obj/structure/lamp/lamp_small/alwayson/red/emergency{dir = 1},/turf/floor/sub_deck/rear_corridor,/area/caribbean/sea/underwater)
"un" = (/obj/structure/machinery/sub_physical/vent_duct/engine_room,/turf/floor/sub_deck/engine_room,/area/caribbean/sea/underwater)
"ut" = (/obj/structure/machinery/sub_control/weapons_panel{dir = 8},/obj/structure/table/modern/retable,/turf/floor/sub_deck/operations,/area/caribbean/sea/underwater)
"vk" = (/turf/floor/sub_deck/galley,/area/caribbean/sea/underwater)
"vR" = (/obj/structure/machinery/sub_physical/breach_sealant/central_corridor,/obj/structure/lamp/lamp_small/alwayson/red/emergency{dir = 1},/turf/floor/sub_deck/central_corridor,/area/caribbean/sea/underwater)
"wc" = (/obj/structure/lamp/lamp_small/alwayson/sub,/obj/item/weapon/torpedo,/obj/item/weapon/torpedo,/obj/structure/table/rack/shelf,/turf/floor/sub_deck/storage,/area/caribbean/sea/underwater)
"wt" = (/obj/structure/lamp/lamp_small/alwayson/sub{dir = 4},/obj/structure/lamp/lamp_small/alwayson/red/emergency{dir = 4},/turf/floor/sub_deck/engine_room,/area/caribbean/sea/underwater)
"wM" = (/obj/structure/machinery/sub_control/reactor_panel{dir = 4},/obj/structure/table/modern/retable,/turf/floor/sub_deck/operations,/area/caribbean/sea/underwater)
"xe" = (/obj/structure/machinery/sub_physical/bilge_pump,/turf/floor/sub_deck/medical_bay,/area/caribbean/sea/underwater)
"xI" = (/obj/structure/sign/custom/metallic{name = "Torpedo Room"},/turf/wall/sub_bulkhead,/area/caribbean/sea/underwater)
"yw" = (/obj/covers/invisible,/turf/floor/sub_deck/engine_room,/area/caribbean/sea/underwater)
"yM" = (/obj/structure/machinery/sub_physical/fuel_storage,/obj/structure/lamp/lamp_small/alwayson/sub,/obj/structure/lamp/lamp_small/alwayson/red/emergency,/turf/floor/sub_deck/engine_room,/area/caribbean/sea/underwater)
"zd" = (/obj/structure/machinery/sub_physical/vent_duct/central_corridor,/obj/structure/lamp/lamp_small/alwayson/red/emergency{dir = 1},/turf/floor/sub_deck/central_corridor,/area/caribbean/sea/underwater)
"zB" = (/obj/structure/table/modern/retable,/turf/floor/sub_deck/galley,/area/caribbean/sea/underwater)
"zH" = (/obj/structure/closet/cabinet/extinguisher_cabinet,/turf/wall/sub_bulkhead/sub_shielding,/area/caribbean/sea/underwater)
"An" = (/turf/floor/sub_deck/central_corridor,/area/caribbean/sea/underwater)
"At" = (/obj/structure/sign/custom/metallic{name = "Engine Room"},/turf/wall/sub_bulkhead,/area/caribbean/sea/underwater)
"Av" = (/obj/structure/bed/bunk,/turf/floor/sub_deck/galley,/area/caribbean/sea/underwater)
"AJ" = (/obj/structure/table/modern/retable,/obj/item/weapon/book/subcom_sonar_manual,/obj/structure/lamp/lamp_small/alwayson/sub{dir = 1},/turf/floor/sub_deck/operations,/area/caribbean/sea/underwater)
"AN" = (/obj/structure/machinery/sub_control/compartment_panel,/obj/structure/table/modern/retable,/turf/floor/sub_deck/operations,/area/caribbean/sea/underwater)
"Bp" = (/obj/structure/machinery/sub_physical/fuel_storage,/obj/structure/lamp/lamp_small/alwayson/sub{dir = 1},/obj/structure/lamp/lamp_small/alwayson/red/emergency{dir = 1},/turf/floor/sub_deck/engine_room,/area/caribbean/sea/underwater)
"BM" = (/obj/structure/lamp/lamp_small/alwayson/sub{dir = 4},/obj/structure/lamp/lamp_small/alwayson/red/emergency{dir = 4},/turf/floor/sub_deck/rear_corridor,/area/caribbean/sea/underwater)
"BU" = (/obj/effect/floor_decal/industrial/warning/dust{dir = 8},/obj/covers/steelplating,/turf/floor/sub_deck/reactor_room,/area/caribbean/sea/underwater)
"Ci" = (/obj/structure/table/modern/retable,/obj/structure/lamp/lamp_small/alwayson/red/emergency,/turf/floor/sub_deck/galley,/area/caribbean/sea/underwater)
"Cp" = (/obj/effect/landmark{name = "JoinLateSub"},/turf/floor/sub_deck/galley,/area/caribbean/sea/underwater)
"CB" = (/obj/structure/lamp/lamp_small/alwayson/sub{dir = 8},/obj/structure/machinery/sub_physical/fuel_storage,/turf/floor/sub_deck/forward_torpedo,/area/caribbean/sea/underwater)
"CE" = (/obj/structure/simple_door/blast,/turf/floor/sub_deck/galley,/area/caribbean/sea/underwater)
"DD" = (/obj/structure/lamp/lamp_small/alwayson/sub{dir = 8},/obj/structure/lamp/lamp_small/alwayson/red/emergency{dir = 8},/turf/floor/sub_deck/operations,/area/caribbean/sea/underwater)
"DO" = (/obj/structure/lamp/lamp_small/alwayson/red/emergency{dir = 1},/turf/floor/sub_deck/central_corridor,/area/caribbean/sea/underwater)
"DZ" = (/obj/structure/machinery/sub_physical/vent_duct/operations,/obj/structure/lamp/lamp_small/alwayson/sub,/obj/structure/lamp/lamp_small/alwayson/red/emergency,/turf/floor/sub_deck/operations,/area/caribbean/sea/underwater)
"Ew" = (/obj/structure/table/modern/retable,/turf/floor/sub_deck/operations,/area/caribbean/sea/underwater)
"Fp" = (/obj/structure/machinery/sub_physical/vent_duct/storage,/turf/floor/sub_deck/storage,/area/caribbean/sea/underwater)
"Ft" = (/obj/item/weapon/storage/toolbox/mechanical,/turf/floor/sub_deck/storage,/area/caribbean/sea/underwater)
"FS" = (/obj/structure/machinery/sub_physical/bilge_pump,/obj/structure/lamp/lamp_small/alwayson/sub,/obj/structure/lamp/lamp_small/alwayson/red/emergency,/turf/floor/sub_deck/forward_torpedo,/area/caribbean/sea/underwater)
"Gx" = (/obj/structure/sign/custom/metallic{name = "Storage"},/turf/wall/sub_bulkhead,/area/caribbean/sea/underwater)
"Hf" = (/obj/structure/machinery/sub_physical/breach_sealant/operations,/turf/floor/sub_deck/operations,/area/caribbean/sea/underwater)
"Hl" = (/obj/structure/closet/crate/footlocker,/obj/structure/lamp/lamp_small/alwayson/sub{dir = 1},/obj/item/clothing/suit/lifejacket,/obj/item/clothing/suit/lifejacket,/obj/item/clothing/suit/lifejacket,/obj/item/clothing/suit/lifejacket,/turf/floor/sub_deck/galley,/area/caribbean/sea/underwater)
"HH" = (/obj/structure/machinery/sub_physical/fuel_storage,/turf/floor/sub_deck/engine_room,/area/caribbean/sea/underwater)
"HV" = (/obj/structure/lamp/lamp_small/alwayson/red/emergency,/obj/structure/machinery/sub_physical/breach_sealant/galley,/turf/floor/sub_deck/galley,/area/caribbean/sea/underwater)
"HX" = (/obj/structure/bed/chair/steel/alt/red{dir = 1},/turf/floor/sub_deck/operations,/area/caribbean/sea/underwater)
"IO" = (/obj/structure/machinery/sub_physical/bilge_pump,/obj/covers/steelplating,/turf/floor/sub_deck/reactor_room,/area/caribbean/sea/underwater)
"IQ" = (/obj/structure/table/modern/retable,/obj/structure/machinery/sub_control/maneuver_panel{dir = 8},/turf/floor/sub_deck/operations,/area/caribbean/sea/underwater)
"Ji" = (/obj/structure/sign/custom/metallic{name = "Bunks & Galley"},/turf/wall/sub_bulkhead,/area/caribbean/sea/underwater)
"JE" = (/obj/structure/props/torpedo_tube,/turf/floor/sub_deck/forward_torpedo,/area/caribbean/sea/underwater)
"JO" = (/obj/structure/machinery/sub_physical/steam_turbine,/obj/covers/invisible,/turf/floor/sub_deck/engine_room,/area/caribbean/sea/underwater)
"Kv" = (/obj/structure/sub_physical/stern_plane,/turf/floor/beach/water/deep/saltwater/underwater,/area/caribbean/sea/underwater)
"Kz" = (/obj/structure/bed/chair/steel{dir = 1},/turf/floor/sub_deck/operations,/area/caribbean/sea/underwater)
"MY" = (/obj/structure/table/modern/retable,/obj/structure/machinery/sub_control/sonar_panel,/turf/floor/sub_deck/operations,/area/caribbean/sea/underwater)
"MZ" = (/obj/structure/closet/crate/footlocker,/obj/structure/lamp/lamp_small/alwayson/red/emergency,/obj/item/clothing/suit/lifejacket,/obj/item/clothing/suit/lifejacket,/obj/item/clothing/suit/lifejacket,/obj/item/clothing/suit/lifejacket,/turf/floor/sub_deck/galley,/area/caribbean/sea/underwater)
"Ne" = (/obj/structure/machinery/sub_physical/vent_duct/rear_corridor,/turf/floor/sub_deck/rear_corridor,/area/caribbean/sea/underwater)
"Ni" = (/obj/structure/simple_door/blast,/turf/floor/sub_deck/operations,/area/caribbean/sea/underwater)
"Nk" = (/obj/structure/machinery/sub_physical/breach_sealant/rear_corridor,/turf/floor/sub_deck/rear_corridor,/area/caribbean/sea/underwater)
"Nr" = (/obj/structure/table/modern/retable,/obj/structure/machinery/sub_control/radio_console{dir = 4},/turf/floor/sub_deck/operations,/area/caribbean/sea/underwater)
"NL" = (/obj/structure/lamp/lamp_small/alwayson/sub{dir = 1},/obj/structure/lamp/lamp_small/alwayson/red/emergency{dir = 1},/obj/covers/steelplating,/turf/floor/sub_deck/reactor_room,/area/caribbean/sea/underwater)
"NS" = (/obj/structure/machinery/sub_physical/diesel_engine,/obj/covers/invisible,/turf/floor/sub_deck/engine_room,/area/caribbean/sea/underwater)
"NW" = (/obj/structure/closet/wardrobe{name = "NBC wardrobe"},/obj/item/clothing/suit/nbc,/obj/item/clothing/suit/nbc,/obj/item/clothing/suit/nbc,/obj/item/clothing/suit/nbc,/obj/item/weapon/storage/box/nbcbox/ami,/obj/item/clothing/head/nbc,/obj/item/clothing/head/nbc,/obj/item/clothing/head/nbc,/obj/item/weapon/geiger_counter,/obj/structure/lamp/lamp_small/alwayson/sub,/turf/floor/sub_deck/rear_corridor,/area/caribbean/sea/underwater)
"Oo" = (/obj/structure/sign/custom/metallic{name = "Medical"},/turf/wall/sub_bulkhead,/area/caribbean/sea/underwater)
"OF" = (/obj/structure/table/modern/retable,/obj/structure/machinery/sub_control/map_display{dir = 1},/obj/structure/lamp/lamp_small/alwayson/red/emergency{dir = 1},/obj/structure/lamp/lamp_small/alwayson/sub{dir = 1},/turf/floor/sub_deck/operations,/area/caribbean/sea/underwater)
"Pe" = (/obj/item/weapon/doctor_handbook,/obj/item/weapon/doctor_handbook,/obj/item/weapon/doctor_handbook,/obj/structure/table/modern,/obj/item/weapon/storage/firstaid/surgery,/turf/floor/sub_deck/medical_bay,/area/caribbean/sea/underwater)
"Pk" = (/obj/structure/lamp/lamp_small/alwayson/sub{dir = 4},/obj/structure/lamp/lamp_small/alwayson/red/emergency{dir = 4},/obj/structure/machinery/sub_physical/fuel_storage,/turf/floor/sub_deck/forward_torpedo,/area/caribbean/sea/underwater)
"Pv" = (/obj/structure/vending/submarine_emergency,/turf/floor/sub_deck/storage,/area/caribbean/sea/underwater)
"PO" = (/obj/structure/machinery/sub_physical/vent_duct/medical_bay,/turf/floor/sub_deck/medical_bay,/area/caribbean/sea/underwater)
"PY" = (/obj/structure/vending/submarine_emergency,/turf/floor/sub_deck/operations,/area/caribbean/sea/underwater)
"Qt" = (/obj/structure/machinery/sub_physical/vent_duct/reactor_room,/obj/covers/steelplating,/turf/floor/sub_deck/reactor_room,/area/caribbean/sea/underwater)
"QA" = (/obj/structure/machinery/sub_physical/bilge_pump,/obj/structure/lamp/lamp_small/alwayson/sub{dir = 1},/turf/floor/sub_deck/galley,/area/caribbean/sea/underwater)
"Ru" = (/obj/structure/machinery/sub_physical/breach_sealant/medical_bay,/turf/floor/sub_deck/medical_bay,/area/caribbean/sea/underwater)
"RA" = (/obj/structure/machinery/sub_physical/diesel_engine,/obj/structure/lamp/lamp_small/alwayson/sub,/obj/structure/lamp/lamp_small/alwayson/red/emergency,/obj/covers/invisible,/turf/floor/sub_deck/engine_room,/area/caribbean/sea/underwater)
"RP" = (/obj/structure/machinery/sub_physical/breach_sealant/reactor_room,/obj/covers/steelplating,/turf/floor/sub_deck/reactor_room,/area/caribbean/sea/underwater)
"RW" = (/obj/structure/machinery/sub_control/misc_systems,/obj/structure/table/modern/retable,/turf/floor/sub_deck/operations,/area/caribbean/sea/underwater)
"RY" = (/obj/structure/closet/wardrobe{name = "NBC wardrobe"},/obj/item/clothing/suit/nbc,/obj/item/clothing/suit/nbc,/obj/item/clothing/suit/nbc,/obj/item/clothing/suit/nbc,/obj/item/weapon/storage/box/nbcbox/ami,/obj/item/clothing/head/nbc,/obj/item/clothing/head/nbc,/obj/item/clothing/head/nbc,/obj/item/weapon/geiger_counter,/turf/floor/sub_deck/rear_corridor,/area/caribbean/sea/underwater)
"SC" = (/obj/structure/machinery/sub_physical/breach_sealant/storage,/turf/floor/sub_deck/storage,/area/caribbean/sea/underwater)
"SK" = (/obj/structure/lamp/lamp_small/alwayson/red/emergency{dir = 1},/obj/item/weapon/torpedo,/obj/item/weapon/torpedo,/obj/structure/table/rack/shelf,/turf/floor/sub_deck/storage,/area/caribbean/sea/underwater)
"SP" = (/obj/structure/sign/custom/metallic{name = "Nuclear Reactor"},/turf/wall/sub_bulkhead/sub_shielding,/area/caribbean/sea/underwater)
"Tf" = (/obj/structure/closet/wardrobe{name = "NBC wardrobe"},/obj/item/clothing/suit/nbc,/obj/item/clothing/suit/nbc,/obj/item/clothing/suit/nbc,/obj/item/clothing/suit/nbc,/obj/item/weapon/storage/box/nbcbox/ami,/obj/item/clothing/head/nbc,/obj/item/clothing/head/nbc,/obj/item/clothing/head/nbc,/obj/item/weapon/geiger_counter,/obj/structure/lamp/lamp_small/alwayson/sub{dir = 1},/turf/floor/sub_deck/rear_corridor,/area/caribbean/sea/underwater)
"Tu" = (/obj/structure/simple_door/blast,/turf/floor/sub_deck/reactor_room,/area/caribbean/sea/underwater)
"TM" = (/obj/structure/table/modern/retable,/obj/item/weapon/paper,/turf/floor/sub_deck/operations,/area/caribbean/sea/underwater)
"Uz" = (/obj/structure/bed/chair/steel/alt/blue{dir = 1},/turf/floor/sub_deck/operations,/area/caribbean/sea/underwater)
"UA" = (/obj/structure/machinery/sub_physical/bilge_pump/emergency,/obj/structure/table/modern/retable,/turf/floor/sub_deck/operations,/area/caribbean/sea/underwater)
"WB" = (/obj/item/weapon/stool,/obj/structure/lamp/lamp_small/alwayson/sub{dir = 1},/turf/floor/sub_deck/galley,/area/caribbean/sea/underwater)
"WG" = (/obj/structure/simple_door/blast,/turf/floor/sub_deck/storage,/area/caribbean/sea/underwater)
"XQ" = (/obj/structure/lamp/lamp_small/alwayson/sub{dir = 1},/obj/structure/machinery/sub_physical/breach_sealant/fwd_torpedo,/obj/structure/lamp/lamp_small/alwayson/red/emergency{dir = 1},/turf/floor/sub_deck/forward_torpedo,/area/caribbean/sea/underwater)
"Yg" = (/obj/structure/machinery/sub_physical/bilge_pump/emergency,/turf/floor/sub_deck/operations,/area/caribbean/sea/underwater)
"Yq" = (/obj/structure/sign/radiation,/turf/wall/sub_bulkhead/sub_shielding,/area/caribbean/sea/underwater)

(1,1,1) = {"
ababababababababababababababababababababababababababababababababababababababababababababababababababababababababababababababababababababababababababab
ababababababababababababababababababababababababababababababababababababababababababababababababababababababababababababababababababababababababababab
ababababababababababababababababababababababababababababababababababababababababababababababababababababababababababababababababababababababababababab
ababababababababababababababababababababababababababababababababababababababababababababababababababababababababababababababababababababababababababab
ababababababababababababababababababababababababababababababababababababababababababababababababababababababababababababababababababababababababababab
ababababababababababababababababababababababababababababababababababababababababababababababababababababababababababababababababababababababababababab
ababababababababababababababababababababababababababababababababababababababababababababababababababababababababababababababababababababababababababab
ababababababababababababababababababababababababababababababababababababababababababababababababababababababababababababababababababababababababababab
ababababababababababababababababababababababababababababababababababababababababababababababababababababababababababababababababababababababababababab
ababababababababababababababababababababababababababababababababababababababababababababababababababababababababababababababababababababababababababab
ababababababababababababababababababababababababababababababababababababababababababababababababababababababababababababababababababababababababababab
ababababKvabababababababababababababababababababababababababababababananababababababababababababababababababababababababababababababababababababababab
abababanananababababababababababababababababababababababababababababanananabababababababababababababababababababababababababababababababababababababab
abababanananabababababababababababababanananananananananananababababananananabababanananananananananananananananananananababababababababababababababab
abababananananabababababababababababanansHucsORYTfkBkBuckBayanananananankIanananananAvHlAvHlAvHlAvHlAvQAsFaDoQaDzBWBaqayananananananananababababababab
abababananananababananananananananananankBkBkBkBkBkBkBkBkBayPYPYEwOFEwHfhxhGafafaCJivkvkCpCpCpCpCpCpCpCpCpvkaDtRaDvkaqaEcfawXQoyJEananananabababababab
abababananananababananananatBpHHejbeywayalauauauaazHauauBMayDDafNrHXIQafafcncncnafCEvkMZAvMZAvMZAvMZAvHVvkaDCiaDCiaDaqaycfawawawPkananananabababababab
abababananananananananananahahahahNSywaykBauaoamtsNLIOaukBayafafKzafKzafafgfhmTMrIayayaEayayayayayayayayCEJiayayayayayayCBawawoyJEanananananababababab
abababananananananananananywywahahahwtAtkBTuBUaoaoaoQtaukBaiafafafDZafafafUzUzUzafaivRAnAnAnAnDOAnAnAnDOAnAnAnDOAnAnzdxIawawawawawmDanananananabababab
abababananananananananananJOywahahahahaBkBSPaoaoaoaoaoaukBNiafEwANUARWEwafafagafafbGapAnAnAnAnapAnAnAnapAnAnAnapAnAnapbGawawawawawmDanananananabababab
abababananananananananananahahahahywywaykBYqaoastseIRPaukBayafEwnMfXnMEwafMYAJavafayayaEayayayayOoeAayaEayayayGxWGayayayCBawawoyJEanananananababababab
abababananananababananananoPyMHHunRAywayalauauauaazHauauBMayDDwMazafaAutafKzKzKzrIayxearjNararjNararjNPeaylcSKaklPSKakaycfawhLawPkananananabababababab
abababananananababananananananankIanananNekBkBkBkBkBkBkBkBayafafafagafafafagYgafafayRuacacacacacacararadaydzFtlPlPlPFpaEcfawFSoyJEananananabababababab
abababananananabababababababababababananNkhvsORYhvkBkBhvkBayanananananankIananananankMacajiuiuajacPOmnkMayPvwcakakNWSCayananananananananababababababab
abababanananabababababababababababababanananananananananananababababananananabababanananananananananananananananananananababababababababababababababab
abababanananababababababababababababababababababababababababababababanananabababababababababababababababababababababababababababababababababababababab
ababababKvabababababababababababababababababababababababababababababananababababababababababababababababababababababababababababababababababababababab
ababababababababababababababababababababababababababababababababababababababababababababababababababababababababababababababababababababababababababab
ababababababababababababababababababababababababababababababababababababababababababababababababababababababababababababababababababababababababababab
ababababababababababababababababababababababababababababababababababababababababababababababababababababababababababababababababababababababababababab
ababababababababababababababababababababababababababababababababababababababababababababababababababababababababababababababababababababababababababab
ababababababababababababababababababababababababababababababababababababababababababababababababababababababababababababababababababababababababababab
ababababababababababababababababababababababababababababababababababababababababababababababababababababababababababababababababababababababababababab
ababababababababababababababababababababababababababababababababababababababababababababababababababababababababababababababababababababababababababab
ababababababababababababababababababababababababababababababababababababababababababababababababababababababababababababababababababababababababababab
ababababababababababababababababababababababababababababababababababababababababababababababababababababababababababababababababababababababababababab
ababababababababababababababababababababababababababababababababababababababababababababababababababababababababababababababababababababababababababab
ababababababababababababababababababababababababababababababababababababababababababababababababababababababababababababababababababababababababababab
ababababababababababababababababababababababababababababababababababababababababababababababababababababababababababababababababababababababababababab
aeabababababababababababababababababababababababababababababababababababababababababababababababababababababababababababababababababababababababababab
"}
