"a" = (/turf/floor/dirt,/area/caribbean)
"b" = (/turf/floor/plating/road,/area/caribbean)
"c" = (/obj/effect/floor_decal/industrial/warning/dust{dir = 9; icon_state = "warning_dust"},/turf/floor/plating/road,/area/caribbean)
"d" = (/obj/effect/floor_decal/industrial/warning/dust{dir = 1; icon_state = "warning_dust"},/turf/floor/plating/road,/area/caribbean)
"e" = (/obj/effect/floor_decal/industrial/warning/dust{dir = 5; icon_state = "warning_dust"},/turf/floor/plating/road,/area/caribbean)
"f" = (/obj/effect/floor_decal/industrial/warning/dust{dir = 8; icon_state = "warning_dust"},/turf/floor/plating/road,/area/caribbean)
"g" = (/obj/effect/floor_decal/industrial/warning/dust{dir = 4; icon_state = "warning_dust"; layer = 3},/turf/floor/plating/road,/area/caribbean)
"h" = (/obj/structure/sign/custom{name = "4th: Make an axis and move it to the TOP LEFT frame. Click on it to finish the vehicle."},/turf/floor/dirt,/area/caribbean)
"i" = (/obj/structure/sign/custom{name = "5th: Test the vehicle. If it doesnt work, try manually assemblying any mising parts: drag and drop them to a connected frame."},/turf/floor/dirt,/area/caribbean)
"j" = (/obj/structure/engine/internal/gasoline{enginesize = 5000},/turf/floor/dirt,/area/caribbean)
"k" = (/obj/item/weapon/reagent_containers/glass/barrel/fueltank/smalltank/fueledgasoline,/turf/floor/dirt,/area/caribbean)
"l" = (/obj/item/stack/material/steel{amount = 1000},/obj/item/stack/material/steel{amount = 1000},/turf/floor/dirt,/area/caribbean)
"m" = (/obj/effect/floor_decal/industrial/warning/dust{dir = 10; icon_state = "warning_dust"},/turf/floor/plating/road,/area/caribbean)
"n" = (/obj/effect/floor_decal/industrial/warning/dust,/turf/floor/plating/road,/area/caribbean)
"o" = (/obj/item/weapon/wrench,/obj/item/weapon/wrench,/obj/item/weapon/wrench,/obj/item/weapon/wrench,/obj/item/weapon/wrench,/turf/floor/dirt,/area/caribbean)
"p" = (/obj/map_metadata/testing,/turf/floor/dirt,/area/caribbean)
"q" = (/obj/effect/landmark{icon_state = "x3"; name = "JoinLateCiv"},/turf/floor/dirt,/area/caribbean)
"r" = (/obj/structure/sign/custom{name = "1st: Build the frames. Maximum 5x5, keep it square or rectangular. If you want to add the walls during this step, you should fix the frames in place with a wrench first."},/turf/floor/dirt,/area/caribbean)
"s" = (/obj/structure/sign/custom{name = "2nd: Place the drivers chair, engine, fueltank"},/turf/floor/dirt,/area/caribbean)
"t" = (/obj/structure/sign/custom{name = "3rd: Create 4 wheels/tracks and place each one on top of each corner."},/turf/floor/dirt,/area/caribbean)
"u" = (/obj/effect/floor_decal/industrial/warning/dust{dir = 6; icon_state = "warning_dust"},/turf/floor/plating/road,/area/caribbean)
"v" = (/obj/item/weapon/weldingtool,/obj/item/weapon/weldingtool,/obj/item/weapon/weldingtool,/obj/item/weapon/weldingtool,/obj/item/weapon/weldingtool,/obj/item/weapon/storage/toolbox,/turf/floor/dirt,/area/caribbean)
"w" = (/obj/item/stack/material/copper{amount = 100},/obj/item/stack/material/copper{amount = 100},/obj/item/stack/material/copper{amount = 100},/turf/floor/dirt,/area/caribbean)
"x" = (/obj/item/weapon/reagent_containers/glass/barrel/gunpowder,/obj/item/weapon/reagent_containers/glass/barrel/gunpowder,/turf/floor/dirt,/area/caribbean)
"y" = (/obj/item/stack/material/iron{amount = 100},/obj/item/stack/material/iron{amount = 100},/obj/item/stack/material/iron{amount = 100},/obj/item/stack/material/iron{amount = 100},/obj/item/stack/material/iron{amount = 100},/obj/item/stack/material/iron{amount = 100},/turf/floor/dirt,/area/caribbean)
"z" = (/obj/structure/vehicleparts/frame,/turf/floor/plating/road,/area/caribbean)
"A" = (/obj/structure/vehicleparts/frame,/obj/structure/bed/chair/drivers,/turf/floor/plating/road,/area/caribbean)
"B" = (/obj/structure/vehicleparts/frame,/obj/structure/vehicleparts/axis/heavy,/turf/floor/plating/road,/area/caribbean)
"C" = (/obj/structure/vehicleparts/frame,/obj/structure/engine/internal/gasoline{enginesize = 5000},/turf/floor/plating/road,/area/caribbean)
"D" = (/obj/structure/vehicleparts/frame,/obj/item/weapon/reagent_containers/glass/barrel/fueltank/tank/fueledgasoline,/turf/floor/plating/road,/area/caribbean)
"E" = (/obj/item/stack/material/steel{amount = 1000},/obj/item/stack/material/steel{amount = 1000},/obj/item/stack/material/steel{amount = 1000},/turf/floor/dirt,/area/caribbean)
"F" = (/obj/item/weapon/reagent_containers/glass/barrel/modern/diesel,/obj/item/weapon/reagent_containers/glass/barrel/modern/diesel,/turf/floor/dirt,/area/caribbean)
"G" = (/obj/item/weapon/reagent_containers/glass/barrel/modern/gasoline,/obj/item/weapon/reagent_containers/glass/barrel/modern/gasoline,/turf/floor/dirt,/area/caribbean)
"H" = (/obj/structure/vehicleparts/frame/ship/rwall,/turf/floor/beach/water/shallowsaltwater,/area/caribbean)
"J" = (/obj/structure/vehicleparts/frame/ship/lwall,/turf/floor/beach/water/shallowsaltwater,/area/caribbean)
"K" = (/obj/structure/vehicleparts/frame/ship/front,/turf/floor/beach/water/shallowsaltwater,/area/caribbean)
"L" = (/turf/floor/beach/water/deep/saltwater,/area/caribbean)
"N" = (/obj/structure/vehicleparts/frame/ship,/turf/floor/beach/water/shallowsaltwater,/area/caribbean)
"O" = (/obj/structure/vehicleparts/frame/ship/br,/turf/floor/beach/water/shallowsaltwater,/area/caribbean)
"P" = (/turf/floor/beach/water/shallowsaltwater,/area/caribbean)
"Q" = (/obj/structure/vehicleparts/frame/ship/bl,/turf/floor/beach/water/shallowsaltwater,/area/caribbean)
"S" = (/obj/structure/vehicleparts/frame/ship,/obj/structure/vehicleparts/shipwheel,/turf/floor/beach/water/shallowsaltwater,/area/caribbean)
"U" = (/obj/structure/vehicleparts/frame/ship/fl,/obj/structure/vehicleparts/axis/ship/heavy{dir = 1; name = "Test Ship"},/turf/floor/beach/water/shallowsaltwater,/area/caribbean)
"W" = (/obj/structure/vehicleparts/frame/ship,/obj/structure/vehicleparts/movement/sails/premade,/turf/floor/beach/water/shallowsaltwater,/area/caribbean)
"X" = (/obj/structure/vehicleparts/frame/ship/fr,/turf/floor/beach/water/shallowsaltwater,/area/caribbean)
"Y" = (/obj/structure/vehicleparts/frame/ship/back,/turf/floor/beach/water/shallowsaltwater,/area/caribbean)
"Z" = (/obj/structure/vehicleparts/frame/ship,/obj/effect/autoassembler{dir = 1},/turf/floor/beach/water/shallowsaltwater,/area/caribbean)

(1,1,1) = {"
LLLLLLLLLLLLLLLLLLLLLLLLLLLLLLLLLLLLLLLLLLLLLLLLLLLLLLLLLLLLLLLLL
LLLLLLLLLLLLLLLLLLLLLLLLLLLLLLLLLLLLLLLLLLLLLLLLLLLLLLLLLLLLLLLLL
LLLLLLLLLLLLLLLLLLLLLLLLLLLLLLLLLLLLLLLLLLLLLLLLLLLLLLLLLLLLLLLLL
LLLLLLLLLLLLLLLLLLLLLLLLLLLLLLLLLLLLLLLLLLLLLLLLLLLLLLLLLLLLLLLLL
LLLLLLLLLLLLLLLLLLLLLLLLLLLLLLLLLLLLLLLLLLLLLLLLLLLLLLLLLLLLLLLLL
LLLLLLLLLLLLLLLLLLLLLLLLLLLLLLLLLLLLLLLLLLLLLLLLLLLLLLLLLLLLLLLLL
LLLLLLLLLLLLLLLLLLLLLLLLLLLLLLLLLLLLLLLLLLLLLLLLLLLLLLLLLLLLLLLLL
LLLLLLLLLLLLLLLLLLLLLLLLLLLLLLLLLLLLLLLLLLLLLLLLLLLLLLLLLLLLLLLLL
LLLLLLLLLLLLLLLLLLLLLLLLLLLLLLLLLLLLLLLLLLLLLLLLLLLLLLLLLLLLLLLLL
LLLLLLLLLLLLLLLLLLLLLLLLLLLLLLLLLLLLLLLLLLLLLLLLLLLLLLLLLLLLLLLLL
LLLLLLLLLLLLLLLLLLLLLLLLLLLLLLLLLLLLLLLLLLLLLLLLLLLLLLLLLLLLLLLLL
LLLLLLLLLLLLLLLLLLLLLLLLLLLLLLLLLLLLLLLLLLLLLLLLLLLLLLLLLLLLLLLLL
LLLLLLLLLLLLLLLLLLLLLLLLLLLLLLLLLLLLLLLLLLLLLLLLLLLLLLLLLLLLLLLLL
PPPPPPPPPPPPPPPPPPPPPPPPPPPPPPPPPPPPPPPPPPPPPPPPPPPPPPPPPPPPPPPPP
PPPPPPPPPPPPPPPPPPPPPPPPPPPPPPPPPPPPPPPPPPPPPPPPPPPPPPPPPPPPPPPPP
PPPPUKKXPPPPPPPPPPPPPPPPPPPPPPPPPPPPPPPPPPPPPPPPPPPPPPPPPPPPPPPPP
PPPPJWNHPPPPPPPPPPPPPPPPPPPPPPPPPPPPPPPPPPPPPPPPPPPPPPPPPPPPPPPPP
PPPPJSZHPPPPPPPPPPPPPPPPPPPPPPPPPPPPPPPPPPPPPPPPPPPPPPPPPPPPPPPPP
PPPPQYYOPPPPPPPPPPPPPPPPPPPPPPPPPPPPPPPPPPPPPPPPPPPPPPPPPPPPPPPPP
bbPPPPPPPPbbbbbbbbbbbbbbbbbbbbbbbbbbbbbbbbbbbbbbbbbbbbbbbbbbbbbbb
bbbbbbbbbbbbbbbbbbbbbbbbbbbbbbbbbbbbbbbbbbbbbbbbbbbbbbbbbbbbbbbbb
bbbbbbbbbbbbbbbbbbbbbbbbbbbbbbbbbbbbbbbbbbbbbbbbbbbbbbbbbbbbbbbbb
bbbbbbbbbbbbbbbbbbbbbbbbbbbbbbbbbbbbbbbbbbbbbbbbbbbbbbbbbbbbbbbbb
bbbbbbbbbbbbbbbbbbbbbbbbbbbbbbbbbbbbbbbbbbbbbbbbbbbbbbbbbbbbbbbbb
bbbbbbbbbbbbbbbbbbbbbbbbbbbbbbbbbbbbbbbbbbbbbbbbbbbbbbbbbbbbbbbbb
bbbbbbbbbbbbbbbbbbbbbbbbbbbbbbbbbbbbbbbbbbbbbbbbbbbbbbbbbbbbbbbbb
bbbbbbbbbbbbbbbbbbbbbbbbbbbbbbbbbbbbbbbbbbbbbbbbbbbbbbbbbbbbbbbbb
bbbbbbbbbbbbbbbbbbbbbbbbbbbbbbbbbbbbbbbbbbbbbbbbbbbbbbbbbbbbbbbbb
bbbbbbbbbbbbbbbbbbbbbbbbbbbbbbbbbbbbbbbbbbbbbbbbbbbbbbbbbbbbbbbbb
bbbbbbbbbbbbbbbbbbbbbbbbbbbbbbbbbbbbbbbbbbbbbbbbbbbbbbbbbbbbbbbbb
abbbbbbbbbbbbbbbbbbbbbbbbbbbbbbbbbbbbbbbbbbbbbbbbbbbbbbbbbbbbbaaa
abbbbbbbbbbbbbbbbbbbbbbbbbbbbbbbbbbbbbbbbbbbbbbbbbbbbbbbbbbbbbaaa
abbbbbbbbbbbbbbbbbbbbbbbbbbbbbbbbbbbbbbbbbbbbbbbbbbbbbbbbbbbbbaaa
abbbbbbbbbbbbbbbbbbbbbbbbbbbbbbbbbbbbbbbbbbbbbbbbbbbbbbbbbbbbbaaa
abbbbbbbbbbbbbbbbbbbbbbbbbbbbbbbbbbbbbbbbbbbbbbbbbbbbbbbbbbbbbaaa
abbbbbaabbbbbaabbbbbaabbbbbaabbbbbaabbbbbaabbbbbaabbbbbaabbbbbaaa
abbbbbaabbbbbaabbbbbaabbbbbaabbbbbaabbbbbaabbbbbaabbbbbaabbbbbaaa
abbbbbaabbbbbaabbbbbaabbbbbaabbbbbaabbbbbaabbbbbaabbbbbaabbbbbaaa
abbbbbaabbbbbaabbbbbaabbbbbaabbbbbaabbbbbaabbbbbaabbbbbaabbbbbaaa
rcdddearcdddearcdddearcdddearcdddearcdddearcdddearcdddearcdddeaaa
sfbbbgasfbbbgasfbbbgasfzAzgasfbbbgasfbbbgasfbbbgasfbbbgasfbbbgaaa
tfbbbgatfbbbgatfbbbgatfzBzgatfbbbgatfbbbgatfbbbgatfbbbgatfbbbgaaa
hfbbbgahfbbbgahfbbbgahfCzDgahfbbbgahfbbbgahfbbbgahfbbbgahfbbbgaaa
imnnnuaimnnnuaimnnnuaimnnnuaimnnnuaimnnnuaimnnnuaimnnnuaimnnnuaaa
avjlkoaavjlkoaavjlkoaavjlkoaavjlkoaavjlkoaavjlkoaavjlkoaavjlkoaaa
aEwxyFaaEwxyFaaEwxyFaaEwxyFaaEwxyFaaEwxyFaaEwxyFaaEwxyFaaEwxyFaaa
aaaaaGaaaaaaGaaaaaaGaaaaaaGaaaaaaGaaaaaaGaaaaaaGaaaaaaGaaaaaaGaaa
aaaaaaaaaaaaaaaaaaaaaaaaaaaaaaaaaaaaaaaaaaaaaaaaaaaaaaaaaaaaaaaaa
aaaaaaaaaaaaaaaaaaaaaaaaaaaaaaaaaaaaaaaaaaaaaaaaaaaaaaaaaaaaaaaaa
paaaaaaaqqqqqqqqqqqqqqqqqqqqqqqqqqqqqqqqqqqqaaaaaaaaaaaaaaaaaaaaa
"}
