"a" = (/turf/floor/beach/water/deep/saltwater,/area/caribbean/sea/top)
"b" = (/obj/structure/barricade/ship/blue/b9,/obj/covers/repairedfloor/ship,/turf/floor/beach/water/deep/saltwater,/area/caribbean/pirates/ship/office)
"e" = (/obj/covers/repairedfloor/ship,/turf/floor/beach/water/deep/saltwater,/area/caribbean/pirates/ship/office)
"f" = (/obj/covers/repairedfloor/ship,/obj/structure/barricade/ship/blue/b2,/turf/floor/beach/water/deep/saltwater,/area/caribbean/pirates/ship/office)
"g" = (/obj/covers/repairedfloor/ship,/mob/living/simple_animal/hostile/pirate,/turf/floor/beach/water/deep/saltwater,/area/caribbean/pirates/ship/main_deck)
"h" = (/obj/structure/barricade/ship/wood/a6,/obj/covers/repairedfloor/ship,/turf/floor/beach/water/deep/saltwater,/area/caribbean/pirates/ship/office)
"j" = (/obj/covers/repairedfloor/ship,/obj/item/stack/money/goldcoin,/obj/structure/closet/crate/chest,/turf/floor/beach/water/deep/saltwater,/area/caribbean/pirates/ship/office)
"l" = (/obj/structure/barricade/ship/wood/port0,/obj/covers/repairedfloor/ship,/turf/floor/beach/water/deep/saltwater,/area/caribbean/pirates/ship/main_deck)
"m" = (/obj/structure/barricade/ship/wood/port2,/obj/covers/repairedfloor/ship/south,/mob/living/simple_animal/hostile/pirate,/turf/floor/beach/water/deep/saltwater,/area/caribbean/pirates/ship/main_deck)
"o" = (/obj/structure/barricade/ship/wood/a3,/obj/covers/repairedfloor/ship,/turf/floor/beach/water/deep/saltwater,/area/caribbean/pirates/ship/office)
"p" = (/obj/structure/barricade/ship/wood/port0,/obj/covers/repairedfloor/ship/south,/turf/floor/beach/water/deep/saltwater,/area/caribbean/pirates/ship/main_deck)
"s" = (/obj/structure/flag/pirates,/obj/covers/repairedfloor/ship,/turf/floor/beach/water/deep/saltwater,/area/caribbean/pirates/ship/main_deck)
"t" = (/obj/structure/barricade/ship/blue/bport0,/obj/covers/repairedfloor/ship,/turf/floor/beach/water/deep/saltwater,/area/caribbean/pirates/ship/main_deck)
"u" = (/obj/covers/repairedfloor/ship,/obj/item/stack/money/goldvaluables,/obj/item/stack/money/goldvaluables,/obj/structure/closet/crate/chest,/turf/floor/beach/water/deep/saltwater,/area/caribbean/pirates/ship/office)
"v" = (/obj/covers/repairedfloor/ship,/obj/structure/grapplehook{owner = "PIRATES"},/turf/floor/beach/water/deep/saltwater,/area/caribbean/pirates/ship/main_deck)
"w" = (/obj/structure/barricade/ship/blue/bport3,/obj/structure/cannon,/obj/covers/repairedfloor/ship,/turf/floor/beach/water/deep/saltwater,/area/caribbean/pirates/ship/main_deck)
"x" = (/obj/structure/barricade/ship/wood/port2,/obj/covers/repairedfloor/ship/south,/turf/floor/beach/water/deep/saltwater,/area/caribbean/pirates/ship/main_deck)
"y" = (/obj/structure/barricade/ship/wood/a5,/obj/covers/repairedfloor/ship,/turf/floor/beach/water/deep/saltwater,/area/caribbean/pirates/ship/office)
"z" = (/obj/covers/repairedfloor/ship,/obj/structure/cannon{dir = 1},/turf/floor/beach/water/deep/saltwater,/area/caribbean/pirates/ship/main_deck)
"A" = (/obj/structure/barricade/ship/blue/b17,/obj/covers/repairedfloor/ship,/obj/structure/barricade/ship/blue/b15,/turf/floor/beach/water/deep/saltwater,/area/caribbean/pirates/ship/office)
"B" = (/obj/structure/barricade/ship/wood/a9,/obj/covers/repairedfloor/ship,/turf/floor/beach/water/deep/saltwater,/area/caribbean/pirates/ship/office)
"C" = (/obj/covers/repairedfloor/ship,/obj/structure/closet/crate/rations/fruits,/turf/floor/beach/water/deep/saltwater,/area/caribbean/pirates/ship/office)
"D" = (/obj/structure/barricade/ship/mast,/obj/covers/repairedfloor/ship,/turf/floor/beach/water/deep/saltwater,/area/caribbean/pirates/ship/main_deck)
"E" = (/obj/structure/barricade/ship/blue/b10,/obj/covers/repairedfloor/ship,/turf/floor/beach/water/deep/saltwater,/area/caribbean/pirates/ship/office)
"F" = (/obj/structure/barricade/ship/blue/bport3,/obj/covers/repairedfloor/ship,/turf/floor/beach/water/deep/saltwater,/area/caribbean/pirates/ship/main_deck)
"G" = (/obj/structure/barricade/ship/wood/a12,/obj/covers/repairedfloor/ship,/turf/floor/beach/water/deep/saltwater,/area/caribbean/pirates/ship/office)
"I" = (/obj/structure/barricade/ship/wood/a1,/obj/covers/repairedfloor/ship,/turf/floor/beach/water/deep/saltwater,/area/caribbean/pirates/ship/office)
"K" = (/obj/structure/barricade/ship/wood/a4,/obj/covers/repairedfloor/ship,/obj/structure/barricade/ship/blue/b1,/turf/floor/beach/water/deep/saltwater,/area/caribbean/pirates/ship/office)
"L" = (/obj/covers/repairedfloor/ship,/mob/living/simple_animal/hostile/human/pirate/ranged,/turf/floor/beach/water/deep/saltwater,/area/caribbean/pirates/ship/main_deck)
"M" = (/obj/structure/barricade/ship/blue/b8,/obj/covers/repairedfloor/ship,/obj/covers/repairedfloor/ship,/turf/floor/beach/water/deep/saltwater,/area/caribbean/pirates/ship/office)
"O" = (/obj/covers/repairedfloor/ship,/obj/structure/closet/crate/rations/ale,/turf/floor/beach/water/deep/saltwater,/area/caribbean/pirates/ship/office)
"P" = (/obj/structure/barricade/ship/blue/b19,/obj/covers/repairedfloor/ship,/turf/floor/beach/water/deep/saltwater,/area/caribbean/pirates/ship/office)
"Q" = (/obj/structure/barricade/ship/wood/a7,/obj/covers/repairedfloor/ship,/turf/floor/beach/water/deep/saltwater,/area/caribbean/pirates/ship/office)
"S" = (/obj/covers/repairedfloor/ship,/obj/item/stack/money/goldvaluables,/obj/structure/closet/crate/chest,/turf/floor/beach/water/deep/saltwater,/area/caribbean/pirates/ship/office)
"U" = (/obj/structure/simple_door/key_door/anyone/wood,/obj/covers/repairedfloor/ship,/turf/floor/beach/water/deep/saltwater,/area/caribbean/pirates/ship/office)
"V" = (/obj/covers/repairedfloor/ship,/turf/floor/beach/water/deep/saltwater,/area/caribbean/pirates/ship/main_deck)
"W" = (/turf/wall/wood,/area/caribbean/pirates/ship/office)
"X" = (/obj/structure/barricade/ship/wood/a2,/obj/covers/repairedfloor/ship,/turf/floor/beach/water/deep/saltwater,/area/caribbean/pirates/ship/office)
"Y" = (/obj/structure/barricade/ship/blue/b16,/obj/covers/repairedfloor/ship,/turf/floor/beach/water/deep/saltwater,/area/caribbean/pirates/ship/office)
"Z" = (/obj/structure/barricade/ship/blue/b18,/obj/covers/repairedfloor/ship,/turf/floor/beach/water/deep/saltwater,/area/caribbean/pirates/ship/office)

(1,1,1) = {"
aaaaaaaaaaaaaaaaaaaaaaaaaaaaaaaaaaaaaaaaaaaaaaaaaaaaaaaaaaaaaaaaaaaaaaaaaaa
aaaaaaaaaaaaaaaaaaaaaaaaaaaaaaaaaaaaaaaaaaaaaaaaaaaaaaaaaaaaaaaaaaaaaaaaaaa
aaaaaaaaaaaaaaaaaaaaaaaaaaaaaaaaaaaaaaaaaaaaaaaaaaaaaaaaaaaaaaaaaaaaaaaaaaa
aaaaaaaaaaaaaaaaaaaaaaaaaaaaaaaaaaaaaaaaaaaaaaaaaaaaaaaaaaaaaaaaaaaaaaaaaaa
aaaaaaaaaaaaaaaaaaaaaaaaaaaaaaaaaaaaaaaaaaaaaaaaaaaaaaaaaaaaaaaaaaaaaaaaaaa
aaaaaaaaaaaaaaaaaaaaaaaaaaaaaaaaaaaaaaaaaaaaaaaaaaaaaaaaaaaaaaaaaaaaaaaaaaa
aaaaaaaaaaaaaaaaaaaaaaaaaaaaaaaaaaaaaaaaaaaaaaaaaaaaaaaaaaaaaaaaaaaaaaaaaaa
aaaaaaaaaaaaaaaaaaaaaaaaaaaaaaaaaaaaaaaaaaaaaaaaaaaaaaaaaaaaaaaaaaaaaaaaaaa
aaaaaaaaaaaaaaaaaaaaaaaaaaaaaaaaaaaaaaaaaaaaaaaaaaaaaaaaaaaaaaaaaaaaaaaaaaa
aaaaaaaaaaaaaaaaaaaaaaaaaaaaaaaaaaaaaaaaaaaaaaaaaaaaaaaaaaaaaaaaaaaaaaaaaaa
aaaaaaaaaaaaaaaaaaaaaaaaaaaaaaaaaaaaaaaaaaaaaaaaaaaaaaaaaaaaaaaaaaaaaaaaaaa
aaaaaaaaaaaaaaaaaaaaaaaaaaaaaaaaaaaaaaaaaaaaaaaaaaaaaaaaaaaaaaaaaaaaaaaaaaa
aaaaaaaaaaaaaaaaaaaaaaaaaaaaaaaaaaaaaaaaaaaaaaaaaaaaaaaaaaaaaaaaaaaaaaaaaaa
aaaaaaaaaaaaaaaaaaaaaaaaaaaaaaaaaaaaaaaaaaaaaaaaaaaaaaaaaaaaaaaaaaaaaaaaaaa
aaaaaaaaaaaaaaaaaaaaaaaaaaaaaaaaaaaaaaaaaaaaaaaaaaaaaaaaaaaaaaaaaaaaaaaaaaa
aaaaaaaaaaaaaaaaaaaaaaaaaaaaaaaaaaaaaaaaaaaaaaaaaaaaaaaaaaaaaaaaaaaaaaaaaaa
aaaaaaaaaaaaaaaaaaaaaaaaaaaaaaaaaaaaaaaaaaaaaaaaaaaaaaaaaaaaaaaaaaaaaaaaaaa
aaaaaaaaaaaaaaaaaaaaaaaaaaaaaaaaaaaaaaaaaaaaaaaaaaaaaaaaaaaaaaaaaaaaaaaaaaa
aaaaaaaaaaaaaaaaaaaaaaaaaaaaaaaaaaaaaaaaaaaaaaaaaaaaaaaaaaaaaaaaaaaaaaaaaaa
aaaaaaaaaaaaaaaaaaaaaaaaaaaaaaaaaaaaaaaaaaaaaaaaaaaaaaaaaaaaaaaaaaaaaaaaaaa
aaaaaaaaaaaaaaaaaaaaaaaaaaaaaaaaaaaaaaaaaaaaaaaaaaaaaaaaaaaaaaaaaaaaaaaaaaa
aaaaaaaaaaaaaaaaaaaaaaaaaaaaaaaaaaaaaaaaaaaaaaaaaaaaaaaaaaaaaaaaaaaaaaaaaaa
aaaaaaaaaaaaaaaaaaaaaaaaaaaaaaaaaaaaaaaaaaaaaaaaaaaaaaaaaaaaaaaaaaaaaaaaaaa
aaaaaaaaaaaaaaaaaaaaaaaaaaaaaaaaaaaaaaaaaaaaaaaaaaaaaaaaaaaaaaaaaaaaaaaaaaa
aaaaaaaaaaaaaaaaaaaaaaaaaaaaaaaaaaaaaaaaaaaaaaaaaaaaaaaaaaaaaaaaaaaaaaaaaaa
"}
(1,1,2) = {"
aaaaaaaaaaaaaaaaaaaaaaaaaaaaaaaaaaaaaaaaaaaaaaaaaaaaaaaaaaaaaaaaaaaaaaaaaaa
aaaaaaaaaaaaaaaaaaaaaaaaaaaaaaaaaaaaaaaaaaaaaaaaaaaaaaaaaaaaaaaaaaaaaaaaaaa
aaaaaaaaaaaaaaaaaaaaaaaaaaaaaaaaaaaaaaaaaaaaaaaaaaaaaaaaaaaaaaaaaaaaaaaaaaa
aaaaaaaaaaaaaaaaaaaaaaaaaaaaaaaaaaaaaaaaaaaaaaaaaaaaaaaaaaaaaaaaaaaaaaaaaaa
aaaaaaaaaaaaaaaaaaaaaaaaaaaaaaaaaaaaaaaaaaaaaaaaaaaaaaaaaaaaaaaaaaaaaaaaaaa
aaaaaaaaaaaaaaaaaaaaaaaaaaaaaaaaaaaaaaaaaaaaaaaaaaaaaaaaaaaaaaaaaaaaaaaaaaa
aaaaaaaaaaaaaaaaaaaaaaaaaaaaaaaaaaaaaaaaaaaaaaaaaaaaaaaaaaaaaaaaaaaaaaaaaaa
aaaaaaaaaaaaaaaaaaaaaaaaaaaaaaaaaaaaaaaaaaaaaaaaaaaaaaaaaaaaaaaaaaaaaaaaaaa
aaaaaaaaaaaaaaaaaaaaaaaaaaaaaaaaaaaaaaaaaaaaaaaaaaaaaaaaaaaaaaaaaaaaaaaaaaa
aaaaaaaaaaaaaaaaaaaaaaaaaaaaaaaaaaaaaaaaaaaaaaaaaaaaaaaaaaaaaaaaaaaaaaaaaaa
aaaaaaaaaaaaaaaaaaaaaaaaaaaaaaaaaaaaaaaaaaaaaaaaaaaaaaaaaaaaaaaaaaaaaaaaaaa
aaaaaaaaaaaaaaaaaaaaaaaaaaaaaaaaaaaaaaaaaaaaaaaaaaaaaaaaaaaaaaaaaaaaaaaaaaa
aaaaaaaaaaaaaaaaaaaaaaaaaaaaaaaaaaaaaaaaaaaaaaaaaaaaaaaaaaaaaaaaaaaaaaaaaaa
aaaaaaaaaaaaaaaaaaaaaaaaaaaaaaaaaaaaaaaaaaaaaaaaaaaaaaaaaaaaaaaaaaaaaaaaaaa
aaaaaaaaaaaaaaaaaaaaaaaaaaaaaaaaaaaaaaaaaaaaaaaaaaaaaaaaaaaaaaaaaaaaaaaaaaa
aaaaaaaaaaaaaaaaaaaaaaaaaaaaaaaaaaaaaaaaaaaaaaaaaaaaaaaaaaaaaaaaaaaaaaaaaaa
aaaaaaaaaaaaaaaaaKQQQQBaaaaaaaaaaaaaaaaaaaaaaaaaaaaaaaaaaaaaaaaaaaaaaaaaaaa
aaaaaaaaaaaaaaaaafeeeeGxlmlxpxlxlxlxlxlxlxloQQQBaaaaaaaaaaaaaaaaaaaaaaaaaaa
aaaaaaaaaaaaaaaaafCeeeGVVVVzVvVVVzvVgVgzvVgXeeeyBaaaaaaaaaaaaaaaaaaaaaaaaaa
aaaaaaaaaaaaaaaaafOeeehVVVVVVVLVVVVVVVVVVVVXeeeehWaaaaaaaaaaaaaaaaaaaaaaaaa
aaaaaaaaaaaaaaaaafeeeeUVVDVVVsVVgVVVDVVVVVVUeeeehWWWaaaaaaaaaaaaaaaaaaaaaaa
aaaaaaaaaaaaaaaaafeeeehVVVVVVVVVVVVVVVVLVVVXeeeehWaaaaaaaaaaaaaaaaaaaaaaaaa
aaaaaaaaaaaaaaaaafSeeehVVgVVLvVgVVvVVVVVvVgIeeeZEaaaaaaaaaaaaaaaaaaaaaaaaaa
aaaaaaaaaaaaaaaaafSujehFtFtwtFtFtwtFtFtwtFtYbbbPaaaaaaaaaaaaaaaaaaaaaaaaaaa
aaaaaaaaaaaaaaaaaAbbbbMaaaaaaaaaaaaaaaaaaaaaaaaaaaaaaaaaaaaaaaaaaaaaaaaaaaa
"}
