"aa" = (/turf/floor/beach/water/deep/saltwater,/area/caribbean/sea/top)
"ab" = (/turf/floor/dirt/underground,/area/caribbean/void/caves/special)
"ac" = (/obj/effect/landmark{name = "Grappling Hook area - do not block"},/turf/floor/beach/water/deep/saltwater,/area/caribbean/sea/top)
"ad" = (/turf/floor/beach/sand,/area/caribbean/sea/top)
"ae" = (/obj/covers/wood_wall/adjustable,/turf/floor/beach/sand,/area/caribbean/roofed)
"af" = (/obj/covers/wood,/turf/floor/beach/sand,/area/caribbean/roofed)
"ag" = (/obj/covers/wood,/obj/covers/wood_wall/adjustable,/turf/floor/beach/sand,/area/caribbean/roofed)
"ah" = (/obj/covers/wood,/obj/structure/bed/wood,/turf/floor/beach/sand,/area/caribbean/roofed)
"ai" = (/turf/floor/beach/sand/dark,/area/caribbean/sea/top)
"aj" = (/obj/covers/wood,/obj/item/weapon/reagent_containers/glass/barrel/rum,/turf/floor/beach/sand,/area/caribbean/roofed)
"ak" = (/obj/covers/wood,/obj/item/weapon/reagent_containers/food/drinks/bottle/rum,/obj/item/weapon/reagent_containers/food/drinks/bottle/rum,/obj/item/weapon/reagent_containers/food/drinks/bottle/rum,/obj/item/weapon/reagent_containers/food/drinks/bottle/rum,/obj/item/weapon/reagent_containers/food/drinks/bottle/rum,/obj/item/weapon/reagent_containers/food/drinks/bottle/rum,/obj/item/weapon/reagent_containers/food/drinks/bottle/rum,/obj/item/weapon/reagent_containers/food/drinks/bottle/rum,/obj/item/weapon/reagent_containers/food/drinks/bottle/rum,/obj/item/weapon/reagent_containers/food/drinks/bottle/rum,/obj/item/weapon/reagent_containers/food/drinks/bottle/rum,/obj/item/weapon/reagent_containers/food/drinks/bottle/rum,/obj/item/weapon/reagent_containers/food/drinks/bottle/rum,/obj/item/weapon/reagent_containers/food/drinks/bottle/rum,/obj/item/weapon/reagent_containers/food/drinks/bottle/rum,/obj/structure/closet/cabinet,/turf/floor/beach/sand,/area/caribbean/roofed)
"al" = (/obj/covers/wood,/obj/structure/closet/cabinet,/obj/item/weapon/reagent_containers/food/drinks/bottle/small/beer,/obj/item/weapon/reagent_containers/food/drinks/bottle/small/beer,/obj/item/weapon/reagent_containers/food/drinks/bottle/small/beer,/obj/item/weapon/reagent_containers/food/drinks/bottle/small/beer,/obj/item/weapon/reagent_containers/food/drinks/bottle/small/beer,/obj/item/weapon/reagent_containers/food/drinks/bottle/small/beer,/obj/item/weapon/reagent_containers/food/drinks/bottle/small/beer,/obj/item/weapon/reagent_containers/food/drinks/bottle/small/beer,/obj/item/weapon/reagent_containers/food/drinks/bottle/small/beer,/obj/item/weapon/reagent_containers/food/drinks/bottle/small/beer,/obj/item/weapon/reagent_containers/food/drinks/bottle/small/beer,/obj/item/weapon/reagent_containers/food/drinks/bottle/small/beer,/obj/item/weapon/reagent_containers/food/drinks/bottle/small/beer,/obj/item/weapon/reagent_containers/food/drinks/bottle/small/beer,/turf/floor/beach/sand,/area/caribbean/roofed)
"am" = (/obj/covers/wood,/obj/structure/table/wood,/obj/item/weapon/reagent_containers/food/drinks/drinkingglass/wood,/turf/floor/beach/sand,/area/caribbean/roofed)
"an" = (/obj/covers/wood,/obj/item/weapon/stool/wood,/turf/floor/beach/sand,/area/caribbean/roofed)
"ao" = (/obj/covers/wood,/obj/structure/bed/chair/wood{icon_state = "wooden_chair"; dir = 4},/turf/floor/beach/sand,/area/caribbean/roofed)
"ap" = (/obj/covers/wood_ship,/turf/floor/beach/sand,/area/caribbean/sea/top)
"aq" = (/obj/covers/wood,/obj/structure/table/wood,/obj/item/weapon/reagent_containers/food/drinks/bottle/rum,/turf/floor/beach/sand,/area/caribbean/roofed)
"ar" = (/turf/floor/beach/water/shallowsaltwater,/area/caribbean/sea/top)
"as" = (/obj/covers/wood_ship,/turf/floor/beach/water/shallowsaltwater,/area/caribbean/sea/top)
"at" = (/obj/effect/landmark{name = "Grappling Hook area - do not block"},/obj/covers/wood_ship,/turf/floor/beach/water/shallowsaltwater,/area/caribbean/sea/top)
"au" = (/obj/effect/landmark{name = "Grappling Hook area - do not block"},/obj/covers/wood_ship,/turf/floor/beach/water/deep/saltwater,/area/caribbean/sea/top)
"av" = (/obj/covers/wood_ship,/turf/floor/beach/water/deep/saltwater,/area/caribbean/sea/top)
"aw" = (/obj/covers/wood,/obj/structure/bed/chair/wood{icon_state = "wooden_chair"; dir = 8},/turf/floor/beach/sand,/area/caribbean/roofed)
"ax" = (/obj/covers/wood,/obj/structure/table/wood,/turf/floor/beach/sand,/area/caribbean/roofed)
"ay" = (/obj/covers/wood,/obj/structure/simple_door/key_door/anyone,/turf/floor/beach/sand,/area/caribbean/roofed)
"az" = (/obj/covers/wood,/obj/structure/toilet/pit_latrine,/turf/floor/beach/sand,/area/caribbean/roofed)
"aA" = (/obj/covers/wood,/obj/structure/bed/chair/wood{icon_state = "wooden_chair"; dir = 4},/mob/living/simple_animal/hostile/human/pirate/friendly,/turf/floor/beach/sand,/area/caribbean/roofed)
"aB" = (/obj/covers/wood,/mob/living/simple_animal/hostile/human/pirate/friendly,/turf/floor/beach/sand,/area/caribbean/roofed)
"aC" = (/obj/covers/wood,/turf/floor/beach/sand/dark,/area/caribbean/roofed)
"aD" = (/obj/covers/wood,/obj/covers/wood_wall/adjustable,/turf/floor/beach/sand/dark,/area/caribbean/roofed)
"aE" = (/obj/covers/wood,/obj/structure/bed/wood,/turf/floor/beach/sand/dark,/area/caribbean/roofed)
"aF" = (/obj/covers/wood,/obj/structure/bed/chair/wood{icon_state = "wooden_chair"; dir = 8},/mob/living/simple_animal/hostile/human/pirate/friendly,/turf/floor/beach/sand,/area/caribbean/roofed)
"aG" = (/obj/covers/wood,/obj/structure/simple_door/key_door/anyone,/turf/floor/beach/sand/dark,/area/caribbean/roofed)
"aH" = (/obj/covers/wood,/obj/item/weapon/reagent_containers/food/drinks/bottle/small/healing/vigorous,/obj/structure/closet/cabinet,/mob/living/simple_animal/hostile/human/british/ranged,/turf/floor/beach/sand,/area/caribbean/roofed)
"aI" = (/obj/covers/wood,/obj/structure/window/classic/reinforced,/turf/floor/beach/sand,/area/caribbean/roofed)
"aJ" = (/obj/covers/wood,/mob/living/simple_animal/hostile/human/pirate/friendly,/turf/floor/beach/sand/dark,/area/caribbean/roofed)
"aK" = (/obj/covers/wood,/obj/structure/bed/chair/wood,/mob/living/simple_animal/hostile/human/pirate/friendly,/turf/floor/beach/sand,/area/caribbean/roofed)
"aL" = (/obj/covers/wood,/obj/structure/bed/chair/wood{icon_state = "wooden_chair"; dir = 8},/mob/living/simple_animal/hostile/human/pirate/friendly/captain,/turf/floor/beach/sand,/area/caribbean/roofed)
"aM" = (/mob/living/simple_animal/hostile/human/pirate/friendly,/turf/floor/beach/sand/dark,/area/caribbean/roofed)
"aN" = (/obj/covers/wood_wall/nordic,/turf/floor/beach/sand,/area/caribbean/roofed)
"aO" = (/obj/covers/wood,/obj/structure/bed/chair/wood,/turf/floor/beach/sand,/area/caribbean/roofed)
"aP" = (/obj/structure/exportbook{faction = "pirates"; faction_treasury = "TreasuryPR"},/turf/floor/beach/sand/dark,/area/caribbean/roofed)
"aQ" = (/obj/structure/supplybook{faction = "pirates"; faction_treasury = "TreasuryPR"; factionarea = "SupplyPR"},/turf/floor/beach/sand/dark,/area/caribbean/roofed)
"aR" = (/turf/floor/beach/sand/dark,/area/caribbean/roofed)
"aS" = (/obj/covers/wood,/obj/structure/closet/cabinet,/turf/floor/beach/sand,/area/caribbean/roofed)
"aT" = (/obj/covers/wood,/obj/structure/window/classic/reinforced,/turf/floor/beach/sand/dark,/area/caribbean/roofed)
"aU" = (/obj/structure/window/classic/reinforced,/obj/covers/wood,/turf/floor/beach/sand,/area/caribbean/roofed)
"aV" = (/obj/covers/wood,/obj/covers/saloon_door,/turf/floor/beach/sand,/area/caribbean/roofed)
"aW" = (/obj/structure/table/wood,/turf/floor/beach/sand/dark,/area/caribbean/roofed)
"aX" = (/obj/covers/saloon_door,/turf/floor/beach/sand/dark,/area/caribbean/roofed)
"aY" = (/mob/living/simple_animal/hostile/human/pirate/friendly/blindman,/turf/floor/beach/sand,/area/caribbean/sea/top)
"aZ" = (/obj/covers/cobblestone/stairs{icon_state = "rampup"; dir = 1},/turf/floor/beach/sand,/area/caribbean/sea/top)
"ba" = (/obj/covers/cobblestone/stairs{icon_state = "rampup"; dir = 1},/turf/floor/beach/sand/dark,/area/caribbean/sea/top)
"bb" = (/obj/structure/toilet/outhouse/female,/turf/floor/beach/sand/dark,/area/caribbean/sea/top)
"bc" = (/obj/structure/toilet/outhouse/male,/turf/floor/beach/sand/dark,/area/caribbean/sea/top)
"bd" = (/obj/covers/cobblestone,/turf/floor/beach/sand/dark,/area/caribbean/roofed)
"be" = (/obj/structure/sink/well,/obj/structure/mine_support,/turf/floor/beach/sand/dark,/area/caribbean/roofed)
"bf" = (/obj/covers/cobblestone,/obj/structure/repair/grindstone,/turf/floor/beach/sand/dark,/area/caribbean/roofed)
"bg" = (/obj/covers/cobblestone,/obj/structure/repair/gun,/turf/floor/beach/sand/dark,/area/caribbean/roofed)
"bh" = (/obj/covers/cobblestone,/obj/item/weapon/clay/mold/clayjug/fired,/turf/floor/beach/sand/dark,/area/caribbean/roofed)
"bi" = (/obj/covers/cobblestone,/obj/structure/table/wood,/obj/item/weapon/clay/mold/axehead/fired,/obj/item/weapon/clay/mold/shovel/fired,/obj/item/weapon/clay/mold/sword/fired,/obj/item/stack/material/copper{amount = 250},/turf/floor/beach/sand/dark,/area/caribbean/roofed)
"bj" = (/obj/covers/cobblestone,/obj/structure/table/wood,/obj/item/weapon/clay/mold/pickaxe/fired,/obj/item/stack/material/iron/twentyfive,/obj/item/stack/material/iron/twentyfive,/obj/item/stack/material/iron/twentyfive,/obj/item/stack/material/iron/twentyfive,/obj/item/stack/material/iron/twentyfive,/obj/item/stack/material/iron/twentyfive,/obj/item/stack/material/iron/twentyfive,/obj/item/stack/material/iron/twentyfive,/obj/item/stack/material/iron/twentyfive,/obj/item/stack/material/iron/twentyfive,/turf/floor/beach/sand/dark,/area/caribbean/roofed)
"bk" = (/obj/covers/cobblestone,/obj/structure/table/wood,/obj/item/weapon/clay/mold/fired,/obj/item/weapon/clay/mold/knife/fired,/obj/item/stack/material/steel/twentyfive,/obj/item/stack/material/steel/twentyfive,/obj/item/stack/material/steel/twentyfive,/obj/item/stack/material/steel/twentyfive,/obj/item/stack/material/steel/twentyfive,/obj/item/stack/material/steel/twentyfive,/obj/item/stack/material/steel/twentyfive,/obj/item/stack/material/steel/twentyfive,/obj/item/stack/material/steel/twentyfive,/obj/item/stack/material/steel/twentyfive,/turf/floor/beach/sand/dark,/area/caribbean/roofed)
"bl" = (/obj/covers/cobblestone,/obj/structure/furnace/kiln,/turf/floor/beach/sand/dark,/area/caribbean/roofed)
"bm" = (/obj/covers/cobblestone,/obj/structure/furnace/blast_furnace,/turf/floor/beach/sand/dark,/area/caribbean/roofed)
"bn" = (/obj/covers/cobblestone,/obj/structure/furnace,/turf/floor/beach/sand/dark,/area/caribbean/roofed)
"bo" = (/obj/covers/cobblestone,/obj/structure/anvil/steel,/turf/floor/beach/sand/dark,/area/caribbean/roofed)
"bp" = (/obj/covers/wood,/obj/structure/oven,/turf/floor/beach/sand,/area/caribbean/roofed)
"bq" = (/obj/covers/wood,/obj/structure/pot,/turf/floor/beach/sand,/area/caribbean/roofed)
"br" = (/obj/covers/wood,/obj/covers/wood_wall/adjustable,/obj/item/flashlight/lantern/on/anchored,/turf/floor/beach/sand,/area/caribbean/roofed)
"bs" = (/obj/covers/wood,/obj/structure/table/wood,/turf/floor/beach/sand/dark,/area/caribbean/roofed)
"bt" = (/obj/covers/wood,/obj/structure/table/wood,/obj/item/weapon/pen,/obj/item/weapon/paper,/turf/floor/beach/sand/dark,/area/caribbean/roofed)
"bu" = (/obj/covers/wood_wall/adjustable,/obj/item/flashlight/lantern/on/anchored,/turf/floor/beach/sand,/area/caribbean/roofed)
"bv" = (/obj/covers/wood,/obj/structure/bed/chair/wood{icon_state = "wooden_chair"; dir = 1},/turf/floor/beach/sand/dark,/area/caribbean/roofed)
"bw" = (/mob/living/simple_animal/hostile/human/pirate/friendly,/turf/floor/beach/sand,/area/caribbean/sea/top)
"bx" = (/obj/covers/wood,/obj/item/flashlight/lantern/on/anchored{pixel_x = 0; pixel_y = 10},/obj/structure/barricade/wood_pole,/turf/floor/beach/sand,/area/caribbean/roofed)
"by" = (/obj/covers/wood,/obj/structure/barricade/wood_pole,/obj/item/flashlight/lantern/on/anchored{pixel_x = 0; pixel_y = 10},/turf/floor/beach/sand,/area/caribbean/roofed)
"bz" = (/obj/covers/wood,/obj/covers/wood_wall/adjustable,/obj/item/flashlight/lantern/on/anchored,/turf/floor/beach/sand/dark,/area/caribbean/roofed)
"bA" = (/obj/covers/cobblestone,/mob/living/simple_animal/hostile/human/pirate/friendly,/turf/floor/beach/sand/dark,/area/caribbean/roofed)
"bC" = (/obj/covers/wood_wall/nordic,/obj/item/flashlight/lantern/on/anchored,/turf/floor/beach/sand,/area/caribbean/roofed)
"bD" = (/obj/covers/wood,/obj/structure/pot,/turf/floor/beach/sand/dark,/area/caribbean/roofed)
"bE" = (/obj/covers/wood,/obj/structure/table/wood,/obj/structure/mill,/turf/floor/beach/sand/dark,/area/caribbean/roofed)
"bF" = (/obj/covers/wood,/obj/structure/oven,/turf/floor/beach/sand/dark,/area/caribbean/roofed)
"bG" = (/obj/map_metadata/voyage,/turf/floor/dirt/underground,/area/caribbean/void/caves/special)

(1,1,1) = {"
ababababababababababababababababababababababababababababababababababababababababababababababababababababababababababababababababababababababababababab
ababababababababababababababababababababababababababababababababababababababababababababababababababababababababababababababababababababababababababab
ababababababababababababababababababababababababababababababababababababababababababababababababababababababababababababababababababababababababababab
ababababababababababababababababababababababababababababababababababababababababababababababababababababababababababababababababababababababababababab
ababababababababababababababababababababababababababababababababababababababababababababababababababababababababababababababababababababababababababab
ababababababababababababababababababababababababababababababababababababababababababababababababababababababababababababababababababababababababababab
ababababababababababababababababababababababababababababababababababababababababababababababababababababababababababababababababababababababababababab
ababababababababababababababababababababababababababababababababababababababababababababababababababababababababababababababababababababababababababab
ababababababababababababababababababababababababababababababababababababababababababababababababababababababababababababababababababababababababababab
ababababababababababababababababababababababababababababababababababababababababababababababababababababababababababababababababababababababababababab
ababababababababababababababababababababababababababababababababababababababababababababababababababababababababababababababababababababababababababab
ababababababababababababababababababababababababababababababababababababababababababababababababababababababababababababababababababababababababababab
ababababababababababababababababababababababababababababababababababababababababababababababababababababababababababababababababababababababababababab
ababababababababababababababababababababababababababababababababababababababababababababababababababababababababababababababababababababababababababab
ababababababababababababababababababababababababababababababababababababababababababababababababababababababababababababababababababababababababababab
ababababababababababababababababababababababababababababababababababababababababababababababababababababababababababababababababababababababababababab
ababababababababababababababababababababababababababababababababababababababababababababababababababababababababababababababababababababababababababab
ababababababababababababababababababababababababababababababababababababababababababababababababababababababababababababababababababababababababababab
ababababababababababababababababababababababababababababababababababababababababababababababababababababababababababababababababababababababababababab
ababababababababababababababababababababababababababababababababababababababababababababababababababababababababababababababababababababababababababab
ababababababababababababababababababababababababababababababababababababababababababababababababababababababababababababababababababababababababababab
ababababababababababababababababababababababababababababababababababababababababababababababababababababababababababababababababababababababababababab
ababababababababababababababababababababababababababababababababababababababababababababababababababababababababababababababababababababababababababab
ababababababababababababababababababababababababababababababababababababababababababababababababababababababababababababababababababababababababababab
bGabababababababababababababababababababababababababababababababababababababababababababababababababababababababababababababababababababababababababab
"}

(1,1,2) = {"
adadadadadadadadadadadadadadadadadadadadadadadadadadadadadadadadadadadadadadadadadadadadadadadadadadadadadadadadadadadaeaeaeaeaeaeaeaeaeadadadadadadad
adaeaeaeaeaeaeaeaeaeaeaeaeaeaeaeaeadadadadadadadadadadadadadadadadadadadadadadadadadadadadadadadadadadadadadadadadadadaebpaxaxbqagahafaeadaeaeaeaeaeae
adaeajajakalafamanaAamaqawaoaxaqaeadadadadadadadadadadadadadadadadadadadadadadadadadaeaeaeaeaeaeaeaeadaeaeaeaeaeadadadaeafafafafbrafafaeadaeafayafazae
adaeafafafafaBamanaoaxamaFaoaxamaeadadadadadadadadadadadadadadadadadadadadadadadadadaebsbtbsaDaCaEaeadaebpafahaeadadadaeafafaBafagafafaeadaeafaebuaeae
adaeafamamamamamanafafafafafafafaeadadadadadadadadadadadaeaeaeaeaeaeaeaeaeaeadadadadaebsbvbsaDaCaCaeadaeafafafayadadadaeafafafafayafafaeadaeafaeafaHae
adaeafanananananafafafafafafafbxaeadadadadadadadadadadadaeafafahagbpaxaxbqaeadaiaiaiaGaCaCaCaDaJaCaeadaeafaBafbuadadadaeaebuayaeaeaIaeaeadaeafayafahae
adaeafafafafafafafbyafafafafafafaeadadaNaNaNaNaNaNaNaNadaeafafafagafafafafaeadaiaiaiaeaCaCaCaDbzaGaeadaeaeaeaeaeadadadadadaiaiaiaiaiadadadaeafaebuaeae
adaeafafafafafafafafafafafafaOaKaeadadaNaPaQaRaRaRaRaNadaeayagagbrafafafafaeaiaiaiaibuaCaCaCaCaCaCaeadaebpafafaeadadadadaiaiaiaiadadadadadaeafaeaBaSae
adaeafaoamaxawaAaxaqawafafaAamaqaeadadaNaRaRaRaRaRaRaNadaeafafafafafafaBafaeaiaiaiadaTaCaCaJaCaCaCaeadaeafaBafayadadadadaiaiaiaiaiaiadadadaeafayafahae
adaeafaAaxaqaLaoamaxawafafaoaxamaeadadaNaRaRaRaMaRaRaNadaeafafafafafafafafaeaiaiaiadaTaCaCaCaCaCaCaeadaeafafafbuadadaiaiaiaiaiaiaiaiaiadadaeafaebuaeae
adaeaeaeaIaIaeaeaUaUaebuaVbuaeaeaeadadbCaWaWaWaWaWaXbCadaeaeaeaeaybuaIaIaeaeaiaiaiadaebDbsaCbsbEbFaeadaeahafafaeadaiaiaiaiaiaiaiaiaiaiaiaiaeafaeaBaSae
adafafafafafafafafafafafafafafafafadadadadaiaiaiaiadadadadadadadadadadadadadaiaiaiadaeaeaeaeaeaeaeaeadaeaeaeaeaeaiaiaiadadadadadadaiaiaiaiayafayafahae
adafafafafafafafafafafafafafafafafadadadaiaiaiaiaiaiaiaiaiaiadadadadadaiaiaiaiaiaiaiadadadadadadadadadadadadadaiaiaiaiadadadadadadadadaiaiaeafaebuaeae
adaeaeaeaeaeaeaeaeaeaiaiaiaiaiaiaiaiaiaiaiaiaiaiaiaiaiaiaiaiaiaiaiaiaiaiaiaiaiaiaiaiaiaiaiaiaiaiaiaiaiaiaiaiaiaiaiaiadaebuayaeaeaIaIaeaeadaeafaeaBaSae
adaeahafaebqaxaxbpaeaiaiaiaiaiaiaiaiaiaiadaiaiaiadadadaiaiaiaiaiaiaiaiaiadadadadaiaiaiaiaiaiaiaiaiaiaiaiaiaiaiaiaiadadaeafafafbqaxaxbpaeadaeafayafahae
adaeafafaeafafafafayaiaiaiaiaiaiaiaiadadadadaiadadadadadadadadadadadadadadadaYadadadadadadadadaZbababababababaaZadadadaeafaBafafafafafaeadaeaeaeaeaeae
adaeayaeaeafafaBafaeaiadadaibbbcaiadadadadaiaiaiadadadadapapadadadadapapadadadadadapapadadadadbubdbdbdbdbdbdbdbuadadadaeafafafagbragagaeadadadadadadad
adaeafafafafafafafaIaiadadadbbbcaiadadadadaibeaibwadadadapapadadadadapapadadadadadapapadadadadaebfbdbdbdbAbdbdaeadadadaeafafafagafafahaeadadadadadadad
araeafafafafafafafaeadadadadbbbcadadadadadaiaiaiadadadadapapadadadadapapadadadadadapapadadadadaebgbdbdbdbdbdbdaeadadadaeafafafayafafafaeadadadadadadad
araeaeaeaeaeaeaeaeaeadadadadadadadadadadadadadarararararasapadadadadapasarararararasasadadadadaebdbdbdbdbdbdbhaeadadadaeaeaeaeaeaeaeaeaeadadadadadadad
aaararararararararararararararararararararararaaararaaaratasasapapasasatasasasasasasasararadadaebibjbkblbmbnboaeadadadadadadadarararararadadadadadadad
aaaaararararaaararaaaaaraaaraaaaaraaaaararaaaaaraaaaaraaauasavasasavasauavasavasavasasaaaaaradaeaeaeaeaeaeaeaeaeadadadadarararaaararaaaaararararadadad
aaaaaaaaaaaaaraaaaaaaaaaaaaaaaaaaaararaaaaaaaaaaaaaaaaaaauavaaaaaaaravauaaaaaraaaravavararaaarararadadadadadadadadarararaaaraaaraaaaarararaaaraaararar
aaaaaaaaaaaaaaaaaaaaaaaaaaaaaaaaaaaaaaaaaaaaaaaaaaaaaaaaauavaaaaaaaaavauaaaaaaaaaaavavaaaaararaaaaararararararararaaarararaaaaaaaaaaaaaaaaaraaarararar
aaaaaaaaaaaaaaaaaaaaaaaaaaaaaaaaaaaaaaaaaaaaaaaaaaaaaaaaacaaaaaaaaaaaaacaaaaaaaaaaaaaaaaaaaaaaararaaaaaraaaraaaaaaaraaaaaaaaaaaaaaaaaaaaaaaaaaaaaaaaar
"}
