"aa" = (/turf/floor/beach/water/deep/saltwater,/area/caribbean/sea/top)
"ab" = (/obj/structure/barricade/ship/wood/a4,/turf/floor/beach/water/deep/saltwater,/area/caribbean/pirates/ship/hold)
"ac" = (/obj/structure/barricade/ship/wood/a7,/turf/floor/beach/water/deep/saltwater,/area/caribbean/pirates/ship/hold)
"ad" = (/obj/structure/barricade/ship/wood/a9,/turf/floor/beach/water/deep/saltwater,/area/caribbean/pirates/ship/hold)
"ae" = (/obj/structure/barricade/ship/wood/a7,/obj/item/flashlight/lantern/on/anchored,/turf/floor/beach/water/deep/saltwater,/area/caribbean/pirates/ship/hold)
"af" = (/obj/structure/barricade/ship/wood/a10,/obj/item/flashlight/lantern/on/anchored,/turf/floor/beach/water/deep/saltwater,/area/caribbean/pirates/ship/hold)
"ag" = (/obj/covers/wood_ship,/obj/structure/closet/crate/chest,/obj/item/stack/money/real/fifty,/turf/floor/beach/water/deep/saltwater,/area/caribbean/pirates/ship/hold)
"ah" = (/obj/structure/barricade/ship/wood/a12,/turf/floor/beach/water/deep/saltwater,/area/caribbean/pirates/ship/hold)
"ai" = (/obj/covers/wood_ship,/obj/structure/closet/crate/musketball_pistol,/turf/floor/beach/water/deep/saltwater,/area/caribbean/pirates/ship/hold)
"aj" = (/obj/covers/wood_ship,/turf/floor/beach/water/deep/saltwater,/area/caribbean/pirates/ship/hold)
"ak" = (/obj/covers/wood_ship,/obj/item/weapon/grenade/bomb,/turf/floor/beach/water/deep/saltwater,/area/caribbean/pirates/ship/hold)
"al" = (/obj/covers/wood_ship,/obj/item/weapon/reagent_containers/glass/barrel/tea,/turf/floor/beach/water/deep/saltwater,/area/caribbean/pirates/ship/hold)
"am" = (/obj/structure/barricade/ship/wood/a5,/obj/item/flashlight/lantern/on/anchored,/turf/floor/beach/water/deep/saltwater,/area/caribbean/pirates/ship/hold)
"an" = (/obj/structure/barricade/ship/wood/a2,/turf/floor/beach/water/deep/saltwater,/area/caribbean/pirates/ship/hold)
"ao" = (/obj/covers/wood_ship,/obj/structure/closet/crate/chest,/obj/item/stack/money/goldvaluables,/turf/floor/beach/water/deep/saltwater,/area/caribbean/pirates/ship/hold)
"ap" = (/obj/structure/barricade/ship/wood/a12,/obj/item/flashlight/lantern/on/anchored,/turf/floor/beach/water/deep/saltwater,/area/caribbean/pirates/ship/hold)
"aq" = (/obj/covers/wood_ship,/mob/living/simple_animal/hostile/human/voyage/spanish,/turf/floor/beach/water/deep/saltwater,/area/caribbean/pirates/ship/hold)
"ar" = (/obj/covers/wood_ship,/obj/item/weapon/reagent_containers/glass/barrel/rum,/turf/floor/beach/water/deep/saltwater,/area/caribbean/pirates/ship/hold)
"as" = (/obj/structure/barricade/ship/wood/a5,/turf/floor/beach/water/deep/saltwater,/area/caribbean/pirates/ship/hold)
"at" = (/obj/covers/wood_ship,/obj/structure/simple_door/key_door/anyone,/turf/floor/beach/water/deep/saltwater,/area/caribbean/pirates/ship/hold)
"au" = (/obj/covers/wood_ship,/obj/structure/closet/crate/cannonball/grapeshot,/turf/floor/beach/water/deep/saltwater,/area/caribbean/pirates/ship/hold)
"av" = (/obj/covers/wood_ship,/obj/structure/closet/crate/cannonball/chainshot,/turf/floor/beach/water/deep/saltwater,/area/caribbean/pirates/ship/hold)
"aw" = (/obj/covers/wood_ship,/obj/structure/closet/crate/cannonball,/turf/floor/beach/water/deep/saltwater,/area/caribbean/pirates/ship/hold)
"ax" = (/obj/covers/wood_ship,/obj/structure/closet/crate/rations/beer,/turf/floor/beach/water/deep/saltwater,/area/caribbean/pirates/ship/hold)
"ay" = (/obj/covers/wood_ship,/obj/structure/closet/crate/rations/biscuits,/turf/floor/beach/water/deep/saltwater,/area/caribbean/pirates/ship/hold)
"az" = (/obj/covers/wood_ship,/obj/structure/closet/crate/rations/fruits,/turf/floor/beach/water/deep/saltwater,/area/caribbean/pirates/ship/hold)
"aA" = (/obj/covers/wood_ship,/obj/structure/closet/crate/wood,/turf/floor/beach/water/deep/saltwater,/area/caribbean/pirates/ship/hold)
"aB" = (/obj/covers/wood_ship,/obj/structure/multiz/ladder/ww2/up,/turf/floor/beach/water/deep/saltwater,/area/caribbean/pirates/ship/hold)
"aC" = (/obj/covers/wood_ship,/mob/living/simple_animal/hostile/human/voyage/spanish/ranged,/turf/floor/beach/water/deep/saltwater,/area/caribbean/pirates/ship/hold)
"aD" = (/obj/covers/wood_ship,/obj/structure/barricade/ship/blue/bport_6/corner,/obj/structure/barricade/ship/blue/b20{dir = 1},/turf/floor/beach/water/deep/saltwater,/area/caribbean/pirates/ship/hold)
"aE" = (/obj/structure/barricade/ship/blue/b8,/turf/floor/beach/water/deep/saltwater,/area/caribbean/pirates/ship/hold)
"aF" = (/obj/structure/barricade/ship/blue/b17,/turf/floor/beach/water/deep/saltwater,/area/caribbean/pirates/ship/hold)
"aG" = (/obj/structure/barricade/ship/blue/b20,/obj/item/flashlight/lantern/on/anchored,/turf/floor/beach/water/deep/saltwater,/area/caribbean/pirates/ship/hold)
"aH" = (/obj/covers/wood_ship,/obj/structure/closet/crate/musketball,/turf/floor/beach/water/deep/saltwater,/area/caribbean/pirates/ship/hold)
"aI" = (/obj/covers/wood_ship,/obj/structure/vending/muskets/spanish,/turf/floor/beach/water/deep/saltwater,/area/caribbean/pirates/ship/hold)
"aJ" = (/obj/covers/wood_ship,/obj/item/weapon/material/sword/cutlass,/obj/item/weapon/material/sword/cutlass,/obj/item/weapon/material/sword/cutlass,/obj/item/weapon/material/sword/cutlass,/obj/item/weapon/material/sword/cutlass,/turf/floor/beach/water/deep/saltwater,/area/caribbean/pirates/ship/hold)
"aK" = (/obj/covers/wood_ship,/obj/item/weapon/reagent_containers/glass/barrel/gunpowder,/turf/floor/beach/water/deep/saltwater,/area/caribbean/pirates/ship/hold)
"aL" = (/obj/structure/barricade/ship/blue/b20{dir = 1},/obj/item/flashlight/lantern/on/anchored,/turf/floor/beach/water/deep/saltwater,/area/caribbean/pirates/ship/hold)
"aM" = (/obj/structure/barricade/ship/blue/b9,/turf/floor/beach/water/deep/saltwater,/area/caribbean/pirates/ship/hold)
"aN" = (/obj/structure/barricade/ship/blue/b9,/obj/item/flashlight/lantern/on/anchored,/turf/floor/beach/water/deep/saltwater,/area/caribbean/pirates/ship/hold)
"aO" = (/obj/map_metadata/voyage,/turf/floor/beach/water/deep/saltwater,/area/caribbean/sea/top)
"aP" = (/obj/structure/barricade/ship/wood/a4,/obj/structure/flag/spanish,/turf/floor/broken_floor,/area/caribbean/pirates/ship/office)
"aQ" = (/obj/structure/barricade/ship/wood/a7,/turf/floor/broken_floor,/area/caribbean/pirates/ship/office)
"aR" = (/obj/structure/barricade/ship/wood/a9,/turf/floor/broken_floor,/area/caribbean/pirates/ship/office)
"aS" = (/obj/covers/wood_ship,/obj/structure/barricade/ship/blue/bport_north,/turf/floor/broken_floor,/area/caribbean/pirates/ship/voyage/upper)
"aT" = (/obj/structure/barricade/ship/blue/bport3{icon_state = "boat_b_port3"; dir = 1},/obj/covers/repairedfloor/ship/south,/turf/floor/broken_floor,/area/caribbean/pirates/ship/voyage/upper)
"aU" = (/obj/structure/barricade/ship/blue/bport_north,/obj/covers/wood_ship,/turf/floor/broken_floor,/area/caribbean/pirates/ship/voyage/upper)
"aV" = (/obj/covers/wood_ship,/obj/structure/barricade/ship/blue/bport_10,/turf/floor/broken_floor,/area/caribbean/pirates/ship/voyage/upper)
"aW" = (/obj/structure/barricade/ship/wood/a4,/turf/floor/broken_floor,/area/caribbean/pirates/ship/office)
"aX" = (/obj/structure/barricade/ship/wood/a10,/obj/item/flashlight/lantern/on/anchored,/turf/floor/broken_floor,/area/caribbean/pirates/ship/office)
"aY" = (/obj/covers/wood_ship,/obj/structure/table/wood,/turf/floor/broken_floor,/area/caribbean/pirates/ship/office)
"aZ" = (/obj/covers/wood_ship,/turf/floor/broken_floor,/area/caribbean/pirates/ship/office)
"ba" = (/obj/structure/barricade/ship/wood/a12,/turf/floor/broken_floor,/area/caribbean/pirates/ship/office)
"bb" = (/obj/covers/wood_ship,/turf/floor/broken_floor,/area/caribbean/pirates/ship/voyage/upper)
"bc" = (/obj/covers/wood_ship,/obj/structure/voyage/ropeladder/thin{dir = 1},/turf/floor/broken_floor,/area/caribbean/pirates/ship/voyage/upper)
"bd" = (/obj/covers/wood_ship,/obj/structure/cannon/modern/tank/voyage/autofire{icon_state = "cannon"; dir = 1},/turf/floor/broken_floor,/area/caribbean/pirates/ship/voyage/upper)
"be" = (/obj/covers/wood_ship,/obj/structure/barricade/ship/blue/bport5/corner,/turf/floor/broken_floor,/area/caribbean/pirates/ship/voyage/upper)
"bf" = (/obj/structure/barricade/ship/wood/a2,/turf/floor/broken_floor,/area/caribbean/pirates/ship/office)
"bg" = (/obj/covers/wood_ship,/obj/structure/table/wood,/obj/item/weapon/paper,/obj/item/weapon/paper,/turf/floor/broken_floor,/area/caribbean/pirates/ship/office)
"bh" = (/obj/structure/barricade/ship/wood/a12,/obj/item/flashlight/lantern/on/anchored,/turf/floor/broken_floor,/area/caribbean/pirates/ship/office)
"bi" = (/obj/covers/wood_ship,/obj/structure/voyage/shipbell,/turf/floor/broken_floor,/area/caribbean/pirates/ship/voyage/upper)
"bj" = (/obj/covers/wood_ship,/mob/living/simple_animal/hostile/human/voyage/spanish,/turf/floor/broken_floor,/area/caribbean/pirates/ship/voyage/upper)
"bk" = (/obj/covers/wood_ship,/obj/structure/bed/chair/wood/red{dir = 4},/mob/living/simple_animal/hostile/human/voyage/spanish/ranged/sgt,/turf/floor/broken_floor,/area/caribbean/pirates/ship/office)
"bl" = (/obj/covers/wood_ship,/obj/structure/table/wood,/obj/item/weapon/pen,/obj/item/weapon/paper,/turf/floor/broken_floor,/area/caribbean/pirates/ship/office)
"bm" = (/obj/covers/wood_ship,/obj/structure/simple_door/key_door/anyone,/turf/floor/broken_floor,/area/caribbean/pirates/ship/office)
"bn" = (/obj/covers/wood_ship,/mob/living/simple_animal/hostile/human/voyage/spanish/ranged,/turf/floor/broken_floor,/area/caribbean/pirates/ship/voyage/upper)
"bo" = (/obj/covers/wood_ship,/obj/structure/barricade/ship/mast/large,/obj/item/flashlight/lantern/on/anchored,/turf/floor/broken_floor,/area/caribbean/pirates/ship/voyage/upper)
"bp" = (/obj/covers/wood_ship,/obj/structure/barricade/ship/blue/bport_6/corner,/turf/floor/broken_floor,/area/caribbean/pirates/ship/voyage/upper)
"bq" = (/obj/covers/wood_ship,/obj/structure/barricade/ship/blue/bport0/south,/turf/floor/broken_floor,/area/caribbean/pirates/ship/voyage/upper)
"br" = (/obj/covers/wood_ship,/obj/structure/barricade/ship/blue/bport9,/turf/floor/broken_floor,/area/caribbean/pirates/ship/voyage/upper)
"bs" = (/obj/covers/wood_ship,/obj/structure/multiz/ladder/ww2,/turf/floor/broken_floor,/area/caribbean/pirates/ship/voyage/upper)
"bt" = (/obj/structure/barricade/ship/blue/b17,/turf/floor/broken_floor,/area/caribbean/pirates/ship/office)
"bu" = (/obj/structure/barricade/ship/blue/b20,/obj/item/flashlight/lantern/on/anchored,/turf/floor/broken_floor,/area/caribbean/pirates/ship/office)
"bv" = (/obj/covers/wood_ship,/obj/structure/bed/padded,/obj/item/weapon/bedsheet/brown,/turf/floor/broken_floor,/area/caribbean/pirates/ship/office)
"bw" = (/obj/covers/wood_ship,/obj/structure/closet/cabinet,/obj/item/weapon/gun/projectile/flintlock/duellingpistol,/obj/item/ammo_casing/musketball_pistol,/turf/floor/broken_floor,/area/caribbean/pirates/ship/office)
"bx" = (/obj/structure/barricade/ship/blue/b17,/obj/structure/flag/spanish,/turf/floor/broken_floor,/area/caribbean/pirates/ship/office)
"by" = (/obj/structure/barricade/ship/blue/b9,/turf/floor/broken_floor,/area/caribbean/pirates/ship/office)
"bz" = (/obj/structure/barricade/ship/blue/b8,/turf/floor/broken_floor,/area/caribbean/pirates/ship/office)
"bA" = (/obj/structure/barricade/ship/blue/bport0/south,/obj/covers/wood_ship,/turf/floor/broken_floor,/area/caribbean/pirates/ship/voyage/upper)
"bB" = (/obj/covers/wood_ship,/obj/structure/barricade/ship/blue/bport0/south,/obj/structure/voyage/ropeladder/thin,/turf/floor/broken_floor,/area/caribbean/pirates/ship/voyage/upper)
"bC" = (/obj/covers/wood_ship,/obj/structure/barricade/ship/blue/bport3,/obj/structure/cannon/modern/tank/voyage/autofire,/turf/floor/broken_floor,/area/caribbean/pirates/ship/voyage/upper)
"bD" = (/obj/effect/landmark{name = "Grappling Hook area - do not block"},/turf/floor/beach/water/deep/saltwater,/area/caribbean/sea/top)
"bE" = (/obj/covers/wood_ship,/obj/structure/voyage/grid/partial{dir = 6},/turf/floor/broken_floor,/area/caribbean/pirates/ship/voyage/upper)
"bF" = (/obj/covers/wood_ship,/obj/structure/voyage/grid/partial{dir = 10},/turf/floor/broken_floor,/area/caribbean/pirates/ship/voyage/upper)
"bG" = (/obj/covers/wood_ship,/obj/structure/voyage/grid/partial{dir = 5},/turf/floor/broken_floor,/area/caribbean/pirates/ship/voyage/upper)
"bH" = (/obj/covers/wood_ship,/obj/structure/voyage/grid/partial{dir = 9},/turf/floor/broken_floor,/area/caribbean/pirates/ship/voyage/upper)

(1,1,1) = {"
aaaaaaaaaaaaaaaaaaaaaaaaaaaaaaaaaaaaaaaaaaaaaaaaaaaaaaaaaaaaaaaaaaaaaaaaaaaaaaaaaaaaaaaaaaaaaaaaaaaaaaaaaaaaaaaaaaaaaaaaaaaaaaaaaaaaaaaaaaaaaaaaaaaaaa
aaaaaaaaaaaaaaaaaaaaaaaaaaaaaaaaaaaaaaaaaaaaaaaaaaaaaaaaaaaaaaaaaaaaaaaaaaaaaaaaaaaaaaaaaaaaaaaaaaaaaaaaaaaaaaaaaaaaaaaaaaaaaaaaaaaaaaaaaaaaaaaaaaaaaa
aaaaaaaaaaaaaaaaaaaaaaaaaaaaaaaaaaaaaaaaaaaaaaaaaaaaaaaaaaaaaaaaaaaaaaaaaaaaaaaaaaaaaaaaaaaaaaaaaaaaaaaaaaaaaaaaaaaaaaaaaaaaaaaaaaaaaaaaaaaaaaaaaaaaaa
aaaaaaaaaaaaaaaaaaaaaaaaaaaaaaaaaaaaaaaaaaaaaaaaaaaaaaaaaaaaaaaaaaaaaaaaaaaaaaaaaaaaaaaaaaaaaaaaaaaaaaaaaaaaaaaaaaaaaaaaaaaaaaaaaaaaaaaaaaaaaaaaaaaaaa
aaaaaaaaaaaaaaaaaaaaaaaaaaaaaaaaaaaaaaaaaaaaaaaaaaaaaaaaaaaaaaaaaaaaaaaaaaaaaaaaaaaaaaaaaaaaaaaaaaaaaaaaaaaaaaaaaaaaaaaaaaaaaaaaaaaaaaaaaaaaaaaaaaaaaa
aaaaaaaaaaaaaaaaaaaaaaaaaaaaaaaaaaaaaaaaaaaaaaaaaaaaaaaaaaaaaaaaaaaaaaaaaaaaaaaaaaaaaaaaaaaaaaaaaaaaaaaaaaaaaaaaaaaaaaaaaaaaaaaaaaaaaaaaaaaaaaaaaaaaaa
aaaaaaaaaaaaaaaaaaaaaaaaaaaaaaaaaaaaaaaaaaaaaaaaaaaaaaaaaaaaaaaaaaaaaaaaaaaaaaaaaaaaaaaaaaaaaaaaaaaaaaaaaaaaaaaaaaaaaaaaaaaaaaaaaaaaaaaaaaaaaaaaaaaaaa
aaaaaaaaaaaaaaaaaaaaaaaaaaaaaaaaaaaaaaaaaaaaaaaaaaaaaaaaaaaaaaaaaaaaaaaaaaaaaaaaaaaaaaaaaaaaaaaaaaaaaaaaaaaaaaaaaaaaaaaaaaaaaaaaaaaaaaaaaaaaaaaaaaaaaa
aaaaaaaaaaaaaaaaaaaaaaaaaaaaaaaaaaaaaaaaaaaaaaaaaaaaaaaaaaaaaaaaaaaaaaaaaaaaaaaaaaaaaaaaaaaaaaaaaaaaaaaaaaaaaaaaaaaaaaaaaaaaaaaaaaaaaaaaaaaaaaaaaaaaaa
aaaaaaaaaaaaaaaaaaaaaaaaaaaaaaaaaaaaaaaaaaaaaaaaaaaaaaaaaaaaaaaaaaaaaaaaaaaaaaaaaaaaaaaaaaaaaaaaaaaaaaaaaaaaaaaaaaaaaaaaaaaaaaaaaaaaaaaaaaaaaaaaaaaaaa
aaaaaaaaaaaaaaaaaaaaaaaaaaaaaaaaaaaaaaaaaaaaaaaaaaaaaaaaaaaaaaaaaaaaaaaaaaaaaaaaaaaaaaaaaaaaaaaaaaaaaaaaaaaaaaaaaaaaaaaaaaaaaaaaaaaaaaaaaaaaaaaaaaaaaa
aaaaaaaaaaaaaaaaaaaaaaaaaaaaaaaaaaaaaaaaaaaaaaaaaaaaaaaaaaaaaaaaaaaaaaaaaaaaaaaaaaaaaaaaaaaaaaaaaaaaaaaaaaaaaaaaaaaaaaaaaaaaaaaaaaaaaaaaaaaaaaaaaaaaaa
aaaaaaaaaaaaaaaaaaaaaaaaaaaaaaabacacacadacacacacacacacacaeacacacacacacaeacacacacacacacacadaaaaaaaaaaaaaaaaaaaaaaaaaaaaaaaaaaaaaaaaaaaaaaaaaaaaaaaaaaaa
aaaaaaaaaaaaaaaaaaaaaaaaaaaaabafagagagahaiajajajajajajajajajajajajajajajajajakakajalalalamadaaaaaaaaaaaaaaaaaaaaaaaaaaaaaaaaaaaaaaaaaaaaaaaaaaaaaaaaaa
aaaaaaaaaaaaaaaaaaaaaaaaaaaaanaoajajajapajajajajajajajajajajajaqajajajajajajajajajajajajarasadaaaaaaaaaaaaaaaaaaaaaaaaaaaaaaaaaaaaaaaaaaaaaaaaaaaaaaaa
aaaaaaaaaaaaaaaaaaaaaaaaaaaaanaoajajajatajajaqajauavawawajaxaxayayayazajaAaAaAaAajaqajajararahaaaaaaaaaaaaaaaaaaaaaaaaaaaaaaaaaaaaaaaaaaaaaaaaaaaaaaaa
aaaaaaaaaaaaaaaaaaaaaaaaaaaaanaoajajajatajajajajauavawawajaxaxayayayazajaAaAaAaAajajajajararahaaaaaaaaaaaaaaaaaaaaaaaaaaaaaaaaaaaaaaaaaaaaaaaaaaaaaaaa
aaaaaaaaaaaaaaaaaaaaaaaaaaaaanaoajajajapaBajajajajajajajajajajajaCajajajajajajajajajajajaraDaEaaaaaaaaaaaaaaaaaaaaaaaaaaaaaaaaaaaaaaaaaaaaaaaaaaaaaaaa
aaaaaaaaaaaaaaaaaaaaaaaaaaaaaFaGagagagahajajajajaHaHaIaIaJaJaJajajajajajajajajaKaKaKaKaKaLaEaaaaaaaaaaaaaaaaaaaaaaaaaaaaaaaaaaaaaaaaaaaaaaaaaaaaaaaaaa
aaaaaaaaaaaaaaaaaaaaaaaaaaaaaaaFaMaMaMaMaMaMaMaMaMaMaMaMaNaMaMaMaMaMaMaNaMaMaMaMaMaMaMaMaEaaaaaaaaaaaaaaaaaaaaaaaaaaaaaaaaaaaaaaaaaaaaaaaaaaaaaaaaaaaa
aaaaaaaaaaaaaaaaaaaaaaaaaaaaaaaaaaaaaaaaaaaaaaaaaaaaaaaaaaaaaaaaaaaaaaaaaaaaaaaaaaaaaaaaaaaaaaaaaaaaaaaaaaaaaaaaaaaaaaaaaaaaaaaaaaaaaaaaaaaaaaaaaaaaaa
aaaaaaaaaaaaaaaaaaaaaaaaaaaaaaaaaaaaaaaaaaaaaaaaaaaaaaaaaaaaaaaaaaaaaaaaaaaaaaaaaaaaaaaaaaaaaaaaaaaaaaaaaaaaaaaaaaaaaaaaaaaaaaaaaaaaaaaaaaaaaaaaaaaaaa
aaaaaaaaaaaaaaaaaaaaaaaaaaaaaaaaaaaaaaaaaaaaaaaaaaaaaaaaaaaaaaaaaaaaaaaaaaaaaaaaaaaaaaaaaaaaaaaaaaaaaaaaaaaaaaaaaaaaaaaaaaaaaaaaaaaaaaaaaaaaaaaaaaaaaa
aaaaaaaaaaaaaaaaaaaaaaaaaaaaaaaaaaaaaaaaaaaaaaaaaaaaaaaaaaaaaaaaaaaaaaaaaaaaaaaaaaaaaaaaaaaaaaaaaaaaaaaaaaaaaaaaaaaaaaaaaaaaaaaaaaaaaaaaaaaaaaaaaaaaaa
aOaaaaaaaaaaaaaaaaaaaaaaaaaaaaaaaaaaaaaaaaaaaaaaaaaaaaaaaaaaaaaaaaaaaaaaaaaaaaaaaaaaaaaaaaaaaaaaaaaaaaaaaaaaaaaaaaaaaaaaaaaaaaaaaaaaaaaaaaaaaaaaaaaaaa
"}

(1,1,2) = {"
aaaaaaaaaaaaaaaaaaaaaaaaaaaaaaaaaaaaaaaaaaaaaaaaaaaaaaaaaaaaaaaaaaaaaaaaaaaaaaaaaaaaaaaaaaaaaaaaaaaaaaaaaaaaaaaaaaaaaaaaaaaaaaaaaaaaaaaaaaaaaaaaaaaaaa
aaaaaaaaaaaaaaaaaaaaaaaaaaaaaaaaaaaaaaaaaaaaaaaaaaaaaaaaaaaaaaaaaaaaaaaaaaaaaaaaaaaaaaaaaaaaaaaaaaaaaaaaaaaaaaaaaaaaaaaaaaaaaaaaaaaaaaaaaaaaaaaaaaaaaa
aaaaaaaaaaaaaaaaaaaaaaaaaaaaaaaaaaaaaaaaaaaaaaaaaaaaaaaaaaaaaaaaaaaaaaaaaaaaaaaaaaaaaaaaaaaaaaaaaaaaaaaaaaaaaaaaaaaaaaaaaaaaaaaaaaaaaaaaaaaaaaaaaaaaaa
aaaaaaaaaaaaaaaaaaaaaaaaaaaaaaaaaaaaaaaaaaaaaaaaaaaaaaaaaaaaaaaaaaaaaaaaaaaaaaaaaaaaaaaaaaaaaaaaaaaaaaaaaaaaaaaaaaaaaaaaaaaaaaaaaaaaaaaaaaaaaaaaaaaaaa
aaaaaaaaaaaaaaaaaaaaaaaaaaaaaaaaaaaaaaaaaaaaaaaaaaaaaaaaaaaaaaaaaaaaaaaaaaaaaaaaaaaaaaaaaaaaaaaaaaaaaaaaaaaaaaaaaaaaaaaaaaaaaaaaaaaaaaaaaaaaaaaaaaaaaa
aaaaaaaaaaaaaaaaaaaaaaaaaaaaaaaaaaaaaaaaaaaaaaaaaaaaaaaaaaaaaaaaaaaaaaaaaaaaaaaaaaaaaaaaaaaaaaaaaaaaaaaaaaaaaaaaaaaaaaaaaaaaaaaaaaaaaaaaaaaaaaaaaaaaaa
aaaaaaaaaaaaaaaaaaaaaaaaaaaaaaaaaaaaaaaaaaaaaaaaaaaaaaaaaaaaaaaaaaaaaaaaaaaaaaaaaaaaaaaaaaaaaaaaaaaaaaaaaaaaaaaaaaaaaaaaaaaaaaaaaaaaaaaaaaaaaaaaaaaaaa
aaaaaaaaaaaaaaaaaaaaaaaaaaaaaaaaaaaaaaaaaaaaaaaaaaaaaaaaaaaaaaaaaaaaaaaaaaaaaaaaaaaaaaaaaaaaaaaaaaaaaaaaaaaaaaaaaaaaaaaaaaaaaaaaaaaaaaaaaaaaaaaaaaaaaa
aaaaaaaaaaaaaaaaaaaaaaaaaaaaaaaaaaaaaaaaaaaaaaaaaaaaaaaaaaaaaaaaaaaaaaaaaaaaaaaaaaaaaaaaaaaaaaaaaaaaaaaaaaaaaaaaaaaaaaaaaaaaaaaaaaaaaaaaaaaaaaaaaaaaaa
aaaaaaaaaaaaaaaaaaaaaaaaaaaaaaaaaaaaaaaaaaaaaaaaaaaaaaaaaaaaaaaaaaaaaaaaaaaaaaaaaaaaaaaaaaaaaaaaaaaaaaaaaaaaaaaaaaaaaaaaaaaaaaaaaaaaaaaaaaaaaaaaaaaaaa
aaaaaaaaaaaaaaaaaaaaaaaaaaaaaaaaaaaaaaaaaaaaaaaaaaaaaaaaaaaaaaaaaaaaaaaaaaaaaaaaaaaaaaaaaaaaaaaaaaaaaaaaaaaaaaaaaaaaaaaaaaaaaaaaaaaaaaaaaaaaaaaaaaaaaa
aaaaaaaaaaaaaaaaaaaaaaaaaaaaaaaaaaaaaaaaaaaaaaaaaaaaaaaaaaaaaaaaaaaaaaaaaaaaaaaaaaaaaaaaaaaaaaaaaaaaaaaaaaaaaaaaaaaaaaaaaaaaaaaaaaaaaaaaaaaaaaaaaaaaaa
aaaaaaaaaaaaaaaaaaaaaaaaaaaaaaaPaQaQaQaRaSaSaSaSaSaSaSaTaSaSaSaSaSaSaTaSaSaUaSaSaSaSaSaSaVaaaaaaaaaaaaaaaaaaaaaaaaaaaaaaaaaaaaaaaaaaaaaaaaaaaaaaaaaaaa
aaaaaaaaaaaaaaaaaaaaaaaaaaaaaWaXaYaZaZbabbbbbbbbbbbcbbbdbbbbbbbbbbbbbdbbbcbbbbbbbbbbbbbbbeaVaaaaaaaaaaaaaaaaaaaaaaaaaaaaaaaaaaaaaaaaaaaaaaaaaaaaaaaaaa
aaaaaaaaaaaaaaaaaaaaaaaaaaaabfaZbgaZaZbhbibbbjbbbbbbbbbbbbbbbbbbbbbbbbbbbbbbbbbbbbbbbbbbbbbeaVaaaaaaaaaaaaaaaaaaaaaaaaaaaaaaaaaaaaaaaaaaaaaaaaaaaaaaaa
aaaaaaaaaaaaaaaaaaaaaaaaaaaabfbkblaZaZbmbbbbbbbbbbbbbbbbbbbEbnbFbbbbbbbbbbbbbbbbbjbbbbbbbbbbbeaSaVaaaaaaaaaaaaaaaaaaaaaaaaaaaaaaaaaaaaaaaaaaaaaaaaaaaa
aaaaaaaaaaaaaaaaaaaaaaaaaaaabfaZaYaZaZbmbbbbbbbbbbbobbbbbbbbbbbbbbbbbbbbbobbbbbbbbbbbbbbbbbbbpbqbraaaaaaaaaaaaaaaaaaaaaaaaaaaaaaaaaaaaaaaaaaaaaaaaaaaa
aaaaaaaaaaaaaaaaaaaaaaaaaaaabfaZaZaZaZbhbsbbbbbbbbbbbbbbbbbGbbbHbjbbbbbbbbbbbbbbbbbbbbbbbbbpbraaaaaaaaaaaaaaaaaaaaaaaaaaaaaaaaaaaaaaaaaaaaaaaaaaaaaaaa
aaaaaaaaaaaaaaaaaaaaaaaaaaaabtbuaZbvbwbabbbbbbbbbbbbbbbbbbbbbbbbbbbbbbbbbbbbbbbbbbbbbbbbbpbraaaaaaaaaaaaaaaaaaaaaaaaaaaaaaaaaaaaaaaaaaaaaaaaaaaaaaaaaa
aaaaaaaaaaaaaaaaaaaaaaaaaaaaaabxbybybybzbqbAbqbqbqbBbqbCbqbqbqbqbqbqbCbqbBbAbqbqbqbqbqbqbraaaaaaaaaaaaaaaaaaaaaaaaaaaaaaaaaaaaaaaaaaaaaaaaaaaaaaaaaaaa
aaaaaaaaaaaaaaaaaaaaaaaaaaaaaaaaaaaaaaaaaaaaaaaaaaaaaaaabDaaaaaaaaaaaabDaaaaaaaaaaaaaaaaaaaaaaaaaaaaaaaaaaaaaaaaaaaaaaaaaaaaaaaaaaaaaaaaaaaaaaaaaaaaaa
aaaaaaaaaaaaaaaaaaaaaaaaaaaaaaaaaaaaaaaaaaaaaaaaaaaaaaaabDaaaaaaaaaaaabDaaaaaaaaaaaaaaaaaaaaaaaaaaaaaaaaaaaaaaaaaaaaaaaaaaaaaaaaaaaaaaaaaaaaaaaaaaaaaa
aaaaaaaaaaaaaaaaaaaaaaaaaaaaaaaaaaaaaaaaaaaaaaaaaaaaaaaabDaaaaaaaaaaaabDaaaaaaaaaaaaaaaaaaaaaaaaaaaaaaaaaaaaaaaaaaaaaaaaaaaaaaaaaaaaaaaaaaaaaaaaaaaaaa
aaaaaaaaaaaaaaaaaaaaaaaaaaaaaaaaaaaaaaaaaaaaaaaaaaaaaaaabDaaaaaaaaaaaabDaaaaaaaaaaaaaaaaaaaaaaaaaaaaaaaaaaaaaaaaaaaaaaaaaaaaaaaaaaaaaaaaaaaaaaaaaaaaaa
aaaaaaaaaaaaaaaaaaaaaaaaaaaaaaaaaaaaaaaaaaaaaaaaaaaaaaaabDaaaaaaaaaaaabDaaaaaaaaaaaaaaaaaaaaaaaaaaaaaaaaaaaaaaaaaaaaaaaaaaaaaaaaaaaaaaaaaaaaaaaaaaaaaa
"}
