"a" = (/turf/floor/beach/water/deep/saltwater,/area/caribbean/sea/top)
"b" = (/obj/structure/barricade/ship/wood/a7,/obj/covers/repairedfloor/ship,/turf/floor/beach/water/deep/saltwater,/area/caribbean/pirates/ship/office)
"c" = (/obj/covers/repairedfloor/ship,/mob/living/simple_animal/hostile/human/pirate/ranged,/turf/floor/beach/water/deep/saltwater,/area/caribbean/pirates/ship/main_deck)
"d" = (/obj/covers/repairedfloor/ship,/obj/structure/bed/chair/comfy/blue{dir = 8},/turf/floor/beach/water/deep/saltwater,/area/caribbean/pirates/ship/office)
"e" = (/obj/covers/repairedfloor/ship,/obj/structure/closet/crate/rations/fruits,/turf/floor/beach/water/deep/saltwater,/area/caribbean/pirates/ship/office)
"f" = (/obj/covers/repairedfloor/ship,/obj/structure/bed/hammock,/turf/floor/beach/water/deep/saltwater,/area/caribbean/pirates/ship/office)
"g" = (/obj/covers/repairedfloor/ship,/obj/structure/wallclock,/turf/floor/beach/water/deep/saltwater,/area/caribbean/pirates/ship/office)
"h" = (/obj/covers/repairedfloor/ship,/obj/structure/grapplehook{owner = "PIRATES"},/turf/floor/beach/water/deep/saltwater,/area/caribbean/pirates/ship/main_deck)
"i" = (/obj/structure/barricade/ship/blue/b9,/obj/covers/repairedfloor/ship,/turf/floor/beach/water/deep/saltwater,/area/caribbean/pirates/ship/office)
"j" = (/obj/structure/barricade/ship/blue/bport3,/obj/covers/repairedfloor/ship,/turf/floor/beach/water/deep/saltwater,/area/caribbean/pirates/ship/main_deck)
"k" = (/obj/structure/barricade/ship/blue/bport3,/obj/structure/cannon,/obj/covers/repairedfloor/ship,/turf/floor/beach/water/deep/saltwater,/area/caribbean/pirates/ship/main_deck)
"l" = (/obj/structure/barricade/ship/wood/port0,/obj/covers/repairedfloor/ship,/turf/floor/beach/water/deep/saltwater,/area/caribbean/pirates/ship/main_deck)
"m" = (/obj/structure/barricade/ship/wood/a12,/obj/covers/repairedfloor/ship,/turf/floor/beach/water/deep/saltwater,/area/caribbean/pirates/ship/office)
"n" = (/obj/structure/barricade/ship/blue/bport0,/obj/covers/repairedfloor/ship,/turf/floor/beach/water/deep/saltwater,/area/caribbean/pirates/ship/main_deck)
"o" = (/obj/covers/repairedfloor/ship,/mob/living/simple_animal/hostile/pirate,/turf/floor/beach/water/deep/saltwater,/area/caribbean/pirates/ship/main_deck)
"p" = (/obj/covers/repairedfloor/ship,/obj/item/stack/money/goldcoin,/obj/structure/closet/crate/chest,/turf/floor/beach/water/deep/saltwater,/area/caribbean/pirates/ship/office)
"q" = (/obj/covers/repairedfloor/ship,/obj/structure/bookcase,/obj/item/weapon/book,/obj/item/weapon/book,/obj/item/weapon/book,/turf/floor/beach/water/deep/saltwater,/area/caribbean/pirates/ship/office)
"r" = (/obj/structure/barricade/ship/blue/b8,/obj/covers/repairedfloor/ship,/obj/covers/repairedfloor/ship,/turf/floor/beach/water/deep/saltwater,/area/caribbean/pirates/ship/office)
"s" = (/obj/structure/barricade/ship/wood/a1,/obj/covers/repairedfloor/ship,/turf/floor/beach/water/deep/saltwater,/area/caribbean/pirates/ship/office)
"t" = (/obj/structure/barricade/ship/wood/port2,/obj/covers/repairedfloor/ship/south,/turf/floor/beach/water/deep/saltwater,/area/caribbean/pirates/ship/main_deck)
"u" = (/obj/structure/barricade/ship/wood/a2,/obj/covers/repairedfloor/ship,/turf/floor/beach/water/deep/saltwater,/area/caribbean/pirates/ship/office)
"v" = (/obj/structure/barricade/ship/wood/a5,/obj/covers/repairedfloor/ship,/turf/floor/beach/water/deep/saltwater,/area/caribbean/pirates/ship/office)
"w" = (/obj/structure/barricade/ship/blue/b19,/obj/covers/repairedfloor/ship,/turf/floor/beach/water/deep/saltwater,/area/caribbean/pirates/ship/office)
"x" = (/obj/covers/repairedfloor/ship,/obj/item/stack/money/goldvaluables,/obj/item/stack/money/goldvaluables,/obj/structure/closet/crate/chest,/turf/floor/beach/water/deep/saltwater,/area/caribbean/pirates/ship/office)
"y" = (/obj/covers/repairedfloor/ship,/obj/structure/bed/chair{dir = 4},/turf/floor/beach/water/deep/saltwater,/area/caribbean/pirates/ship/office)
"z" = (/obj/structure/simple_door/key_door/anyone/wood,/obj/covers/repairedfloor/ship,/turf/floor/beach/water/deep/saltwater,/area/caribbean/pirates/ship/office)
"A" = (/obj/covers/repairedfloor/ship,/obj/structure/oven,/turf/floor/beach/water/deep/saltwater,/area/caribbean/pirates/ship/office)
"B" = (/obj/structure/barricade/ship/wood/a4,/obj/covers/repairedfloor/ship,/obj/structure/barricade/ship/blue/b1,/turf/floor/beach/water/deep/saltwater,/area/caribbean/pirates/ship/office)
"C" = (/obj/structure/barricade/ship/blue/b10,/obj/covers/repairedfloor/ship,/turf/floor/beach/water/deep/saltwater,/area/caribbean/pirates/ship/office)
"D" = (/obj/structure/barricade/ship/wood/a7,/obj/covers/repairedfloor/ship,/obj/structure/sign/painting9,/turf/floor/beach/water/deep/saltwater,/area/caribbean/pirates/ship/office)
"E" = (/obj/structure/barricade/ship/blue/b17,/obj/covers/repairedfloor/ship,/obj/structure/barricade/ship/blue/b15,/turf/floor/beach/water/deep/saltwater,/area/caribbean/pirates/ship/office)
"F" = (/obj/structure/barricade/ship/mast,/obj/covers/repairedfloor/ship,/turf/floor/beach/water/deep/saltwater,/area/caribbean/pirates/ship/main_deck)
"G" = (/obj/structure/flag/pirates,/obj/covers/repairedfloor/ship,/turf/floor/beach/water/deep/saltwater,/area/caribbean/pirates/ship/main_deck)
"H" = (/obj/covers/repairedfloor/ship,/obj/structure/barricade/ship/blue/b2,/turf/floor/beach/water/deep/saltwater,/area/caribbean/pirates/ship/office)
"I" = (/obj/structure/table/wood,/obj/covers/repairedfloor/ship,/obj/structure/voyage_tablemap{dir = 4; layer = 2.9},/obj/item/weapon/gun/projectile/flintlock/pistoletmodelean1733,/turf/floor/beach/water/deep/saltwater,/area/caribbean/pirates/ship/office)
"J" = (/obj/covers/repairedfloor/ship,/obj/structure/table/fancy,/obj/item/weapon/reagent_containers/food/snacks/applepie,/turf/floor/beach/water/deep/saltwater,/area/caribbean/pirates/ship/office)
"K" = (/obj/covers/repairedfloor/ship,/obj/item/stack/money/goldvaluables,/obj/structure/closet/crate/chest,/turf/floor/beach/water/deep/saltwater,/area/caribbean/pirates/ship/office)
"L" = (/obj/structure/barricade/ship/wood/a9,/obj/covers/repairedfloor/ship,/turf/floor/beach/water/deep/saltwater,/area/caribbean/pirates/ship/office)
"M" = (/obj/structure/barricade/ship/wood/port0,/obj/covers/repairedfloor/ship/south,/turf/floor/beach/water/deep/saltwater,/area/caribbean/pirates/ship/main_deck)
"N" = (/turf/wall/wood,/area/caribbean/pirates/ship/office)
"O" = (/obj/structure/barricade/ship/wood/port2,/obj/covers/repairedfloor/ship/south,/mob/living/simple_animal/hostile/pirate,/turf/floor/beach/water/deep/saltwater,/area/caribbean/pirates/ship/main_deck)
"P" = (/obj/structure/barricade/ship/wood/a6,/obj/covers/repairedfloor/ship,/turf/floor/beach/water/deep/saltwater,/area/caribbean/pirates/ship/office)
"Q" = (/obj/structure/barricade/ship/blue/b16,/obj/covers/repairedfloor/ship,/turf/floor/beach/water/deep/saltwater,/area/caribbean/pirates/ship/office)
"R" = (/obj/covers/repairedfloor/ship,/obj/structure/cannon{dir = 1},/turf/floor/beach/water/deep/saltwater,/area/caribbean/pirates/ship/main_deck)
"S" = (/obj/covers/repairedfloor/ship,/obj/structure/table/rack/coatrack,/turf/floor/beach/water/deep/saltwater,/area/caribbean/pirates/ship/office)
"T" = (/obj/structure/barricade/ship/wood/a3,/obj/covers/repairedfloor/ship,/turf/floor/beach/water/deep/saltwater,/area/caribbean/pirates/ship/office)
"U" = (/obj/covers/repairedfloor/ship,/obj/structure/bookcase,/obj/item/weapon/book,/obj/item/weapon/book,/obj/item/weapon/book,/obj/item/weapon/book,/obj/item/weapon/book,/turf/floor/beach/water/deep/saltwater,/area/caribbean/pirates/ship/office)
"V" = (/obj/covers/repairedfloor/ship,/turf/floor/beach/water/deep/saltwater,/area/caribbean/pirates/ship/main_deck)
"W" = (/obj/structure/barricade/ship/blue/b18,/obj/covers/repairedfloor/ship,/turf/floor/beach/water/deep/saltwater,/area/caribbean/pirates/ship/office)
"X" = (/obj/covers/repairedfloor/ship,/turf/floor/beach/water/deep/saltwater,/area/caribbean/pirates/ship/office)
"Y" = (/obj/structure/table/wood,/obj/covers/repairedfloor/ship,/obj/structure/potted_plant{dir = 5},/turf/floor/beach/water/deep/saltwater,/area/caribbean/pirates/ship/office)
"Z" = (/obj/covers/repairedfloor/ship,/obj/structure/closet/crate/rations/ale,/turf/floor/beach/water/deep/saltwater,/area/caribbean/pirates/ship/office)

(1,1,1) = {"
aaaaaaaaaaaaaaaaaaaaaaaaaaaaaaaaaaaaaaaaaaaaaaaaaaaaaaaaaaaaaaaaaaaaaaaaaaa
aaaaaaaaaaaaaaaaaaaaaaaaaaaaaaaaaaaaaaaaaaaaaaaaaaaaaaaaaaaaaaaaaaaaaaaaaaa
aaaaaaaaaaaaaaaaaaaaaaaaaaaaaaaaaaaaaaaaaaaaaaaaaaaaaaaaaaaaaaaaaaaaaaaaaaa
aaaaaaaaaaaaaaaaaaaaaaaaaaaaaaaaaaaaaaaaaaaaaaaaaaaaaaaaaaaaaaaaaaaaaaaaaaa
aaaaaaaaaaaaaaaaaaaaaaaaaaaaaaaaaaaaaaaaaaaaaaaaaaaaaaaaaaaaaaaaaaaaaaaaaaa
aaaaaaaaaaaaaaaaaaaaaaaaaaaaaaaaaaaaaaaaaaaaaaaaaaaaaaaaaaaaaaaaaaaaaaaaaaa
aaaaaaaaaaaaaaaaaaaaaaaaaaaaaaaaaaaaaaaaaaaaaaaaaaaaaaaaaaaaaaaaaaaaaaaaaaa
aaaaaaaaaaaaaaaaaaaaaaaaaaaaaaaaaaaaaaaaaaaaaaaaaaaaaaaaaaaaaaaaaaaaaaaaaaa
aaaaaaaaaaaaaaaaaaaaaaaaaaaaaaaaaaaaaaaaaaaaaaaaaaaaaaaaaaaaaaaaaaaaaaaaaaa
aaaaaaaaaaaaaaaaaaaaaaaaaaaaaaaaaaaaaaaaaaaaaaaaaaaaaaaaaaaaaaaaaaaaaaaaaaa
aaaaaaaaaaaaaaaaaaaaaaaaaaaaaaaaaaaaaaaaaaaaaaaaaaaaaaaaaaaaaaaaaaaaaaaaaaa
aaaaaaaaaaaaaaaaaaaaaaaaaaaaaaaaaaaaaaaaaaaaaaaaaaaaaaaaaaaaaaaaaaaaaaaaaaa
aaaaaaaaaaaaaaaaaaaaaaaaaaaaaaaaaaaaaaaaaaaaaaaaaaaaaaaaaaaaaaaaaaaaaaaaaaa
aaaaaaaaaaaaaaaaaaaaaaaaaaaaaaaaaaaaaaaaaaaaaaaaaaaaaaaaaaaaaaaaaaaaaaaaaaa
aaaaaaaaaaaaaaaaaaaaaaaaaaaaaaaaaaaaaaaaaaaaaaaaaaaaaaaaaaaaaaaaaaaaaaaaaaa
aaaaaaaaaaaaaaaaaaaaaaaaaaaaaaaaaaaaaaaaaaaaaaaaaaaaaaaaaaaaaaaaaaaaaaaaaaa
aaaaaaaaaaaaaaaaaaaaaaaaaaaaaaaaaaaaaaaaaaaaaaaaaaaaaaaaaaaaaaaaaaaaaaaaaaa
aaaaaaaaaaaaaaaaaaaaaaaaaaaaaaaaaaaaaaaaaaaaaaaaaaaaaaaaaaaaaaaaaaaaaaaaaaa
aaaaaaaaaaaaaaaaaaaaaaaaaaaaaaaaaaaaaaaaaaaaaaaaaaaaaaaaaaaaaaaaaaaaaaaaaaa
aaaaaaaaaaaaaaaaaaaaaaaaaaaaaaaaaaaaaaaaaaaaaaaaaaaaaaaaaaaaaaaaaaaaaaaaaaa
aaaaaaaaaaaaaaaaaaaaaaaaaaaaaaaaaaaaaaaaaaaaaaaaaaaaaaaaaaaaaaaaaaaaaaaaaaa
aaaaaaaaaaaaaaaaaaaaaaaaaaaaaaaaaaaaaaaaaaaaaaaaaaaaaaaaaaaaaaaaaaaaaaaaaaa
aaaaaaaaaaaaaaaaaaaaaaaaaaaaaaaaaaaaaaaaaaaaaaaaaaaaaaaaaaaaaaaaaaaaaaaaaaa
aaaaaaaaaaaaaaaaaaaaaaaaaaaaaaaaaaaaaaaaaaaaaaaaaaaaaaaaaaaaaaaaaaaaaaaaaaa
aaaaaaaaaaaaaaaaaaaaaaaaaaaaaaaaaaaaaaaaaaaaaaaaaaaaaaaaaaaaaaaaaaaaaaaaaaa
"}
(1,1,2) = {"
aaaaaaaaaaaaaaaaaaaaaaaaaaaaaaaaaaaaaaaaaaaaaaaaaaaaaaaaaaaaaaaaaaaaaaaaaaa
aaaaaaaaaaaaaaaaaaaaaaaaaaaaaaaaaaaaaaaaaaaaaaaaaaaaaaaaaaaaaaaaaaaaaaaaaaa
aaaaaaaaaaaaaaaaaaaaaaaaaaaaaaaaaaaaaaaaaaaaaaaaaaaaaaaaaaaaaaaaaaaaaaaaaaa
aaaaaaaaaaaaaaaaaaaaaaaaaaaaaaaaaaaaaaaaaaaaaaaaaaaaaaaaaaaaaaaaaaaaaaaaaaa
aaaaaaaaaaaaaaaaaaaaaaaaaaaaaaaaaaaaaaaaaaaaaaaaaaaaaaaaaaaaaaaaaaaaaaaaaaa
aaaaaaaaaaaaaaaaaaaaaaaaaaaaaaaaaaaaaaaaaaaaaaaaaaaaaaaaaaaaaaaaaaaaaaaaaaa
aaaaaaaaaaaaaaaaaaaaaaaaaaaaaaaaaaaaaaaaaaaaaaaaaaaaaaaaaaaaaaaaaaaaaaaaaaa
aaaaaaaaaaaaaaaaaaaaaaaaaaaaaaaaaaaaaaaaaaaaaaaaaaaaaaaaaaaaaaaaaaaaaaaaaaa
aaaaaaaaaaaaaaaaaaaaaaaaaaaaaaaaaaaaaaaaaaaaaaaaaaaaaaaaaaaaaaaaaaaaaaaaaaa
aaaaaaaaaaaaaaaaaaaaaaaaaaaaaaaaaaaaaaaaaaaaaaaaaaaaaaaaaaaaaaaaaaaaaaaaaaa
aaaaaaaaaaaaaaaaaaaaaaaaaaaaaaaaaaaaaaaaaaaaaaaaaaaaaaaaaaaaaaaaaaaaaaaaaaa
aaaaaaaaaaaaaaaaaaaaaaaaaaaaaaaaaaaaaaaaaaaaaaaaaaaaaaaaaaaaaaaaaaaaaaaaaaa
aaaaaaaaaaaaaaaaaaaaaaaaaaaaaaaaaaaaaaaaaaaaaaaaaaaaaaaaaaaaaaaaaaaaaaaaaaa
aaaaaaaaaaaaaaaaaaaaaaaaaaaaaaaaaaaaaaaaaaaaaaaaaaaaaaaaaaaaaaaaaaaaaaaaaaa
aaaaaaaaaaaaaaaaaaaaaaaaaaaaaaaaaaaaaaaaaaaaaaaaaaaaaaaaaaaaaaaaaaaaaaaaaaa
aaaaaaaaaaaaaaaaaaaaaaaaaaaaaaaaaaaaaaaaaaaaaaaaaaaaaaaaaaaaaaaaaaaaaaaaaaa
aaaaaaaaaaaaaaaaaBbbbbLaaaaaaaaaaaaaaaaaaaaaaaaaaaaaaaaaaaaaaaaaaaaaaaaaaaa
aaaaaaaaaaaaaaaaaHfXXfmtlOltMtltltltltltltlTbDbLaaaaaaaaaaaaaaaaaaaaaaaaaaa
aaaaaaaaaaaaaaaaaHeXXfmVVVVRVhVVVRhVoVoRhVougUqvLaaaaaaaaaaaaaaaaaaaaaaaaaa
aaaaaaaaaaaaaaaaaHZXXXPVVVVVVVcVVVVVVVVVVVVuXXXXPNaaaaaaaaaaaaaaaaaaaaaaaaa
aaaaaaaaaaaaaaaaaHJXXXzVVFVVVGVVoVVVFVVVVVVzXXIdPNNNaaaaaaaaaaaaaaaaaaaaaaa
aaaaaaaaaaaaaaaaaHAXXXPVVVVVVVVVVVVVVVVcVVVuXXXXPNaaaaaaaaaaaaaaaaaaaaaaaaa
aaaaaaaaaaaaaaaaaHKXXXPVVoVVchVoVVhVVVVVhVosSyYWCaaaaaaaaaaaaaaaaaaaaaaaaaa
aaaaaaaaaaaaaaaaaHKxpfPjnjnknjnjnknjnjnknjnQiiiwaaaaaaaaaaaaaaaaaaaaaaaaaaa
aaaaaaaaaaaaaaaaaEiiiiraaaaaaaaaaaaaaaaaaaaaaaaaaaaaaaaaaaaaaaaaaaaaaaaaaaa
"}
