"aa" = (/turf/floor/dirt,/area/caribbean/forest)
"ab" = (/turf/floor/grass,/area/caribbean/forest)
"ac" = (/obj/structure/wild/tallgrass,/turf/floor/grass,/area/caribbean/forest)
"ad" = (/obj/structure/wild/tree/live_tree,/turf/floor/grass,/area/caribbean/forest)
"ae" = (/turf/floor/dirt/dust,/area/caribbean/forest)
"af" = (/obj/structure/wild/smallbush,/turf/floor/grass,/area/caribbean/forest)
"ag" = (/turf/floor/dirt/underground,/area/caribbean/forest)
"ah" = (/obj/structure/wild/smallbush,/turf/floor/dirt,/area/caribbean/forest)
"ai" = (/obj/structure/wild/jungle/medpine,/turf/floor/grass,/area/caribbean/forest)
"aj" = (/obj/structure/wild/jungle/medpine,/turf/floor/dirt,/area/caribbean/forest)
"ak" = (/obj/structure/wild/junglebush,/turf/floor/grass,/area/caribbean/forest)
"al" = (/obj/structure/wild/tree/live_tree,/turf/floor/dirt/dust,/area/caribbean/forest)
"am" = (/obj/structure/wild/tallgrass,/turf/floor/dirt,/area/caribbean/forest)
"an" = (/obj/structure/wild/junglebush,/turf/floor/dirt,/area/caribbean/forest)
"ao" = (/obj/structure/wild/smallbush,/turf/floor/dirt/dust,/area/caribbean/forest)
"ap" = (/turf/floor/trench,/area/caribbean/forest)
"aq" = (/obj/structure/wild/tallgrass,/obj/structure/wild/tallgrass,/turf/floor/grass,/area/caribbean/forest)
"ar" = (/obj/structure/wild/jungle/medpine/dead,/turf/floor/grass,/area/caribbean/forest)
"as" = (/obj/structure/wild/tree/live_tree,/obj/structure/wild/tallgrass,/obj/structure/wild/tallgrass,/turf/floor/grass,/area/caribbean/forest)
"at" = (/obj/structure/wild/tallgrass,/turf/floor/dirt/underground,/area/caribbean/forest)
"au" = (/obj/structure/wild/tallgrass,/turf/floor/dirt/dust,/area/caribbean/forest)
"av" = (/obj/structure/vehicleparts/frame/lb,/obj/item/weapon/reagent_containers/glass/barrel/fueltank/tank/fueledgasoline,/turf/floor/dirt,/area/caribbean/forest)
"aw" = (/obj/structure/vehicleparts/frame/rdoor{doorcode = 11940},/turf/floor/dirt,/area/caribbean/forest)
"ax" = (/obj/structure/vehicleparts/frame/bwall,/obj/structure/engine/internal/gasoline{enginesize = 12000},/turf/floor/dirt,/area/caribbean/forest)
"ay" = (/obj/structure/vehicleparts/axis/heavy{name = "Panzer IV"},/obj/effect/autoassembler,/obj/structure/vehicleparts/frame/fwall,/obj/structure/radio/transmitter_receiver/nopower/faction1{anchored = 1},/turf/floor/dirt,/area/caribbean/forest)
"az" = (/obj/structure/vehicleparts/axis/heavy{dir = 1; name = "T-34"},/obj/effect/autoassembler,/obj/structure/vehicleparts/frame/fwall{icon_state = "frame_steel"; dir = 1},/obj/structure/radio/transmitter_receiver/nopower/faction2{anchored = 1},/turf/floor/dirt,/area/caribbean/forest)
"aA" = (/obj/structure/vehicleparts/frame/ldoor{doorcode = 11940},/obj/item/weapon/storage/toolbox/emergency,/turf/floor/dirt,/area/caribbean/forest)
"aB" = (/obj/structure/closet/hideout/pine,/turf/floor/grass,/area/caribbean/forest)
"aC" = (/obj/structure/wild/burnedbush,/turf/floor/grass,/area/caribbean/forest)
"aD" = (/obj/structure/wild/jungle/medpine,/turf/floor/dirt/dust,/area/caribbean/forest)
"aE" = (/obj/structure/wild/jungle/medpine,/obj/structure/wild/tallgrass,/turf/floor/grass,/area/caribbean/forest)
"aF" = (/obj/map_metadata/kursk,/turf/floor/grass,/area/caribbean/forest)
"aG" = (/obj/structure/wild/burnedbush,/turf/floor/dirt,/area/caribbean/forest)
"aH" = (/obj/structure/vehicleparts/movement/tracks/reversed{icon_state = "tracks_end"; dir = 1},/turf/floor/dirt,/area/caribbean/forest)
"aI" = (/obj/item/weapon/reagent_containers/glass/barrel/modern/gasoline,/turf/floor/dirt,/area/caribbean/forest)
"aJ" = (/obj/structure/table/rack{density = 0; layer = 3},/obj/item/cannon_ball/shell,/obj/item/cannon_ball/shell,/obj/item/cannon_ball/shell,/obj/item/cannon_ball/shell,/obj/structure/vehicleparts/frame/rb,/obj/item/ammo_magazine/mg34belt,/obj/item/ammo_magazine/mg34belt,/turf/floor/dirt,/area/caribbean/forest)
"aK" = (/obj/structure/engine/internal/diesel{enginesize = 20000},/obj/structure/vehicleparts/frame/bwall{icon_state = "frame_steel"; dir = 1},/turf/floor/dirt,/area/caribbean/forest)
"aL" = (/obj/effect/landmark{name = "JoinLateGE"},/turf/floor/dirt,/area/caribbean/forest)
"aM" = (/obj/structure/wild/tallgrass,/obj/effect/landmark{name = "JoinLateGE"},/turf/floor/grass,/area/caribbean/forest)
"aN" = (/obj/item/weapon/storage/toolbox/emergency,/obj/structure/vehicleparts/frame/ldoor{dir = 1; doorcode = 4975; icon_state = "frame_steel"},/turf/floor/dirt,/area/caribbean/forest)
"aO" = (/obj/structure/vehicleparts/frame,/obj/structure/bed/chair/loader,/turf/floor/dirt,/area/caribbean/forest)
"aP" = (/obj/structure/vehicleparts/frame/rdoor{dir = 1; doorcode = 4975; icon_state = "frame_steel"},/turf/floor/dirt,/area/caribbean/forest)
"aQ" = (/obj/structure/vehicleparts/frame/rwall,/obj/structure/bed/chair/commander,/turf/floor/dirt,/area/caribbean/forest)
"aR" = (/obj/structure/vehicleparts/frame,/obj/structure/cannon/modern/tank{anchored = 1; name = "7.5 cm Kampfwagenkanone 40"},/turf/floor/dirt,/area/caribbean/forest)
"aS" = (/obj/structure/vehicleparts/frame/lwall,/obj/structure/bed/chair/gunner{icon_state = "officechair_white"; dir = 8},/turf/floor/dirt,/area/caribbean/forest)
"aT" = (/obj/structure/vehicleparts/movement/tracks{icon_state = "tracks_end"; dir = 1},/turf/floor/dirt,/area/caribbean/forest)
"aU" = (/obj/item/weapon/gun/projectile/automatic/stationary/modern/mg34{anchored = 1; layer = 4},/obj/structure/vehicleparts/frame/rf,/obj/structure/bed/chair/office/light{name = "machinegunner's seat"},/turf/floor/dirt,/area/caribbean/forest)
"aV" = (/obj/structure/wild/smallbush,/obj/structure/vehicleparts/movement/tracks{icon_state = "tracks_end"; dir = 1},/turf/floor/dirt,/area/caribbean/forest)
"aW" = (/obj/structure/bed/chair/drivers/tank,/obj/structure/vehicleparts/frame/lf,/turf/floor/dirt,/area/caribbean/forest)
"aX" = (/obj/structure/vehicleparts/movement/tracks,/turf/floor/dirt,/area/caribbean/forest)
"aY" = (/obj/effect/landmark{icon_state = "x1"; name = "JoinLateRU"},/turf/floor/dirt,/area/caribbean/forest)
"aZ" = (/obj/structure/vehicleparts/frame/lf{icon_state = "frame_steel"; dir = 1},/obj/item/weapon/gun/projectile/automatic/stationary/modern/maxim/ww2{icon_state = "maxim_ww2"; dir = 1},/turf/floor/dirt,/area/caribbean/forest)
"ba" = (/obj/structure/bed/chair/drivers/tank{icon_state = "driver_tank"; dir = 1},/obj/structure/vehicleparts/frame/rf{icon_state = "frame_steel"; dir = 1},/turf/floor/dirt,/area/caribbean/forest)
"bb" = (/obj/structure/bed/chair/gunner{icon_state = "officechair_white"; dir = 4},/obj/structure/vehicleparts/frame/lwall{icon_state = "frame_steel"; dir = 1},/turf/floor/dirt,/area/caribbean/forest)
"bc" = (/obj/structure/bed/chair/commander{icon_state = "commanders_seat"; dir = 1},/obj/structure/vehicleparts/frame/rwall{icon_state = "frame_steel"; dir = 1},/turf/floor/dirt,/area/caribbean/forest)
"be" = (/obj/item/weapon/reagent_containers/glass/barrel/modern/diesel,/turf/floor/dirt,/area/caribbean/forest)
"bk" = (/obj/structure/bed/chair/loader{icon_state = "officechair_white"; dir = 1},/obj/structure/vehicleparts/frame{icon_state = "frame_steel"; dir = 1},/turf/floor/dirt,/area/caribbean/forest)
"bm" = (/obj/item/weapon/reagent_containers/glass/barrel/fueltank/tank/fueled,/obj/structure/vehicleparts/frame/lb{icon_state = "frame_steel"; dir = 1},/turf/floor/dirt,/area/caribbean/forest)
"bn" = (/obj/effect/landmark{name = "JoinLateGE"},/turf/floor/grass,/area/caribbean/forest)
"bp" = (/obj/structure/vehicleparts/movement/tracks/reversed,/turf/floor/dirt,/area/caribbean/forest)
"bq" = (/obj/structure/cannon/modern/tank{anchored = 1; dir = 1; name = "76.2mm Mankovaya Pushka F-34"},/obj/structure/vehicleparts/frame{icon_state = "frame_steel"; dir = 1},/turf/floor/dirt,/area/caribbean/forest)
"br" = (/obj/structure/table/rack{density = 0; layer = 3},/obj/item/cannon_ball/shell,/obj/item/cannon_ball/shell,/obj/item/cannon_ball/shell,/obj/item/cannon_ball/shell,/obj/structure/vehicleparts/frame/rb{icon_state = "frame_steel"; dir = 1},/obj/item/ammo_magazine/maxim,/obj/item/ammo_magazine/maxim,/turf/floor/dirt,/area/caribbean/forest)
"bs" = (/obj/structure/closet/crate/ww2/artillery_shells,/turf/floor/dirt,/area/caribbean/forest)

(1,1,1) = {"
aaaaaaaaaaabababacababadababadababababababababababaeababababafaaabababababababababacacababababababababababababagagagabadafabababaaabaaabababaeaeaeabaaababababababababababaaaaaaabaaaaahaaababaaaaaaafaa
aaaaaaaaaaabababababababababaaabaiabababaiabababaeaeacadababaGamaaaHaaaHaaabababababababababacababababaiabababababagagababababacabababaaabaeaeabaiabaaacabafabaaabababababababababababahabababababababab
aaaaaaaaaaababababababababababababababaaabababaaaeaeabababbsbsaIaIaJaxavabacabadabababababababababababababababababagagagagagababababababaeaeabababababababababagabababahababagabababacabaiabababadababac
aaaaaaaaaaababababaaaaaaaaabababababababababaiaaaeaeaaadaaabaaaaaaawaOaAaaababafababababadababacabababafababababababagagacabagagababaeaeaeaeaaaaaeababacadabagagagagabababacabababababababababababababab
aaaaaaaaaaabababababaaaaaaaaababababababababababaeaeabababaLaLaLaaaQaRaSafabafababababababababababababababacabababacabababababababaaabaeaeaeaaaaaeajababababababagagabababababadafababafabababababababab
abababafababababababababababababadabababababababakaeabababaMaLaLaaaUayaWaaabafababaaabaiabababababababababadababababababababababababaaaaaaaeaeaeaeaaaaababafafabababababaiabababacabababababababababadab
abababababababababababacababababacababababababababaealababbnaLaLaaaXaaaXabaiabababafabababababababababababababababababababababadacababaaaaaaaeaeamaaaaababababababacabababababababababacafababababababab
abababaiabababababababababadababababababaiababababaeaeaiabababaaabaaaaabababababababababababadabababababababababaiababababacabababadabababaaaeaeanabababacabababababababaiabababababababafababafabafabaa
adababababababaiabababababababababababababababafadaeaeaeacababababababacabababababababababadababababacabababababababababababababababababababaeaeaeaoababadabababacababababababadabababababababaaabababaa
abababacabababababababababababababababababababababababaeaeabafababababaaaaaaadababababababaaabaaababababababababababababadaaabaeaeaeaaamaaaaaeaeadaaabababababababababababababababadababacababababababab
abababababacabababababababababapapababafababaiabababagaeaeabababababaaababababababafababaaaaaaaaababaqadabababababababababababaaaeaeaeaeaaaaaeajaaaaabababacabababababadabababababababababababababababab
abacabababababababarabafabababapapabababababababagabababaeaeaeaeababagababaaababababababaaapapaaaaabababababacabababababababababaaaaaaaeaeaeaeaaababababababababababagababababacabababababababababababab
adababababaiababababababababababababacabababababagagagagabaeaeaeacacabadabababababaiabaaaaapapaaababababababababababadabababacababaaaaaaaeaeamaaababadabababacabagababafabababababababadabababababababaf
abababafabababababababababababababababaiababababababagagabafaeabababababababababababababaaaaaaaaabababababababababababababagabadabababaaaeaeanababababababababagabababadacababaiabababacabababadacabafab
abababababababababababacabababaaabaaabababababababagabagagagaeaeababababababababababababababaaabababasababababababababacabagababababababaeaeaeaoaaamababagagagagababagababaaababababababafababababababab
abababaiabababababababababaaaaaaaaaaabababafacababababababacaeaeaaacabadabababababababaaabababababababababababaiabababababagagagababadacabaeaeaeaeaaabababagabababatagabababababababababababaaababababab
abababafababababababababababababaaaaaaaaaaaaaaaaabadabababaaabaeaeaaababababadabacababaiababaqacabababaiababababafabababagababagagababababaaaeaeaeaaaaababababadabababababacababafababababababababababab
abababababababababababacababadabababababaaaaaaaaaaaiabababababaeaeabababababababababababababaaababababababababababababababacabababacabababababaeaaaaaaabababagababacabababababaaakabacababababababacabab
abababaiababababababababababababababaiabababakaaaaabababaiababaeaeababababaiabababababababababababakababababababacababababababababababababadabaeaeaaajababababababadabadafaaaaaaaaababababababababababab
adababababababaiababababababababafabacabababababaaabaaabababaeaeaeabacabababababababababababababababababababaaabababababababaiafababaiababababaeaeaaababababababakabababaaaaapapaaabaaaiababadababacabab
abababacababababababababababababababababababababaaabababadabaeaeabababababadaiababababacabababacabababacabababababababababababafabababacabaaaeaeagacababababababababacababaaapapaaaaabababababababababab
abababababacababababababababababababababadababaaaaaaafababaeaeaaababababababababababababababababababababababababagagabababababababababababaaaeaeabababababababababababababaaaaaaaaabacababababababababab
abacabababababababarabafabababababababababababababaaaaababaeaeababacababababababababadabababababababababaiabababagabacabaaababababababadababaeabaaabababababababacabababagabaaaaababababaaababacaiababab
adababababaiabababababababababababacabababaiabacababaaaeaeaeabababababababafabababafababababababafababababababagagabababaiababaqacababakababaaaeaealaaafabaiababagababafafababababababababababababababab
abababababababababababacababaiababafabababababababababaeaeabababababababaiababababafacabababababababababababagababababababababaaabababagababacaaaeaeaeaeabagagagagababafababababacabadabacababababababab
abababaiabababababababababababababababababababababababaaaeadababaaababababababababababababababababababacababababababababababababaaabafacabababababagaeaeagagababababababababababakaiababafabababadacabab
adababababababaiabababababafababababababababadabadabababaeabababababababacababababababababacabadababababababababababacabababababacacadafabababababacabaeaeabafabagababababababababababababababababababab
abababacabababababababababababababacababababababababaaaaaeauaaababababababababababababababababababaaababababababababababacababadababababababaaababababaaaeaeaeaeababacaiababababababababadababababababab
abababababacababababababababababababaaabababababababababaaaeaaaaabaiabababababababababababaaaaababababababababadabababababababababababababababababaaabaaaaabagaeaaababababababababababababacabafabababab
abacabababababababarabafababababababababababababababababaaaeaaababababababacababababaaababababababacabaaamababababababababababababababababababababababababaaaeaeababababatatabababababababababababababac
adababababaiababababababababaaababababababafabababababababaeabababaaabaaabaaababababababababababaaabababababababaaabafacadababacababababababababababababaiaaaeaeaaadababagagabababadabababababababababab
aiababababababaiabababababababababababababababababababababaeaaabaaaaabaiabababababababababadababababababababababacacadafabababaaabaiababafababababafabababababaeababababafababagagabacababababababadabab
abababababababababababababababacababababababababababababaaaeaaaaaaababababababababababaaabaiabababababafabababadabababababababababababababababababababababababaeabababacababaaabagacababababababacabagab
ababababababababababababababababacababababababababaiababaeaeababababababababadabababababababababababababababababababababababababababababadababababababababababaealabababafababababacabadabacabababababab
acababababababacababababababaiabababababafacadabababababaeaeaaadabababababadababababacabababababadababababababababababababadabababababadababababacabababababafaeaeaiabababababababakaiababafabababadacab
abababababafababababababafabababababababadafababafabababaeaeabababababababacabaaabababababababadababababacabababababafababaiabababababacabaaababababababaaababaeaeaeacababababababababababababababababab
ababababababadababababababadabababababababababababacababakaeabababababababababababababababababacabaaababababaaabaiababababababababababababababababaiababababababaealaeabaiadabababababababadabababababab
ababababababababababababababababababaiababababababababababaealababababababababababababababababababababababaiabababababababababababababababababababababababababaeaeaeaiababababababababababababababababab
ababaiababababababaiababababaaababababababababadabababababaeaeaiababacabaiababababadabababababababababababababababababadababababacabaiababababadababababacababaeaeaeaeacabababacababababababababaaababab
ababababababababababababababacacabadababababababababababaeaeaeaeacabababababababababababacabaiababababadababababababadababababababababababababababababababadabaeaeababababababababababababababababababab
abadababababababadabababababababaiababacababacafabababaeaeaeaeaaabababaiabababababaaaaabababababababababababababababacabaaababababababaaababababababababafadaeaeaeacababababababababaaabafacadababacabab
abaiababababababaiababababababababababababafababababababaeauaeabaaaaabababababababababafafabaaabababaaabababababababababababababaiababababababababababacabababaeaeabababababababababacacadafabababababab
ababababababababababababababababacabababababababababadabaeaaaeababababacababababababababababababababamababababababababababababababababababababababababababababaeaeababababababababababababababababacabab
afababababababafabababababababababababababababababaiabababaeaeaaabababababababababababafadabababababaiababababacabaiababababadababababacababababababababababababaeabafabaiabababadababababababababababab
aaaaaaaaaaababababaaababababababababababababadabababababababaeaeabababababababaiababababababababababababababababababababababababababababadabababababababadababaeaeababababababababababababababadabababab
abacabababababababababafadababababacabababababababafababababaeacabafafacadababababababababababacababababababababababababaaabababababababababababaBababababababaeaeaeabababaaaaababababababababaiabababab
abababababababaiababababababababababababababacabaiababafafaaaeababafadafababafabababababababababababababacabadababaaaaababacadabababababababadababababababababaeaeacababababababababafacadababababababab
ababafafadababababababababababacabaiabababadabababababadafaaaeaeabababababababacababababababaiabababadabababababababababafabababababababababababababababadabaeaaaeababaiabacababababadafababafababababab
ababababababafababababababababababakabababababababagagagababaeaeabaqababababababababababafababababababacabababababababababababababadababababababaiababababaeaeaeabababababababababababababababacabababab
abafabababababacababababababaiabababababababacagagagagagagagabaeabababababadabababababababadababababababababafababababaaacabacababababababababababababafadaeaeaeacabababababababaiababababababababababab
ababababababababababababafabababababababaaababagagagababababaeaeabababababababababababababababababababaiacabababababababababababababababababababababacabaeabaeaeabababababababababababababababaaabaaabaa
abababababababababafadabababababababababababagagabadacabababaeababaiababacafabababaiababababaaabababadadababababababafafabababacababababaiabababababababababaeaeaeababababababababaaababaiabababaaaaafab
abababababaiababababababababababadababadababababababababababaeababababafababababababababababacacabababababababababababababababababababababababababababababababaeabafabaiabababafababababababaaaaahaaabab
afacadababababababababababacaaababababaaabaiabababaiabababaeaeacadabababababababadababababababababababacababababaiababababababaiabababababababababababadababaeaeababababababababaaaaababababababahababab
adafababafabababababababababacacababababababababaaabababaaaeaeababababababababaiababacabadababababababababababababababababababababababababababaBababababababaeaeaeabababaaaaabababababababababacabaiabab
abababababacababababababaiabababaaaaabababababababababaiaaaeaeaaadabababababadababababababababababadababacabababafabababacadabababababababadababababababababaeaeacababababababadabadabababababababababab
ababababababababababafabababababaaaaaaababababababababababaeaeabababababababababababababafabababababababababababababacababababababababababababababababadababaaaeababaiabacabababababababababababafababab
abababadabababababababadababababacababababadabababababababakaeabababacabababababababababababaaabaiabababababababababadabababababacabababababababababababababaeaeababababagagabagagababababababababababab
abababababababababababababababababababababacababababababababaealabababababaiaaabababaiababababababababababababababababababababababababababababababababababaCaeabagabagagababababagabababacabababacafabab
ababacafabababaiababababaaabababababadababababababaiababababaeaeaiababababababababababababababababababadabababababababababababaiabababafababababacabadabaeaeaeabacababababaCabababafabababababababafabab
abafababababababababababacacabacababababababababababababafadaeaeaeacababababababacabababababababababadababababacabababababafababababababadabababababaeaeaeaeaeababababababababababababababababababababab
ababababababadababababababababababababababababababababacabababaeaeabababababababababababababababababacabaaababababababaaababacababababababababababaeaeaeadababababababafabababadabacababababacababababac
ababababababababacabadabababababacababababaiabababaaabababababaeaeabababababababababaaababaiababababababababababaiabababababababababababababadababaeaeaeacababababadabababababababababababababababababab
ababababaBabababababababababababababababababababababababababababaeabafabaiabababafababababababababababababababababababababababababaiababababababaaaeaeaaabababaiabacabababadababacabababababababababafac
ababadabababababaBabababababababaiabababababababababababadababaeaeababababababababaaaaababababacabaiababababadababababacabababababababababaaabadaaaeaeaeabababababababababababababaaabadabababaiabababab
ababababababadabababababababababababababababababaBababababababaeaeaeabababaaaaabababababababababababababababababababababadababababadababababaeaaaeaeaeaeabababababababababababababababadabababababababab
aaaaaaaaabababababababababacadabababababababadababababababababaeaeacababababababadabadababababababababababacababababababababababacabababaeaeaeaeaeaeaeaaaaababababababaaababaaabababacababababacababacab
acababababababababaiabababababababababababaaababababababadababaaaeababaiabacababababababababababababadabafababababababadabababababababadababaeaeabababaiabababababababababababababababababababababadabab
ababababafacadabababaaababababababacabababababababababababababaeaeababababagagabagagababababababababababababababababababababababababababababaeaeaeababababababababababacabababababadabababababababababab
ababababadafababafaaaaaaaaaaababababababababababababababababaCaeabagabagagababababagabababacabaiababababababababaiabababababaiabababababababaeaeacabababababababababababababababababadabababafabababaiab
abababababababababaaapapaaabababaiabababafababababacabadabaeaeaeabacababababaCabababafabababababababababababababacababababababababamabadababaaaeababaiacababababababaiabababafababababababaaaaababababab
ababaiababababababaaapapaaabafababababababadabababaaabababaeaeaeababababababababababababababababababacabaiabababagagagagagabababababababababaeaeababababababababafababababababadabacababaaapapaaabababac
abababababababadabaaaaaaaaaaabadababababababaiabababababaeaeaeaaababababababababababaiabababababababababababababagagabababababafabababababaCaeabagabagababababababadababababababaaabarabaaapapaaabababab
abadabababababababaaababababaaabababababababababababababaeaeaeabaiababababababadababababababaiabababababababababababaiababarababababadabaeaeaeabacabababababababababababababababababababaaaaaaababababac
aiababacababacafabababaiababababaaabafacadababababababababaeaeacababababaiabababababacabababababababababaaaaaaaaabacabababababababaBababaeaeaeababababababaiababababaaabafacadababacabababababababababab
abababababafababababababababababacacadafababababaiabadababauaeabababababababababababababacabababababababaaapapaaabakabababababakabababaeaeaeaaabababababababababababacacadafabababababababababababababab
acabababababababababadabababababababababababababababababababaeabababarabacabababacabababababababarabafabaaapapaaabababababababababababaeaeaeabaiababababadababababababababababababacababababacababababab
abababababababababaiababacabadabababababababababababababababaeaDabababababababadababababaiabababababababaaaaaaaaabababaiababababaEabababaeaeacababababaiababacabadababababababababababababababafabadabab
ababababababababadababababababababababababadacakababadababaeaeababababababaiabababababababababababababababababababababababababacababababauaeabababababababababababababababababadabababababababababababab
abababababaiabababababababababababaiabababadabababababababaeaeaeababadababababababababababacabababababababababababababababababababababababaeabababarabafababacababababababababaiabababababababababababab
afacadababababababababababacadabababababababababafababababaeaeacababababafabababababababababacababababababababaiababababababababababadababaeaeabababababacabababababafacadababababababababababacabababab
adafababafabababababababababababababafadababababababadababaaaeababaiabababacababababababaiabababababafacadababababababababababacabababababaeaeaeababababababababababadafababafababababababababababababab
abababababacababababababababaiababababababababababababababaeaeabababababababababababafabababababababadafababafababababababababababababababaeaeacababadababababababababababababacababababababaiabababafab
abababababababababafacadababababababababababacabababababaCaeabagabagabadabababababababadabababababababababababacababababababaiabababadababaaaeababaiababababababaiabababababababababababafababababababad
abababadabababababadafababafabababababababababababadabaeaeaeabacababababababababababababababababaiabababababababababababafababababababababaeaeabababafababababababababababadabababababababadabababababab
ababababababababababababababacababababababaiabababababaeaeaeababababacafabababaiababababaaababababababababadabababababababadababababababaCaeabagabagabababababadabababababababababababababababababababab
ababacafabababaiabababababababababababafababababababaeaeaeaaababababababababababababababacacabadabababababababababababababababababadabaeaeaeabacabababababadaiababacababacafabababaiababababaaabafacadab
abafababababababababababadabababababababadabababababaeaeaeabaiabababababababadabababababababaiababacababacafabababaiababababaaabafababaeaeaeababababababaiababababababafababababababababababacacadafabab
ababababababadababababababababababababababababababababaeaeacababaaabababababaiababaaabababababababababafababababababababababacacadabaeaeaeaaabababababadababacabababababababababadababababababababababab
abababababaiababacababacafabababaiababababaaabafacababauaeabababababacadababababababababababacabababababababababadabababababababababaeaeaeabaiababababababababababababababababaiababacabadababababababab
ababababadabababababafababababababababababacacadafabababaeabababarabafababafaaaaabababacabababababababababababaiababacabadababababababaeaeacababababababababababababababababadababababababababababababad
abababababacabababababababababadababababababababadabaeaeaaajababababaaabaaaTaaaVaaafafababaiabababafababababadababababababababababababauaeabababababacababaaabababababababababacababababababaiabababafab
ababababababababababababababaiababacabadababababababaeaeaaabababaaaYaYaYaaaZazbaababacabababababababadabababababababafabababababababababaeabababarabababababababaiabababababababababababafababababababad
abababadabababababababababadababababababababababaaaeaeagacababababaYaYaYaabbbqbcaaafababadababababababadabababababababadabababababadabaeaeaaajababababababababababababababadabababababababadabababababab
ababababababababababababababababababababababababaaaeaeabababaCabaaaYaYaYaaaNbkaPaaababababababababababababababababababababababababababaeaeaaabababababababababadabababababababababababababababababababab
ababacafabababaiababababacafabababaiababababaaababaeaeaaabaeaeabamaabsaaaabmaKbrabaaabababaaabafacadabafabababaiababababaaabafacabaaaeaeagacababababababaiabaiababacababacafabababaiababababaaabafacadab
abafabababababababababafababababababababababacababaaaeaeabaeaeaeabaabsaaafbpaabpabababababacacadafabababababababababababacacadafabaaaeaeabababababababababababababababafababababababababababacacadafabab
ababababababadabababababababababadababababababababacaaaeaeaeaeaeababaaaaaaabababaaabaaabababababababababababadabababababababababababaeabaaababababababadababacabababababababababadababababababababababab
abababababaiababacababababababaiababacabadabababababababaeaeaeaeababbebeababaiababacabadabababababababababaiababacabadabababababababaaaeaealaaafababaiababacabababababababababaiababacabadababababababab
aFabababadabababababababababadababababababababababaaabadabaeaeababababababadababababababababababababadabadabababababababababababababacaaaeaeaeaeabadababababababababababababadababababababababababababad
"}
