"aa" = (/turf/floor/beach/water/deep/saltwater,/area/caribbean/sea/top)
"ab" = (/turf/floor/dirt/underground,/area/caribbean/sea/top/roofed)
"ad" = (/turf/floor/beach/sand,/area/caribbean/sea/top)
"ae" = (/obj/map_metadata/voyage,/turf/floor/dirt/underground,/area/caribbean/sea/top/roofed)
"af" = (/obj/covers/wood_wall/adjustable,/turf/floor/beach/sand,/area/caribbean/sea/top/roofed)
"ag" = (/obj/covers/wood,/obj/structure/oven,/turf/floor/beach/sand,/area/caribbean/sea/top/roofed)
"ah" = (/obj/covers/wood,/obj/structure/table/wood,/turf/floor/beach/sand,/area/caribbean/sea/top/roofed)
"ai" = (/turf/floor/beach/sand/dark,/area/caribbean/sea/top)
"aj" = (/obj/covers/wood,/obj/structure/pot,/turf/floor/beach/sand,/area/caribbean/sea/top/roofed)
"ak" = (/obj/covers/wood,/obj/covers/wood_wall/adjustable,/turf/floor/beach/sand,/area/caribbean/sea/top/roofed)
"al" = (/obj/covers/wood,/obj/structure/bed/wood,/turf/floor/beach/sand,/area/caribbean/sea/top/roofed)
"am" = (/obj/covers/wood,/turf/floor/beach/sand,/area/caribbean/sea/top/roofed)
"an" = (/obj/covers/wood,/obj/item/weapon/reagent_containers/glass/barrel/rum,/turf/floor/beach/sand,/area/caribbean/sea/top/roofed)
"ao" = (/obj/covers/wood,/obj/item/weapon/reagent_containers/food/drinks/bottle/rum,/obj/item/weapon/reagent_containers/food/drinks/bottle/rum,/obj/item/weapon/reagent_containers/food/drinks/bottle/rum,/obj/item/weapon/reagent_containers/food/drinks/bottle/rum,/obj/item/weapon/reagent_containers/food/drinks/bottle/rum,/obj/item/weapon/reagent_containers/food/drinks/bottle/rum,/obj/item/weapon/reagent_containers/food/drinks/bottle/rum,/obj/item/weapon/reagent_containers/food/drinks/bottle/rum,/obj/item/weapon/reagent_containers/food/drinks/bottle/rum,/obj/item/weapon/reagent_containers/food/drinks/bottle/rum,/obj/item/weapon/reagent_containers/food/drinks/bottle/rum,/obj/item/weapon/reagent_containers/food/drinks/bottle/rum,/obj/item/weapon/reagent_containers/food/drinks/bottle/rum,/obj/item/weapon/reagent_containers/food/drinks/bottle/rum,/obj/item/weapon/reagent_containers/food/drinks/bottle/rum,/obj/structure/closet/cabinet,/turf/floor/beach/sand,/area/caribbean/sea/top/roofed)
"ap" = (/obj/covers/wood_ship,/turf/floor/beach/sand,/area/caribbean/sea/top)
"aq" = (/obj/covers/wood,/obj/structure/closet/cabinet,/obj/item/weapon/reagent_containers/food/drinks/bottle/small/beer,/obj/item/weapon/reagent_containers/food/drinks/bottle/small/beer,/obj/item/weapon/reagent_containers/food/drinks/bottle/small/beer,/obj/item/weapon/reagent_containers/food/drinks/bottle/small/beer,/obj/item/weapon/reagent_containers/food/drinks/bottle/small/beer,/obj/item/weapon/reagent_containers/food/drinks/bottle/small/beer,/obj/item/weapon/reagent_containers/food/drinks/bottle/small/beer,/obj/item/weapon/reagent_containers/food/drinks/bottle/small/beer,/obj/item/weapon/reagent_containers/food/drinks/bottle/small/beer,/obj/item/weapon/reagent_containers/food/drinks/bottle/small/beer,/obj/item/weapon/reagent_containers/food/drinks/bottle/small/beer,/obj/item/weapon/reagent_containers/food/drinks/bottle/small/beer,/obj/item/weapon/reagent_containers/food/drinks/bottle/small/beer,/obj/item/weapon/reagent_containers/food/drinks/bottle/small/beer,/turf/floor/beach/sand,/area/caribbean/sea/top/roofed)
"ar" = (/turf/floor/beach/water/shallowsaltwater,/area/caribbean/sea/top)
"as" = (/obj/covers/wood_ship,/turf/floor/beach/water/shallowsaltwater,/area/caribbean/sea/top)
"au" = (/obj/covers/wood_ship,/obj/structure/railing{dir = 8},/turf/floor/beach/water/deep/saltwater,/area/caribbean/sea/top)
"av" = (/obj/covers/wood_ship,/turf/floor/beach/water/deep/saltwater,/area/caribbean/sea/top)
"aw" = (/obj/covers/wood,/obj/structure/table/wood,/obj/item/weapon/reagent_containers/food/drinks/drinkingglass/wood,/turf/floor/beach/sand,/area/caribbean/sea/top/roofed)
"ax" = (/obj/covers/wood,/obj/item/weapon/stool/wood,/turf/floor/beach/sand,/area/caribbean/sea/top/roofed)
"ay" = (/obj/covers/wood,/obj/structure/bed/chair/wood{dir = 4; icon_state = "wooden_chair"},/mob/living/simple_animal/hostile/human/pirate/friendly,/turf/floor/beach/sand,/area/caribbean/sea/top/roofed)
"az" = (/obj/covers/wood,/obj/structure/table/wood,/obj/item/weapon/reagent_containers/food/drinks/bottle/rum,/turf/floor/beach/sand,/area/caribbean/sea/top/roofed)
"aA" = (/obj/covers/wood,/obj/structure/bed/chair/wood{dir = 8; icon_state = "wooden_chair"},/turf/floor/beach/sand,/area/caribbean/sea/top/roofed)
"aB" = (/obj/covers/wood,/obj/structure/bed/chair/wood{dir = 4; icon_state = "wooden_chair"},/turf/floor/beach/sand,/area/caribbean/sea/top/roofed)
"aC" = (/obj/covers/wood,/obj/covers/wood_wall/adjustable,/obj/item/flashlight/lantern/on/anchored,/turf/floor/beach/sand,/area/caribbean/sea/top/roofed)
"aD" = (/obj/covers/wood,/obj/structure/simple_door/key_door/anyone,/turf/floor/beach/sand,/area/caribbean/sea/top/roofed)
"aE" = (/obj/covers/wood,/obj/structure/toilet/pit_latrine,/turf/floor/beach/sand,/area/caribbean/sea/top/roofed)
"aF" = (/obj/covers/wood,/mob/living/simple_animal/hostile/human/pirate/friendly,/turf/floor/beach/sand,/area/caribbean/sea/top/roofed)
"aG" = (/obj/covers/wood,/obj/structure/bed/chair/wood{dir = 8; icon_state = "wooden_chair"},/mob/living/simple_animal/hostile/human/voyage/civilian,/turf/floor/beach/sand,/area/caribbean/sea/top/roofed)
"aH" = (/obj/covers/wood,/obj/structure/table/wood,/turf/floor/beach/sand/dark,/area/caribbean/sea/top/roofed)
"aI" = (/obj/covers/wood,/obj/structure/table/wood,/obj/item/weapon/pen,/obj/item/weapon/paper,/turf/floor/beach/sand/dark,/area/caribbean/sea/top/roofed)
"aJ" = (/obj/covers/wood,/obj/covers/wood_wall/adjustable,/turf/floor/beach/sand/dark,/area/caribbean/sea/top/roofed)
"aK" = (/obj/covers/wood,/turf/floor/beach/sand/dark,/area/caribbean/sea/top/roofed)
"aL" = (/obj/covers/wood,/obj/structure/bed/wood,/turf/floor/beach/sand/dark,/area/caribbean/sea/top/roofed)
"aM" = (/obj/covers/wood_wall/adjustable,/obj/item/flashlight/lantern/on/anchored,/turf/floor/beach/sand,/area/caribbean/sea/top/roofed)
"aN" = (/obj/covers/wood,/obj/structure/bed/chair/wood{dir = 1; icon_state = "wooden_chair"},/turf/floor/beach/sand/dark,/area/caribbean/sea/top/roofed)
"aO" = (/obj/covers/wood,/obj/item/weapon/reagent_containers/food/drinks/bottle/small/healing/vigorous,/obj/structure/closet/cabinet,/mob/living/simple_animal/hostile/human/british/ranged,/turf/floor/beach/sand,/area/caribbean/sea/top/roofed)
"aP" = (/obj/structure/wild/palm,/turf/floor/beach/sand,/area/caribbean/sea/top)
"aQ" = (/obj/covers/wood,/obj/structure/simple_door/key_door/anyone,/turf/floor/beach/sand/dark,/area/caribbean/sea/top/roofed)
"aR" = (/obj/covers/wood,/mob/living/simple_animal/hostile/human/voyage/barmaiden,/turf/floor/beach/sand,/area/caribbean/sea/top/roofed)
"aS" = (/obj/covers/wood,/obj/structure/window/classic/reinforced,/turf/floor/beach/sand,/area/caribbean/sea/top/roofed)
"aT" = (/obj/covers/wood,/obj/structure/barricade/wood_pole,/obj/item/flashlight/lantern/on/anchored{pixel_x = 0; pixel_y = 10},/turf/floor/beach/sand,/area/caribbean/sea/top/roofed)
"aU" = (/obj/covers/wood_wall/nordic,/turf/floor/beach/sand,/area/caribbean/sea/top/roofed)
"aV" = (/obj/covers/wood,/obj/covers/wood_wall/adjustable,/obj/item/flashlight/lantern/on/anchored,/turf/floor/beach/sand/dark,/area/caribbean/sea/top/roofed)
"aW" = (/obj/covers/wood,/obj/structure/bed/chair/wood,/turf/floor/beach/sand,/area/caribbean/sea/top/roofed)
"aX" = (/obj/covers/wood,/obj/structure/bed/chair/wood,/mob/living/simple_animal/hostile/human/pirate/friendly,/turf/floor/beach/sand,/area/caribbean/sea/top/roofed)
"aY" = (/mob/living/simple_animal/hostile/human/pirate/friendly/blindman,/turf/floor/beach/sand,/area/caribbean/sea/top)
"aZ" = (/obj/covers/cobblestone/stairs{dir = 1; icon_state = "rampup"},/turf/floor/beach/sand,/area/caribbean/sea/top)
"ba" = (/obj/covers/cobblestone/stairs{dir = 1; icon_state = "rampup"},/turf/floor/beach/sand/dark,/area/caribbean/sea/top)
"bb" = (/obj/structure/toilet/outhouse/female,/turf/floor/beach/sand/dark,/area/caribbean/sea/top)
"bc" = (/obj/structure/toilet/outhouse/male,/turf/floor/beach/sand/dark,/area/caribbean/sea/top)
"bd" = (/obj/structure/exportbook{faction = "pirates"; faction_treasury = "TreasuryPR"},/turf/floor/beach/sand/dark,/area/caribbean/sea/top/roofed)
"be" = (/obj/structure/supplybook{faction = "pirates"; faction_treasury = "TreasuryPR"; factionarea = "SupplyPR"},/turf/floor/beach/sand/dark,/area/caribbean/sea/top/roofed)
"bf" = (/turf/floor/beach/sand/dark,/area/caribbean/sea/top/roofed)
"bg" = (/obj/covers/wood,/obj/structure/closet/cabinet,/turf/floor/beach/sand,/area/caribbean/sea/top/roofed)
"bh" = (/obj/covers/wood,/obj/structure/window/classic/reinforced,/turf/floor/beach/sand/dark,/area/caribbean/sea/top/roofed)
"bi" = (/obj/covers/wood,/obj/structure/bed/chair/wood{dir = 8; icon_state = "wooden_chair"},/mob/living/simple_animal/hostile/human/pirate/friendly/captain,/turf/floor/beach/sand,/area/caribbean/sea/top/roofed)
"bj" = (/obj/covers/wood,/obj/structure/bed/chair/wood{dir = 8; icon_state = "wooden_chair"},/mob/living/simple_animal/hostile/human/voyage/barmaiden,/turf/floor/beach/sand,/area/caribbean/sea/top/roofed)
"bk" = (/obj/structure/window/classic/reinforced,/obj/covers/wood,/turf/floor/beach/sand,/area/caribbean/sea/top/roofed)
"bl" = (/obj/covers/wood,/obj/covers/saloon_door,/turf/floor/beach/sand,/area/caribbean/sea/top/roofed)
"bm" = (/obj/covers/wood_wall/nordic,/obj/item/flashlight/lantern/on/anchored,/turf/floor/beach/sand,/area/caribbean/sea/top/roofed)
"bn" = (/obj/structure/table/wood,/turf/floor/beach/sand/dark,/area/caribbean/sea/top/roofed)
"bo" = (/obj/covers/saloon_door,/turf/floor/beach/sand/dark,/area/caribbean/sea/top/roofed)
"bp" = (/obj/covers/wood,/obj/structure/pot,/turf/floor/beach/sand/dark,/area/caribbean/sea/top/roofed)
"bq" = (/obj/covers/wood,/obj/structure/table/wood,/obj/structure/mill,/turf/floor/beach/sand/dark,/area/caribbean/sea/top/roofed)
"br" = (/obj/covers/wood,/obj/structure/oven,/turf/floor/beach/sand/dark,/area/caribbean/sea/top/roofed)
"bs" = (/obj/covers/cobblestone,/turf/floor/beach/sand/dark,/area/caribbean/sea/top/roofed)
"bt" = (/obj/structure/sink/well,/obj/structure/mine_support,/turf/floor/beach/sand/dark,/area/caribbean/sea/top/roofed)
"bu" = (/obj/covers/cobblestone,/obj/structure/repair/grindstone,/turf/floor/beach/sand/dark,/area/caribbean/sea/top/roofed)
"bv" = (/obj/covers/wood,/obj/structure/bed/chair/wood{dir = 4; icon_state = "wooden_chair"},/mob/living/simple_animal/hostile/human/pirate/friendly/female,/turf/floor/beach/sand,/area/caribbean/sea/top/roofed)
"bw" = (/mob/living/simple_animal/hostile/human/pirate/friendly,/turf/floor/beach/sand,/area/caribbean/sea/top)
"bx" = (/obj/covers/cobblestone,/obj/structure/repair/gun,/turf/floor/beach/sand/dark,/area/caribbean/sea/top/roofed)
"by" = (/obj/covers/cobblestone,/obj/item/weapon/clay/mold/clayjug/fired,/turf/floor/beach/sand/dark,/area/caribbean/sea/top/roofed)
"bz" = (/obj/covers/cobblestone,/obj/structure/table/wood,/obj/item/weapon/clay/mold/axehead/fired,/obj/item/weapon/clay/mold/shovel/fired,/obj/item/weapon/clay/mold/sword/fired,/obj/item/stack/material/copper{amount = 250},/turf/floor/beach/sand/dark,/area/caribbean/sea/top/roofed)
"bA" = (/obj/covers/cobblestone,/obj/structure/table/wood,/obj/item/weapon/clay/mold/pickaxe/fired,/obj/item/stack/material/iron/twentyfive,/obj/item/stack/material/iron/twentyfive,/obj/item/stack/material/iron/twentyfive,/obj/item/stack/material/iron/twentyfive,/obj/item/stack/material/iron/twentyfive,/obj/item/stack/material/iron/twentyfive,/obj/item/stack/material/iron/twentyfive,/obj/item/stack/material/iron/twentyfive,/obj/item/stack/material/iron/twentyfive,/obj/item/stack/material/iron/twentyfive,/turf/floor/beach/sand/dark,/area/caribbean/sea/top/roofed)
"bB" = (/obj/covers/cobblestone,/obj/structure/table/wood,/obj/item/weapon/clay/mold/fired,/obj/item/weapon/clay/mold/knife/fired,/obj/item/stack/material/steel/twentyfive,/obj/item/stack/material/steel/twentyfive,/obj/item/stack/material/steel/twentyfive,/obj/item/stack/material/steel/twentyfive,/obj/item/stack/material/steel/twentyfive,/obj/item/stack/material/steel/twentyfive,/obj/item/stack/material/steel/twentyfive,/obj/item/stack/material/steel/twentyfive,/obj/item/stack/material/steel/twentyfive,/obj/item/stack/material/steel/twentyfive,/turf/floor/beach/sand/dark,/area/caribbean/sea/top/roofed)
"bC" = (/obj/covers/cobblestone,/obj/structure/furnace/kiln,/turf/floor/beach/sand/dark,/area/caribbean/sea/top/roofed)
"bD" = (/obj/covers/cobblestone,/obj/structure/furnace/blast_furnace,/turf/floor/beach/sand/dark,/area/caribbean/sea/top/roofed)
"bE" = (/obj/covers/cobblestone,/obj/structure/furnace,/turf/floor/beach/sand/dark,/area/caribbean/sea/top/roofed)
"bF" = (/obj/covers/cobblestone,/obj/structure/anvil/steel,/turf/floor/beach/sand/dark,/area/caribbean/sea/top/roofed)
"bG" = (/obj/item/flashlight/lantern/on/anchored{pixel_x = 0; pixel_y = 10},/obj/structure/barricade/wood_pole,/turf/floor/beach/sand/dark,/area/caribbean/sea/top/roofed)
"bH" = (/obj/covers/wood,/obj/structure/bed/chair/wood{dir = 4; icon_state = "wooden_chair"},/mob/living/simple_animal/hostile/human/voyage/civilian,/turf/floor/beach/sand,/area/caribbean/sea/top/roofed)
"bI" = (/obj/covers/wood,/obj/structure/bed/chair/wood{dir = 8; icon_state = "wooden_chair"},/mob/living/simple_animal/hostile/human/voyage/civilian_f,/turf/floor/beach/sand,/area/caribbean/sea/top/roofed)
"bJ" = (/mob/living/simple_animal/hostile/human/voyage/merchant,/turf/floor/beach/sand/dark,/area/caribbean/sea/top/roofed)
"bK" = (/obj/covers/wood,/mob/living/simple_animal/hostile/human/voyage/civilian_f,/turf/floor/beach/sand,/area/caribbean/sea/top/roofed)
"bL" = (/obj/covers/wood,/mob/living/simple_animal/hostile/human/voyage/civilian,/turf/floor/beach/sand,/area/caribbean/sea/top/roofed)
"bM" = (/obj/covers/wood,/mob/living/simple_animal/hostile/human/voyage/civilian_f,/turf/floor/beach/sand/dark,/area/caribbean/sea/top/roofed)
"bN" = (/obj/covers/wood,/mob/living/simple_animal/hostile/human/voyage/civilian,/turf/floor/beach/sand/dark,/area/caribbean/sea/top/roofed)
"bO" = (/obj/covers/cobblestone,/mob/living/simple_animal/hostile/human/voyage/civilian,/turf/floor/beach/sand/dark,/area/caribbean/sea/top/roofed)
"bP" = (/obj/covers/wood,/obj/structure/roof_support,/obj/item/flashlight/lantern/on/anchored{pixel_x = 0; pixel_y = 10},/turf/floor/beach/sand,/area/caribbean/sea/top/roofed)
"bQ" = (/obj/covers/wood,/obj/structure/bed/wood,/obj/item/flashlight/lantern/on/anchored{pixel_x = 0; pixel_y = 10},/turf/floor/beach/sand,/area/caribbean/sea/top/roofed)
"bR" = (/obj/covers/wood,/obj/structure/oven,/obj/item/flashlight/lantern/on/anchored{pixel_x = 0; pixel_y = 10},/turf/floor/beach/sand,/area/caribbean/sea/top/roofed)
"fO" = (/obj/covers/wood,/obj/item/flashlight/lantern/on/anchored{pixel_x = 0; pixel_y = 10},/obj/structure/barricade/wood_pole,/turf/floor/beach/sand,/area/caribbean/sea/top/roofed)
"hE" = (/obj/structure/practice_dummy/target,/turf/floor/beach/sand,/area/caribbean/sea/top)
"jR" = (/obj/structure/practice_dummy,/turf/floor/beach/sand,/area/caribbean/sea/top)
"rW" = (/obj/covers/wood_ship,/obj/structure/bed/chair{dir = 4},/turf/floor/beach/water/shallowsaltwater,/area/caribbean/sea/top)
"uK" = (/obj/covers/wood_ship,/obj/structure/railing{dir = 4},/turf/floor/beach/water/shallowsaltwater,/area/caribbean/sea/top)
"FV" = (/obj/structure/wild/tallgrass2,/turf/floor/beach/sand,/area/caribbean/sea/top)
"Kb" = (/obj/structure/wild/burnedbush,/turf/floor/beach/sand,/area/caribbean/sea/top)
"NV" = (/mob/living/simple_animal/dog,/turf/floor/beach/sand,/area/caribbean/sea/top)
"QX" = (/obj/covers/wood_ship,/obj/structure/table/fancy,/obj/item/weapon/paper,/turf/floor/beach/water/deep/saltwater,/area/caribbean/sea/top)
"RT" = (/obj/structure/flag/pirates,/turf/floor/beach/sand,/area/caribbean/sea/top)
"Zg" = (/obj/covers/wood_ship,/obj/structure/railing{dir = 4},/turf/floor/beach/water/deep/saltwater,/area/caribbean/sea/top)

(1,1,1) = {"
ababababababababababababababababababababababababababababababababababababababababababababababababababababababababababababababababababababababababababab
ababababababababababababababababababababababababababababababababababababababababababababababababababababababababababababababababababababababababababab
ababababababababababababababababababababababababababababababababababababababababababababababababababababababababababababababababababababababababababab
ababababababababababababababababababababababababababababababababababababababababababababababababababababababababababababababababababababababababababab
ababababababababababababababababababababababababababababababababababababababababababababababababababababababababababababababababababababababababababab
ababababababababababababababababababababababababababababababababababababababababababababababababababababababababababababababababababababababababababab
ababababababababababababababababababababababababababababababababababababababababababababababababababababababababababababababababababababababababababab
ababababababababababababababababababababababababababababababababababababababababababababababababababababababababababababababababababababababababababab
ababababababababababababababababababababababababababababababababababababababababababababababababababababababababababababababababababababababababababab
ababababababababababababababababababababababababababababababababababababababababababababababababababababababababababababababababababababababababababab
ababababababababababababababababababababababababababababababababababababababababababababababababababababababababababababababababababababababababababab
ababababababababababababababababababababababababababababababababababababababababababababababababababababababababababababababababababababababababababab
ababababababababababababababababababababababababababababababababababababababababababababababababababababababababababababababababababababababababababab
ababababababababababababababababababababababababababababababababababababababababababababababababababababababababababababababababababababababababababab
ababababababababababababababababababababababababababababababababababababababababababababababababababababababababababababababababababababababababababab
ababababababababababababababababababababababababababababababababababababababababababababababababababababababababababababababababababababababababababab
ababababababababababababababababababababababababababababababababababababababababababababababababababababababababababababababababababababababababababab
ababababababababababababababababababababababababababababababababababababababababababababababababababababababababababababababababababababababababababab
ababababababababababababababababababababababababababababababababababababababababababababababababababababababababababababababababababababababababababab
ababababababababababababababababababababababababababababababababababababababababababababababababababababababababababababababababababababababababababab
ababababababababababababababababababababababababababababababababababababababababababababababababababababababababababababababababababababababababababab
ababababababababababababababababababababababababababababababababababababababababababababababababababababababababababababababababababababababababababab
ababababababababababababababababababababababababababababababababababababababababababababababababababababababababababababababababababababababababababab
ababababababababababababababababababababababababababababababababababababababababababababababababababababababababababababababababababababababababababab
aeabababababababababababababababababababababababababababababababababababababababababababababababababababababababababababababababababababababababababab
"}
(1,1,2) = {"
adadadadadadadadadadadadadadadadadadadadadadadadadadadadadadaPadadadadadadadadFVadadadadadaPadadadadadadadadadadadadadafafafafafafafafafadadadadFVadad
adafafafafafafafafafafafafafafafafadadadadadadadadadFVadadadadadFVadadKbadadadadadadadadadadadadadadadadadadadadFVadadafagahahajakalamafadafafafafafaf
adafananaoaqamawaxayawazaAaBahazafadadadaPadadadadadaPadadadadadadadadadadadadadadadafafafafafafafafadafafafafafadaPadafamamamamaCamamafadafamaDamaEaf
adafamamamamaRawaxaBahawaGbvahawafadadadFVadadadadadadadadadadadadadadadadadaPFVadadafaHaIaHaJaKaLafadafagamalafadadadafambKbLamakamamafadafamafaMafaf
adafamawawawawawaxamamamamamamamafadaPadadadadKbadadadadafafafafafafafafafafjRhEhEadafaHaNaHaJaKaKafadafamamamaDadadadafamamamamaDamamafadafamafamaOaf
adafamaxaxaxaxaxamamamamamamamamafadadadadadadadadadadadafamamalakagahahajafadaiaiaiaQaKaKaKaJbMaKafadafambLamaMKbadadafafaMaDafafaSafafadafamaDamalaf
adafaTamamamamamamaTamamamamamfOafadFVaUaUaUaUaUaUaUaUadafambKamakamamamamafadaiaiaiafaKaKaKaJaVaQafadafafafafafadadadadadaiaiaiaiaiadadadafamafaMafaf
adafamamamamamamamamamamamamaWaXafadadaUbdbebfbfbfbGaUFVafaDakakaCamamamamafaiaiaiaiaMaKaKaKaKaKaKafadafagamamafadadFVadaiaiaiaiadadKbaPFVafamafbKbgaf
adafamaBawahbjayahazaAamambHawazafadaPaUbfbfbfbfbfbfaUadafamamamamamambLamafaiaiaiadbhaKaKbNaKaKaKafadafambLamaDadFVadadaiaiaiaiaiaiadadadafamaDamalaf
adafaTbHahazbiaBawahbIamamaBahawafadadaUbfbfbfbJbfbfaUadafamamamamamamamamafaiaiaiadbhaKaKaKaKaKaKafadafamamamaMadadaiaiaiaiaiaiaiaiaiadaiafamafaMafaf
adafafafaSaSafafbkbkafaMblaMafafafFVadbmbnbnbnbnbnbobmadafafafafaDaMaSaSafafaiaiaiadafbpaHaKaHbqbrafFVafalamamafadaiaiaiaiaiaiaiaiaiaiaiaiafamafbKbgaf
adamamamamamamamamamamamamamamamamadadadadaiaiaiaiadadadaPadNVFVadadadadadadaiaiaiaPafafafafafafafafadafafafafafaiaiaiadaiadadadadaiaiaiaiaDamaDamalaf
adbPamamamambPamamamambPamamamambPadaiadaiaiaiaiaiaiaiaiaiaiadadadaiadaiaiaiaiaiaiaiadadadadadKbaiadadaiadadadaiaiaiaiadadadadKbadadadaiaiafamafaMafaf
adafafafafafafafafafaiaiaiaiaiaiaiaiaiaiaiaiaiaiaiaiaiaiaiaiaiaiaiaiaiaiaiaiaiaiaiaiaiaiaiaiaiaiaiaiaiaiaiaiaiaiaiaiadafaMaDafafaSaSafafadafamafaFbgaf
adafbQamafajahahbRafaiaiaiaiaiaiaiaiaiaiadaiaiaiadadKbaiaiaiaiaiaiaiaiaiaiadadadaiaiaiaiaiaiaiaiaiaiaiaiaiaiaiaiaiadadafamamamajahahagafadafamaDamalaf
adafamamafamamamamaDaiaiaiaiaiaiaiaiadadFVadaiadadadadKbadaiaiadadaiaiadadadaYaiaiadadadaiadadaZbababababababaaZadaPadafambKamamamamamafadafafafafafaf
adafaDafaMamamaFamafaiadaiaibbbcaiadaPadadaiaiaiFVadaPadadadadFVadaiaiadadFVadaiaiadadadadadadaMbsbsbsbsbsbsbsaMadadadafamamamakaCakakafadadadKbadadad
adafamamamamamamamaSaiadadaibbbcaiadFVFVadaibtaibwadadadadadadadaiaiadadadadadaiadadadaPKbadadafbubsbsbsbObsbsafadFVadafamamamakamamalafadFVadadadadad
arafamamamambKamamafadadadadbbbcadadadadadaiaiaiadarFVadFVadadadaiaiRTadadadadaiaiadadFVadadadafbxbsbsbsbsbsbsafadKbadafamamamaDamamamafadadadFVadaPad
arafafafafafafafafafadarFVadadadFVadKbadaPadadarararararadadadadaiaiadadFVadadadaiaiadadadadadafbsbsbsbsbsbsbyafadadadafafafafafafafafafadadadadadadad
aaarararararararararararararadararararararadararararaaarauasasapapasasavasasasasasasuKararadadafbzbAbBbCbDbEbFafadadadadadadFVarararararadadadadadadFV
aaaaararararaaararaaaaaraaaradararaaaaarararararaaaaaraaauasavasrWQXasavavasavasavasuKarararFVafafafafafafafafafadadFVadarararaaararaaaaararararadFVad
aaaaaaaaaaaaaraaaaaaaaaaaaarararaaararaaaaaraaaaaaaaaaaaauZgaaaaaaarauZgaaaaaraaarauZgararaaarararadadadadadadadadarararaaaraaaraaaaarararaaaraaararar
aaaaaaaaaaaaaaaaaaaaaaaaaaaaaaaaaaaaaaaaaaaaaaaaaaaaaaaaauZgaaaaaaaaauZgaaaaaaaaaaauZgaaaaararaaaaararararararararaaarararaaaaaaaaaaaaaaaaaraaarararar
aaaaaaaaaaaaaaaaaaaaaaaaaaaaaaaaaaaaaaaaaaaaaaaaaaaaaaaaauZgaaaaaaaaauZgaaaaaaaaaaauZgaaaaaaaaararaaaaaraaaraaaaaaaraaaaaaaaaaaaaaaaaaaaaaaaaaaaaaaaar
"}
