"aa" = (/turf/floor/beach/water/deep/saltwater,/area/caribbean/sea/top)
"ab" = (/obj/structure/barricade/ship/wood/a7,/obj/item/flashlight/lantern/on/anchored,/turf/floor/beach/water/deep/saltwater,/area/caribbean/sea/top/roofed)
"ac" = (/obj/structure/barricade/ship/wood/a10,/obj/item/flashlight/lantern/on/anchored,/turf/floor/beach/water/deep/saltwater,/area/caribbean/sea/top/roofed)
"ad" = (/obj/covers/wood_ship,/obj/structure/closet/crate/chest,/obj/item/stack/money/real/fifty,/turf/floor/beach/water/deep/saltwater,/area/caribbean/sea/top/roofed)
"ae" = (/obj/covers/wood_ship,/mob/living/simple_animal/hostile/human/voyage/pirate/ranged,/turf/floor/beach/water/deep/saltwater,/area/caribbean/sea/top/roofed)
"af" = (/obj/structure/barricade/ship/wood/a12,/turf/floor/beach/water/deep/saltwater,/area/caribbean/sea/top/roofed)
"ag" = (/obj/covers/wood_ship,/obj/structure/closet/crate/musketball_pistol,/turf/floor/beach/water/deep/saltwater,/area/caribbean/sea/top/roofed)
"ah" = (/obj/covers/wood_ship,/obj/structure/simple_door/key_door/anyone,/turf/floor/beach/water/deep/saltwater,/area/caribbean/sea/top/roofed)
"ai" = (/obj/covers/wood_ship,/obj/item/weapon/reagent_containers/glass/barrel/tea,/turf/floor/beach/water/deep/saltwater,/area/caribbean/sea/top/roofed)
"aj" = (/obj/covers/wood_ship,/turf/floor/beach/water/deep/saltwater,/area/caribbean/sea/top/roofed)
"ak" = (/obj/structure/barricade/ship/wood/a5,/obj/item/flashlight/lantern/on/anchored,/turf/floor/beach/water/deep/saltwater,/area/caribbean/sea/top/roofed)
"al" = (/obj/covers/wood_ship,/obj/structure/closet/crate/rations/fruits,/turf/floor/beach/water/deep/saltwater,/area/caribbean/sea/top/roofed)
"am" = (/obj/covers/wood_ship,/obj/structure/closet/crate/wood,/turf/floor/beach/water/deep/saltwater,/area/caribbean/sea/top/roofed)
"an" = (/obj/structure/barricade/ship/wood/a2,/turf/floor/beach/water/deep/saltwater,/area/caribbean/sea/top/roofed)
"ao" = (/obj/structure/barricade/ship/wood/a4,/turf/floor/beach/water/deep/saltwater,/area/caribbean/sea/top/roofed)
"ap" = (/obj/structure/barricade/ship/wood/a12,/obj/item/flashlight/lantern/on/anchored,/turf/floor/beach/water/deep/saltwater,/area/caribbean/sea/top/roofed)
"as" = (/obj/covers/wood_ship,/obj/item/weapon/reagent_containers/glass/barrel/rum,/turf/floor/beach/water/deep/saltwater,/area/caribbean/sea/top/roofed)
"au" = (/obj/covers/wood_ship,/obj/structure/multiz/ladder/ww2/up,/turf/floor/beach/water/deep/saltwater,/area/caribbean/sea/top/roofed)
"av" = (/obj/covers/wood_ship,/obj/structure/window/barrier/ship/blue/bport_6/corner,/obj/structure/barricade/ship/blue/b20{dir = 1},/turf/floor/beach/water/deep/saltwater,/area/caribbean/sea/top/roofed)
"aA" = (/obj/structure/barricade/ship/wood/a7,/turf/floor/beach/water/deep/saltwater,/area/caribbean/sea/top/roofed)
"aB" = (/obj/structure/barricade/ship/blue/b8,/turf/floor/beach/water/deep/saltwater,/area/caribbean/sea/top/roofed)
"aC" = (/obj/structure/barricade/ship/blue/b17,/turf/floor/beach/water/deep/saltwater,/area/caribbean/sea/top/roofed)
"aD" = (/obj/structure/barricade/ship/wood/a5,/turf/floor/beach/water/deep/saltwater,/area/caribbean/sea/top/roofed)
"aE" = (/obj/structure/barricade/ship/wood/a9,/turf/floor/beach/water/deep/saltwater,/area/caribbean/sea/top/roofed)
"aG" = (/obj/covers/wood_ship,/obj/structure/closet/crate/chest,/obj/item/stack/money/goldvaluables,/turf/floor/beach/water/deep/saltwater,/area/caribbean/sea/top/roofed)
"aH" = (/obj/structure/barricade/ship/blue/b20,/obj/item/flashlight/lantern/on/anchored,/turf/floor/beach/water/deep/saltwater,/area/caribbean/sea/top/roofed)
"aI" = (/obj/covers/wood_ship,/obj/structure/closet/crate/cannonball,/turf/floor/beach/water/deep/saltwater,/area/caribbean/sea/top/roofed)
"aJ" = (/obj/covers/wood_ship,/obj/structure/closet/crate/rations/biscuits,/turf/floor/beach/water/deep/saltwater,/area/caribbean/sea/top/roofed)
"aK" = (/obj/covers/wood_ship,/obj/structure/closet/crate/musketball,/turf/floor/beach/water/deep/saltwater,/area/caribbean/sea/top/roofed)
"aL" = (/obj/covers/wood_ship,/obj/structure/vending/muskets/spanish,/turf/floor/beach/water/deep/saltwater,/area/caribbean/sea/top/roofed)
"aM" = (/obj/covers/wood_ship,/mob/living/simple_animal/hostile/human/voyage/pirate,/turf/floor/beach/water/deep/saltwater,/area/caribbean/sea/top/roofed)
"aN" = (/obj/covers/wood_ship,/obj/item/weapon/material/sword/cutlass,/obj/item/weapon/material/sword/cutlass,/obj/item/weapon/material/sword/cutlass,/obj/item/weapon/material/sword/cutlass,/obj/item/weapon/material/sword/cutlass,/turf/floor/beach/water/deep/saltwater,/area/caribbean/sea/top/roofed)
"aO" = (/obj/map_metadata/voyage,/turf/floor/beach/water/deep/saltwater,/area/caribbean/sea/top)
"aP" = (/obj/covers/wood_ship,/obj/item/weapon/reagent_containers/glass/barrel/gunpowder,/turf/floor/beach/water/deep/saltwater,/area/caribbean/sea/top/roofed)
"aQ" = (/obj/structure/barricade/ship/blue/b20{dir = 1},/obj/item/flashlight/lantern/on/anchored,/turf/floor/beach/water/deep/saltwater,/area/caribbean/sea/top/roofed)
"aR" = (/obj/structure/barricade/ship/blue/b9,/turf/floor/beach/water/deep/saltwater,/area/caribbean/sea/top/roofed)
"aS" = (/obj/structure/barricade/ship/blue/b9,/obj/item/flashlight/lantern/on/anchored,/turf/floor/beach/water/deep/saltwater,/area/caribbean/sea/top/roofed)
"aT" = (/obj/structure/window/barrier/ship/blue/bport3{dir = 1; icon_state = "boat_b_port3"},/obj/covers/repairedfloor/ship/south,/turf/floor/broken_floor,/area/caribbean/sea/top)
"aU" = (/obj/structure/window/barrier/ship/blue/bport_north,/obj/covers/wood_ship,/turf/floor/broken_floor,/area/caribbean/sea/top)
"aV" = (/obj/structure/barricade/ship/wood/a4,/obj/structure/flag/pirates,/obj/covers/wood_ship,/turf/floor/broken_floor,/area/caribbean/sea/top/roofed)
"aW" = (/obj/structure/barricade/ship/wood/a10,/obj/item/flashlight/lantern/on/anchored,/obj/covers/wood_ship,/turf/floor/broken_floor,/area/caribbean/sea/top/roofed)
"aX" = (/obj/structure/barricade/ship/wood/a12,/obj/covers/wood_ship,/turf/floor/broken_floor,/area/caribbean/sea/top/roofed)
"aY" = (/obj/covers/wood_ship,/obj/structure/table/wood,/turf/floor/broken_floor,/area/caribbean/sea/top/roofed)
"aZ" = (/obj/covers/wood_ship,/turf/floor/broken_floor,/area/caribbean/sea/top/roofed)
"bb" = (/obj/covers/wood_ship,/turf/floor/broken_floor,/area/caribbean/sea/top)
"bc" = (/obj/covers/wood_ship,/obj/structure/grapplehook/auto{dir = 1},/turf/floor/broken_floor,/area/caribbean/sea/top)
"bd" = (/obj/covers/wood_ship,/obj/structure/cannon/modern/tank/voyage/autofire{dir = 1; icon_state = "cannon"},/turf/floor/broken_floor,/area/caribbean/sea/top)
"be" = (/obj/covers/wood_ship,/obj/structure/table/wood,/obj/item/weapon/paper,/obj/item/weapon/paper,/turf/floor/broken_floor,/area/caribbean/sea/top/roofed)
"bf" = (/obj/structure/barricade/ship/wood/a2,/obj/covers/wood_ship,/turf/floor/broken_floor,/area/caribbean/sea/top/roofed)
"bg" = (/obj/covers/wood_ship,/obj/structure/table/wood,/obj/item/weapon/pen,/obj/item/weapon/paper,/turf/floor/broken_floor,/area/caribbean/sea/top/roofed)
"bh" = (/obj/structure/barricade/ship/wood/a12,/obj/item/flashlight/lantern/on/anchored,/obj/covers/wood_ship,/turf/floor/broken_floor,/area/caribbean/sea/top/roofed)
"bi" = (/obj/structure/voyage/grid{dir = 9},/turf/floor/broken_floor,/area/caribbean/sea/top)
"bj" = (/obj/covers/wood_ship,/mob/living/simple_animal/hostile/human/voyage/pirate,/turf/floor/broken_floor,/area/caribbean/sea/top)
"bk" = (/obj/structure/barricade/ship/wood/a4,/obj/covers/wood_ship,/turf/floor/broken_floor,/area/caribbean/sea/top/roofed)
"bl" = (/obj/structure/barricade/ship/wood/a7,/obj/covers/wood_ship,/turf/floor/broken_floor,/area/caribbean/sea/top/roofed)
"bm" = (/obj/structure/barricade/ship/wood/a9,/obj/covers/wood_ship,/turf/floor/broken_floor,/area/caribbean/sea/top/roofed)
"bp" = (/obj/covers/wood_ship,/obj/structure/window/barrier/ship/blue/bport_north,/turf/floor/broken_floor,/area/caribbean/sea/top)
"bq" = (/obj/covers/wood_ship,/obj/structure/voyage/ropeladder/thin{dir = 1},/turf/floor/broken_floor,/area/caribbean/sea/top)
"br" = (/obj/covers/wood_ship,/obj/structure/window/barrier/ship/blue/bport5/corner,/turf/floor/broken_floor,/area/caribbean/sea/top)
"bs" = (/obj/structure/voyage/grid{dir = 1},/turf/floor/broken_floor,/area/caribbean/sea/top)
"bt" = (/obj/covers/wood_ship,/obj/structure/window/barrier/ship/blue/bport_10,/turf/floor/broken_floor,/area/caribbean/sea/top)
"bu" = (/obj/covers/wood_ship,/obj/structure/voyage/shipbell,/turf/floor/broken_floor,/area/caribbean/sea/top)
"bv" = (/obj/structure/voyage/grid{dir = 5},/turf/floor/broken_floor,/area/caribbean/sea/top)
"bw" = (/obj/covers/wood_ship,/obj/structure/window/barrier/ship/blue/bport_6/corner,/turf/floor/broken_floor,/area/caribbean/sea/top)
"bx" = (/obj/covers/wood_ship,/obj/structure/window/barrier/ship/blue/bport0/south,/turf/floor/broken_floor,/area/caribbean/sea/top)
"by" = (/obj/covers/wood_ship,/obj/structure/bed/chair/wood/red{dir = 4},/mob/living/simple_animal/hostile/human/voyage/pirate/ranged/captain,/turf/floor/broken_floor,/area/caribbean/sea/top/roofed)
"bz" = (/obj/covers/wood_ship,/obj/structure/window/barrier/ship/blue/bport9,/turf/floor/broken_floor,/area/caribbean/sea/top)
"bA" = (/obj/covers/wood_ship,/obj/structure/multiz/ladder/ww2,/turf/floor/broken_floor,/area/caribbean/sea/top)
"bB" = (/obj/structure/voyage/grid{dir = 10},/turf/floor/broken_floor,/area/caribbean/sea/top)
"bC" = (/obj/structure/voyage/grid{dir = 6},/turf/floor/broken_floor,/area/caribbean/sea/top)
"bD" = (/obj/effect/landmark{name = "Grappling Hook area - do not block"},/turf/floor/beach/water/deep/saltwater,/area/caribbean/sea/top)
"bE" = (/obj/covers/wood_ship,/obj/structure/simple_door/key_door/anyone,/turf/floor/broken_floor,/area/caribbean/sea/top/roofed)
"bF" = (/obj/structure/barricade/ship/blue/b17,/obj/structure/flag/pirates,/obj/covers/wood_ship,/turf/floor/broken_floor,/area/caribbean/sea/top/roofed)
"bG" = (/obj/covers/wood_ship,/obj/structure/barricade/ship/mast/large,/obj/item/flashlight/lantern/on/anchored,/turf/floor/broken_floor,/area/caribbean/sea/top)
"bH" = (/obj/item/flashlight/lantern/on/anchored,/obj/covers/wood_ship,/obj/structure/barricade/ship/blue/b20{dir = 2},/turf/floor/broken_floor,/area/caribbean/sea/top/roofed)
"dm" = (/obj/structure/barricade/ship/blue/b17,/obj/covers/wood_ship,/turf/floor/broken_floor,/area/caribbean/sea/top/roofed)
"ei" = (/obj/structure/voyage/grid,/turf/floor/broken_floor,/area/caribbean/sea/top)
"ie" = (/obj/covers/wood_ship,/obj/structure/window/barrier/ship/blue/bport0/south,/obj/structure/voyage/ropeladder/thin,/turf/floor/broken_floor,/area/caribbean/sea/top)
"lE" = (/obj/structure/voyage/grid{dir = 8},/turf/floor/broken_floor,/area/caribbean/sea/top)
"mb" = (/obj/covers/wood_ship,/obj/structure/bed/padded,/obj/item/weapon/bedsheet/brown,/turf/floor/broken_floor,/area/caribbean/sea/top/roofed)
"mq" = (/obj/covers/wood_ship,/obj/structure/window/barrier/ship/blue/bport3,/obj/structure/cannon/modern/tank/voyage/autofire,/turf/floor/broken_floor,/area/caribbean/sea/top)
"nS" = (/obj/structure/barricade/ship/blue/b8,/obj/covers/wood_ship,/turf/floor/broken_floor,/area/caribbean/sea/top/roofed)
"FO" = (/obj/structure/window/barrier/ship/blue/bport0/south,/obj/covers/wood_ship,/turf/floor/broken_floor,/area/caribbean/sea/top)
"Gp" = (/obj/covers/wood_ship,/obj/structure/grapplehook/auto,/turf/floor/broken_floor,/area/caribbean/sea/top)
"Om" = (/obj/structure/voyage/grid{dir = 4},/turf/floor/broken_floor,/area/caribbean/sea/top)
"OU" = (/obj/covers/wood_ship,/mob/living/simple_animal/hostile/human/voyage/pirate/ranged,/turf/floor/broken_floor,/area/caribbean/sea/top)
"Rx" = (/obj/structure/barricade/ship/blue/b9,/obj/covers/wood_ship,/turf/floor/broken_floor,/area/caribbean/sea/top/roofed)
"Su" = (/obj/structure/voyage/grid/middle,/turf/floor/broken_floor,/area/caribbean/sea/top)
"Tw" = (/obj/covers/wood_ship,/obj/structure/closet/cabinet,/obj/item/weapon/gun/projectile/flintlock/duellingpistol,/obj/item/ammo_casing/musketball_pistol,/turf/floor/broken_floor,/area/caribbean/sea/top/roofed)
"Wq" = (/obj/covers/wood_ship,/obj/structure/window/barrier/ship/blue/bport0/south,/obj/effect/landmark{name = "Grappling Hook area - do not block"},/turf/floor/broken_floor,/area/caribbean/sea/top)

(1,1,1) = {"
aaaaaaaaaaaaaaaaaaaaaaaaaaaaaaaaaaaaaaaaaaaaaaaaaaaaaaaaaaaaaaaaaaaaaaaaaaaaaaaaaaaaaaaaaaaaaaaaaaaaaaaaaaaaaaaaaaaaaaaaaaaaaaaaaaaaaaaaaaaaaaaaaaaaaa
aaaaaaaaaaaaaaaaaaaaaaaaaaaaaaaaaaaaaaaaaaaaaaaaaaaaaaaaaaaaaaaaaaaaaaaaaaaaaaaaaaaaaaaaaaaaaaaaaaaaaaaaaaaaaaaaaaaaaaaaaaaaaaaaaaaaaaaaaaaaaaaaaaaaaa
aaaaaaaaaaaaaaaaaaaaaaaaaaaaaaaaaaaaaaaaaaaaaaaaaaaaaaaaaaaaaaaaaaaaaaaaaaaaaaaaaaaaaaaaaaaaaaaaaaaaaaaaaaaaaaaaaaaaaaaaaaaaaaaaaaaaaaaaaaaaaaaaaaaaaa
aaaaaaaaaaaaaaaaaaaaaaaaaaaaaaaaaaaaaaaaaaaaaaaaaaaaaaaaaaaaaaaaaaaaaaaaaaaaaaaaaaaaaaaaaaaaaaaaaaaaaaaaaaaaaaaaaaaaaaaaaaaaaaaaaaaaaaaaaaaaaaaaaaaaaa
aaaaaaaaaaaaaaaaaaaaaaaaaaaaaaaaaaaaaaaaaaaaaaaaaaaaaaaaaaaaaaaaaaaaaaaaaaaaaaaaaaaaaaaaaaaaaaaaaaaaaaaaaaaaaaaaaaaaaaaaaaaaaaaaaaaaaaaaaaaaaaaaaaaaaa
aaaaaaaaaaaaaaaaaaaaaaaaaaaaaaaaaaaaaaaaaaaaaaaaaaaaaaaaaaaaaaaaaaaaaaaaaaaaaaaaaaaaaaaaaaaaaaaaaaaaaaaaaaaaaaaaaaaaaaaaaaaaaaaaaaaaaaaaaaaaaaaaaaaaaa
aaaaaaaaaaaaaaaaaaaaaaaaaaaaaaaaaaaaaaaaaaaaaaaaaaaaaaaaaaaaaaaaaaaaaaaaaaaaaaaaaaaaaaaaaaaaaaaaaaaaaaaaaaaaaaaaaaaaaaaaaaaaaaaaaaaaaaaaaaaaaaaaaaaaaa
aaaaaaaaaaaaaaaaaaaaaaaaaaaaaaaaaaaaaaaaaaaaaaaaaaaaaaaaaaaaaaaaaaaaaaaaaaaaaaaaaaaaaaaaaaaaaaaaaaaaaaaaaaaaaaaaaaaaaaaaaaaaaaaaaaaaaaaaaaaaaaaaaaaaaa
aaaaaaaaaaaaaaaaaaaaaaaaaaaaaaaaaaaaaaaaaaaaaaaaaaaaaaaaaaaaaaaaaaaaaaaaaaaaaaaaaaaaaaaaaaaaaaaaaaaaaaaaaaaaaaaaaaaaaaaaaaaaaaaaaaaaaaaaaaaaaaaaaaaaaa
aaaaaaaaaaaaaaaaaaaaaaaaaaaaaaaaaaaaaaaaaaaaaaaaaaaaaaaaaaaaaaaaaaaaaaaaaaaaaaaaaaaaaaaaaaaaaaaaaaaaaaaaaaaaaaaaaaaaaaaaaaaaaaaaaaaaaaaaaaaaaaaaaaaaaa
aaaaaaaaaaaaaaaaaaaaaaaaaaaaaaaaaaaaaaaaaaaaaaaaaaaaaaaaaaaaaaaaaaaaaaaaaaaaaaaaaaaaaaaaaaaaaaaaaaaaaaaaaaaaaaaaaaaaaaaaaaaaaaaaaaaaaaaaaaaaaaaaaaaaaa
aaaaaaaaaaaaaaaaaaaaaaaaaaaaaaaaaaaaaaaaaaaaaaaaaaaaaaaaaaaaaaaaaaaaaaaaaaaaaaaaaaaaaaaaaaaaaaaaaaaaaaaaaaaaaaaaaaaaaaaaaaaaaaaaaaaaaaaaaaaaaaaaaaaaaa
aaaaaaaaaaaaaaaaaaaaaaaaaaaaaaaaaaaaaaaaaaaaaaaaaaaaaaaaaaaaaaaaaaaaaaaaaaaaaaaaaaaaaaaaaaaaaaaaaaaaaaaaaaaaaaaaaaaaaaaaaaaaaaaaaaaaaaaaaaaaaaaaaaaaaa
aaaaaaaaaaaaaaaaaaaaaaaaaaaaaaaaaaaaaaaaaaaaaaaaaaaaaaaaaaaaaaaaaaaaaaaaaaaaaaaaaaaaaaaaaaaaaaaaaaaaaaaaaaaaaaaaaaaaaaaaaaaaaaaaaaaaaaaaaaaaaaaaaaaaaa
aaaaaaaaaaaaaaaaaaaaaaaaaaaaaaaaaaaaaaaaaaaaaaaaaaaaaaaaaaaaaaaaaaaaaaaaaaaaaaaaaaaaaaaaaaaaaaaaaaaaaaaaaaaaaaaaaaaaaaaaaaaaaaaaaaaaaaaaaaaaaaaaaaaaaa
aaaaaaaaaaaaaaaaaaaaaaaaaaaaaaaaaaaaaaaaaaaaaaaaaaaaaaaaaaaaaaaaaaaaaaaaaaaaaaaaaaaaaaaaaaaaaaaaaaaaaaaaaaaaaaaaaaaaaaaaaaaaaaaaaaaaaaaaaaaaaaaaaaaaaa
aaaaaaaaaaaaaaaaaaaaaaaaaaaaaaaoaAaAaAaEaAaAaAaAaAaAaAaAabaAaAaAaAaAaAabaAaAaAaAaAaAaAaAaEaaaaaaaaaaaaaaaaaaaaaaaaaaaaaaaaaaaaaaaaaaaaaaaaaaaaaaaaaaaa
aaaaaaaaaaaaaaaaaaaaaaaaaaaaaoacadadaeafagajajajajajajajajaMajajajajajajajajajaMajaiaiaiakaEaaaaaaaaaaaaaaaaaaaaaaaaaaaaaaaaaaaaaaaaaaaaaaaaaaaaaaaaaa
aaaaaaaaaaaaaaaaaaaaaaaaaaaaanajajajajapajajajajajajajajajajajaMajajajajajajajajajajajajajaDaEaaaaaaaaaaaaaaaaaaaaaaaaaaaaaaaaaaaaaaaaaaaaaaaaaaaaaaaa
aaaaaaaaaaaaaaaaaaaaaaaaaaaaanaGajajajahajajaMajajajaIaIajajaJalaJajajajamamamamajaMajajajasafaaaaaaaaaaaaaaaaaaaaaaaaaaaaaaaaaaaaaaaaaaaaaaaaaaaaaaaa
aaaaaaaaaaaaaaaaaaaaaaaaaaaaanaGajaMajahajajajajajajaIaIajajaJalaJajajajamamamamajajajajajasafaaaaaaaaaaaaaaaaaaaaaaaaaaaaaaaaaaaaaaaaaaaaaaaaaaaaaaaa
aaaaaaaaaaaaaaaaaaaaaaaaaaaaanajajajajapauajajajajajajajajajajajaeajajajajajajajajajajajajavaBaaaaaaaaaaaaaaaaaaaaaaaaaaaaaaaaaaaaaaaaaaaaaaaaaaaaaaaa
aaaaaaaaaaaaaaaaaaaaaaaaaaaaaCaHadadaeafajajajajajaKaLajaNaNaNajajajajajajajajajajajaPaPaQaBaaaaaaaaaaaaaaaaaaaaaaaaaaaaaaaaaaaaaaaaaaaaaaaaaaaaaaaaaa
aaaaaaaaaaaaaaaaaaaaaaaaaaaaaaaCaRaRaRaRaRaRaRaRaRaRaRaRaSaRaRaRaRaRaRaSaRaRaRaRaRaRaRaRaBaaaaaaaaaaaaaaaaaaaaaaaaaaaaaaaaaaaaaaaaaaaaaaaaaaaaaaaaaaaa
aOaaaaaaaaaaaaaaaaaaaaaaaaaaaaaaaaaaaaaaaaaaaaaaaaaaaaaaaaaaaaaaaaaaaaaaaaaaaaaaaaaaaaaaaaaaaaaaaaaaaaaaaaaaaaaaaaaaaaaaaaaaaaaaaaaaaaaaaaaaaaaaaaaaaa
"}

(1,1,2) = {"
aaaaaaaaaaaaaaaaaaaaaaaaaaaaaaaaaaaaaaaaaaaaaaaaaaaaaaaaaaaaaaaaaaaaaaaaaaaaaaaaaaaaaaaaaaaaaaaaaaaaaaaaaaaaaaaaaaaaaaaaaaaaaaaaaaaaaaaaaaaaaaaaaaaaaa
aaaaaaaaaaaaaaaaaaaaaaaaaaaaaaaaaaaaaaaaaaaaaaaaaaaaaaaaaaaaaaaaaaaaaaaaaaaaaaaaaaaaaaaaaaaaaaaaaaaaaaaaaaaaaaaaaaaaaaaaaaaaaaaaaaaaaaaaaaaaaaaaaaaaaa
aaaaaaaaaaaaaaaaaaaaaaaaaaaaaaaaaaaaaaaaaaaaaaaaaaaaaaaaaaaaaaaaaaaaaaaaaaaaaaaaaaaaaaaaaaaaaaaaaaaaaaaaaaaaaaaaaaaaaaaaaaaaaaaaaaaaaaaaaaaaaaaaaaaaaa
aaaaaaaaaaaaaaaaaaaaaaaaaaaaaaaaaaaaaaaaaaaaaaaaaaaaaaaaaaaaaaaaaaaaaaaaaaaaaaaaaaaaaaaaaaaaaaaaaaaaaaaaaaaaaaaaaaaaaaaaaaaaaaaaaaaaaaaaaaaaaaaaaaaaaa
aaaaaaaaaaaaaaaaaaaaaaaaaaaaaaaaaaaaaaaaaaaaaaaaaaaaaaaaaaaaaaaaaaaaaaaaaaaaaaaaaaaaaaaaaaaaaaaaaaaaaaaaaaaaaaaaaaaaaaaaaaaaaaaaaaaaaaaaaaaaaaaaaaaaaa
aaaaaaaaaaaaaaaaaaaaaaaaaaaaaaaaaaaaaaaaaaaaaaaaaaaaaaaaaaaaaaaaaaaaaaaaaaaaaaaaaaaaaaaaaaaaaaaaaaaaaaaaaaaaaaaaaaaaaaaaaaaaaaaaaaaaaaaaaaaaaaaaaaaaaa
aaaaaaaaaaaaaaaaaaaaaaaaaaaaaaaaaaaaaaaaaaaaaaaaaaaaaaaaaaaaaaaaaaaaaaaaaaaaaaaaaaaaaaaaaaaaaaaaaaaaaaaaaaaaaaaaaaaaaaaaaaaaaaaaaaaaaaaaaaaaaaaaaaaaaa
aaaaaaaaaaaaaaaaaaaaaaaaaaaaaaaaaaaaaaaaaaaaaaaaaaaaaaaaaaaaaaaaaaaaaaaaaaaaaaaaaaaaaaaaaaaaaaaaaaaaaaaaaaaaaaaaaaaaaaaaaaaaaaaaaaaaaaaaaaaaaaaaaaaaaa
aaaaaaaaaaaaaaaaaaaaaaaaaaaaaaaaaaaaaaaaaaaaaaaaaaaaaaaaaaaaaaaaaaaaaaaaaaaaaaaaaaaaaaaaaaaaaaaaaaaaaaaaaaaaaaaaaaaaaaaaaaaaaaaaaaaaaaaaaaaaaaaaaaaaaa
aaaaaaaaaaaaaaaaaaaaaaaaaaaaaaaaaaaaaaaaaaaaaaaaaaaaaaaaaaaaaaaaaaaaaaaaaaaaaaaaaaaaaaaaaaaaaaaaaaaaaaaaaaaaaaaaaaaaaaaaaaaaaaaaaaaaaaaaaaaaaaaaaaaaaa
aaaaaaaaaaaaaaaaaaaaaaaaaaaaaaaaaaaaaaaaaaaaaaaaaaaaaaaaaaaaaaaaaaaaaaaaaaaaaaaaaaaaaaaaaaaaaaaaaaaaaaaaaaaaaaaaaaaaaaaaaaaaaaaaaaaaaaaaaaaaaaaaaaaaaa
aaaaaaaaaaaaaaaaaaaaaaaaaaaaaaaaaaaaaaaaaaaaaaaaaaaaaaaaaaaaaaaaaaaaaaaaaaaaaaaaaaaaaaaaaaaaaaaaaaaaaaaaaaaaaaaaaaaaaaaaaaaaaaaaaaaaaaaaaaaaaaaaaaaaaa
aaaaaaaaaaaaaaaaaaaaaaaaaaaaaaaaaaaaaaaaaaaaaaaaaaaaaaaaaaaaaaaaaaaaaaaaaaaaaaaaaaaaaaaaaaaaaaaaaaaaaaaaaaaaaaaaaaaaaaaaaaaaaaaaaaaaaaaaaaaaaaaaaaaaaa
aaaaaaaaaaaaaaaaaaaaaaaaaaaaaaaaaaaaaaaaaaaaaaaaaaaaaaaaaaaaaaaaaaaaaaaaaaaaaaaaaaaaaaaaaaaaaaaaaaaaaaaaaaaaaaaaaaaaaaaaaaaaaaaaaaaaaaaaaaaaaaaaaaaaaa
aaaaaaaaaaaaaaaaaaaaaaaaaaaaaaaaaaaaaaaaaaaaaaaaaaaaaaaaaaaaaaaaaaaaaaaaaaaaaaaaaaaaaaaaaaaaaaaaaaaaaaaaaaaaaaaaaaaaaaaaaaaaaaaaaaaaaaaaaaaaaaaaaaaaaa
aaaaaaaaaaaaaaaaaaaaaaaaaaaaaaaaaaaaaaaaaaaaaaaaaaaaaaaaaaaaaaaaaaaaaaaaaaaaaaaaaaaaaaaaaaaaaaaaaaaaaaaaaaaaaaaaaaaaaaaaaaaaaaaaaaaaaaaaaaaaaaaaaaaaaa
aaaaaaaaaaaaaaaaaaaaaaaaaaaaaabkblblblbmbpbpbpbpbpbpbpaTbpbpbpbpbpbpaTbpbpaUbpbpbpbpbpbpbtaaaaaaaaaaaaaaaaaaaaaaaaaaaaaaaaaaaaaaaaaaaaaaaaaaaaaaaaaaaa
aaaaaaaaaaaaaaaaaaaaaaaaaaaaaVaWaYaZaZaXbbbcbbbbbbbqbbbdbbbbbjbbbcbbbdbbbqbbbbbbbbbcbbbbbrbtaaaaaaaaaaaaaaaaaaaaaaaaaaaaaaaaaaaaaaaaaaaaaaaaaaaaaaaaaa
aaaaaaaaaaaaaaaaaaaaaaaaaaaabfaZbeaZaZbhbubbbjbbbbbbbbbbbbbbbbbbbbbbbbbbbbbbbbbbbbbbbbbbbbbrbtaaaaaaaaaaaaaaaaaaaaaaaaaaaaaaaaaaaaaaaaaaaaaaaaaaaaaaaa
aaaaaaaaaaaaaaaaaaaaaaaaaaaabfbybgaZaZbEbbbbbbbbbbbbbbbbbbbibsbvbbOUbbbbbbbbbbbbbjbbbbbbbbbbbrbpbtaaaaaaaaaaaaaaaaaaaaaaaaaaaaaaaaaaaaaaaaaaaaaaaaaaaa
aaaaaaaaaaaaaaaaaaaaaaaaaaaabfaZaYaZaZbEbbbbbbbbbbbGbbbbbblESuOmbbbbbbbbbGbbbbbbbbbbbbbbbbbbbwbxbzaaaaaaaaaaaaaaaaaaaaaaaaaaaaaaaaaaaaaaaaaaaaaaaaaaaa
aaaaaaaaaaaaaaaaaaaaaaaaaaaabfaZaZaZaZbhbAbbbbbbbbbbbbbbbbbBeibCbjbbbbbbbbbbbbbbbbbbbbbbbbbwbzaaaaaaaaaaaaaaaaaaaaaaaaaaaaaaaaaaaaaaaaaaaaaaaaaaaaaaaa
aaaaaaaaaaaaaaaaaaaaaaaaaaaabFbHaZmbTwaXbbGpbbbjbbbbbbbbbbbbbbGpbbbbbbbbbbbbbbbjbjGpbbbbbwbzaaaaaaaaaaaaaaaaaaaaaaaaaaaaaaaaaaaaaaaaaaaaaaaaaaaaaaaaaa
aaaaaaaaaaaaaaaaaaaaaaaaaaaaaadmRxRxRxnSbxbxbxbxbxiebxmqWqbxbxbxbxbxmqWqieFObxbxbxbxbxbxbzaaaaaaaaaaaaaaaaaaaaaaaaaaaaaaaaaaaaaaaaaaaaaaaaaaaaaaaaaaaa
aaaaaaaaaaaaaaaaaaaaaaaaaaaaaaaaaaaaaaaaaaaaaaaaaaaaaaaabDaaaaaaaaaaaabDaaaaaaaaaaaaaaaaaaaaaaaaaaaaaaaaaaaaaaaaaaaaaaaaaaaaaaaaaaaaaaaaaaaaaaaaaaaaaa
"}
