"aa" = (/turf/floor/beach/water/deep/saltwater,/area/caribbean/sea/top)
"ab" = (/obj/map_metadata/voyage,/turf/floor/beach/water/deep/saltwater,/area/caribbean/sea/top)
"ac" = (/obj/effect/landmark{name = "Grappling Hook area - do not block"},/turf/floor/beach/water/deep/saltwater,/area/caribbean/sea/top)
"ad" = (/obj/structure/barricade/ship{dir = 8},/turf/floor/beach/water/deep/saltwater,/area/caribbean/sea/top/roofed)
"ae" = (/obj/covers/repairedfloor/ship,/obj/structure/simple_door/key_door/anyone,/obj/covers/repairedfloor/ship,/turf/floor/beach/water/deep/saltwater,/area/caribbean/sea/top/roofed)
"af" = (/obj/structure/simple_door/key_door/anyone/wood,/obj/covers/repairedfloor/ship,/turf/floor/broken_floor,/area/caribbean/sea/top/roofed)
"ag" = (/obj/structure/window/barrier/ship/blue/bport3,/obj/covers/repairedfloor/ship,/obj/structure/cannon/modern/tank/voyage/autofire,/obj/effect/landmark{name = "Grappling Hook area - do not block"},/turf/floor/broken_floor,/area/caribbean/sea/top)
"ah" = (/obj/structure/window/barrier/ship/blue/bport0,/obj/covers/repairedfloor/ship,/obj/effect/landmark{name = "Grappling Hook area - do not block"},/turf/floor/broken_floor,/area/caribbean/sea/top)
"ai" = (/obj/structure/barricade/ship/north/corners{dir = 2},/turf/floor/beach/water/deep/saltwater,/area/caribbean/sea/top/roofed)
"aj" = (/obj/structure/barricade/ship/north/corners{dir = 5; icon_state = "boat1_up_corners"},/turf/floor/beach/water/deep/saltwater,/area/caribbean/sea/top/roofed)
"ak" = (/obj/structure/barricade/ship/north/corners{dir = 4},/obj/item/flashlight/lantern/on/anchored,/obj/structure/barricade/ship/north/corners{dir = 5; icon_state = "boat1_up_corners"},/turf/floor/beach/water/deep/saltwater,/area/caribbean/sea/top/roofed)
"al" = (/obj/covers/repairedfloor/ship,/obj/structure/closet/crate/wood,/turf/floor/beach/water/deep/saltwater,/area/caribbean/sea/top/roofed)
"am" = (/obj/structure/barricade/ship/north/corners{dir = 6; icon_state = "boat1_up_corners"},/turf/floor/beach/water/deep/saltwater,/area/caribbean/sea/top/roofed)
"an" = (/obj/structure/barricade/ship/north/corners{dir = 1},/obj/item/flashlight/lantern/on/anchored,/obj/structure/barricade/ship/north/corners{dir = 6; icon_state = "boat1_up_corners"},/turf/floor/beach/water/deep/saltwater,/area/caribbean/sea/top/roofed)
"ao" = (/obj/structure/barricade/ship{dir = 2},/turf/floor/beach/water/deep/saltwater,/area/caribbean/sea/top/roofed)
"ap" = (/obj/covers/repairedfloor/ship,/obj/structure/grapplehook/auto{dir = 1},/turf/floor/broken_floor,/area/caribbean/sea/top)
"aq" = (/obj/structure/barricade/ship/wood/a6,/turf/floor/broken_floor,/area/caribbean/sea/top/roofed)
"as" = (/obj/covers/repairedfloor/ship,/obj/item/flashlight/lantern/on/anchored,/turf/floor/beach/water/deep/saltwater,/area/caribbean/sea/top/roofed)
"av" = (/obj/structure/barricade/ship/north/corners{dir = 1},/turf/floor/beach/water/deep/saltwater,/area/caribbean/sea/top/roofed)
"aw" = (/obj/structure/barricade/ship{dir = 1},/turf/floor/beach/water/deep/saltwater,/area/caribbean/sea/top/roofed)
"ax" = (/obj/structure/barricade/ship/aport0/north,/turf/floor/beach/water/deep/saltwater,/area/caribbean/sea/top/roofed)
"az" = (/obj/covers/repairedfloor/ship,/obj/structure/closet/crate/chest,/obj/item/stack/money/goldvaluables,/obj/item/stack/money/goldvaluables,/obj/item/flashlight/lantern/on/anchored,/turf/floor/beach/water/deep/saltwater,/area/caribbean/sea/top/roofed)
"aA" = (/obj/covers/repairedfloor/ship,/obj/structure/closet/crate/chest,/obj/item/stack/money/goldvaluables,/obj/item/stack/money/goldvaluables,/turf/floor/beach/water/deep/saltwater,/area/caribbean/sea/top/roofed)
"aB" = (/obj/covers/repairedfloor/ship,/obj/item/weapon/reagent_containers/glass/barrel/tea,/turf/floor/beach/water/deep/saltwater,/area/caribbean/sea/top/roofed)
"aC" = (/obj/covers/repairedfloor/ship,/obj/structure/cannon/modern/tank/voyage/autofire{dir = 1; icon_state = "cannon"},/turf/floor/beach/water/deep/saltwater,/area/caribbean/sea/top/roofed)
"aD" = (/obj/structure/barricade/ship/blue/b9,/obj/covers/repairedfloor/ship,/obj/item/flashlight/lantern/on/anchored,/turf/floor/broken_floor,/area/caribbean/sea/top/roofed)
"aE" = (/obj/covers/repairedfloor/ship,/obj/structure/window/barrier/ship/wood/portl2,/obj/structure/window/barrier/ship/blue/bport0,/turf/floor/broken_floor,/area/caribbean/sea/top)
"aF" = (/obj/covers/repairedfloor/ship,/obj/structure/grapplehook/auto,/obj/structure/cannon/modern/tank/voyage/autofire{dir = 1; icon_state = "cannon"},/turf/floor/beach/water/deep/saltwater,/area/caribbean/sea/top/roofed)
"aG" = (/obj/covers/repairedfloor/ship,/obj/structure/closet/crate/grenades,/turf/floor/beach/water/deep/saltwater,/area/caribbean/sea/top/roofed)
"aH" = (/obj/covers/repairedfloor/ship,/obj/item/weapon/reagent_containers/glass/barrel/gunpowder,/turf/floor/beach/water/deep/saltwater,/area/caribbean/sea/top/roofed)
"aJ" = (/obj/structure/barricade/ship/north/corners{dir = 4},/turf/floor/beach/water/deep/saltwater,/area/caribbean/sea/top/roofed)
"aL" = (/obj/covers/repairedfloor/ship,/mob/living/simple_animal/hostile/human/voyage/spanish,/turf/floor/broken_floor,/area/caribbean/sea/top/roofed)
"aN" = (/obj/covers/repairedfloor/ship,/mob/living/simple_animal/hostile/human/voyage/spanish/ranged/sgt,/turf/floor/beach/water/deep/saltwater,/area/caribbean/sea/top/roofed)
"aO" = (/obj/covers/repairedfloor/ship,/mob/living/simple_animal/hostile/human/voyage/spanish/ranged,/turf/floor/beach/water/deep/saltwater,/area/caribbean/sea/top/roofed)
"aQ" = (/obj/covers/repairedfloor/ship,/obj/structure/table/wood,/turf/floor/beach/water/deep/saltwater,/area/caribbean/sea/top/roofed)
"aR" = (/obj/covers/repairedfloor/ship,/obj/structure/closet/crate/cannonball,/turf/floor/beach/water/deep/saltwater,/area/caribbean/sea/top/roofed)
"aS" = (/obj/structure/barricade/ship{dir = 4},/obj/item/flashlight/lantern/on/anchored,/turf/floor/beach/water/deep/saltwater,/area/caribbean/sea/top/roofed)
"aT" = (/obj/covers/repairedfloor/ship,/obj/structure/table/wood,/obj/item/weapon/pen,/turf/floor/beach/water/deep/saltwater,/area/caribbean/sea/top/roofed)
"aU" = (/obj/covers/repairedfloor/ship,/obj/covers/wood_wall,/obj/item/flashlight/lantern/on/anchored,/turf/floor/beach/water/deep/saltwater,/area/caribbean/sea/top/roofed)
"aV" = (/obj/covers/repairedfloor/ship,/obj/item/weapon/reagent_containers/food/drinks/bottle/rum/empty,/turf/floor/beach/water/deep/saltwater,/area/caribbean/sea/top/roofed)
"aW" = (/obj/structure/barricade/ship{dir = 4},/turf/floor/beach/water/deep/saltwater,/area/caribbean/sea/top/roofed)
"aX" = (/obj/structure/barricade/ship/wall2{dir = 8},/turf/floor/beach/water/deep/saltwater,/area/caribbean/sea/top/roofed)
"aY" = (/obj/covers/repairedfloor/ship,/obj/structure/table/wood,/obj/item/weapon/paper,/turf/floor/beach/water/deep/saltwater,/area/caribbean/sea/top/roofed)
"aZ" = (/obj/covers/repairedfloor/ship,/obj/structure/simple_door/key_door/anyone,/turf/floor/beach/water/deep/saltwater,/area/caribbean/sea/top/roofed)
"bg" = (/obj/structure/barricade/ship/wood/a6,/obj/covers/repairedfloor/ship,/obj/item/flashlight/lantern/on/anchored,/turf/floor/broken_floor,/area/caribbean/sea/top/roofed)
"bi" = (/obj/covers/repairedfloor/ship,/obj/structure/window/barrier/ship/wood/portl2,/turf/floor/broken_floor,/area/caribbean/sea/top)
"bk" = (/obj/covers/repairedfloor/ship,/obj/structure/barricade/ship/blue/b2,/obj/structure/sign/painting3,/obj/item/flashlight/lantern/on/anchored,/obj/structure/barricade/ship/wood/a2,/turf/floor/broken_floor,/area/caribbean/sea/top/roofed)
"bl" = (/obj/covers/repairedfloor/ship,/obj/structure/bed/padded,/obj/item/weapon/bedsheet/brown,/turf/floor/broken_floor,/area/caribbean/sea/top/roofed)
"bo" = (/obj/covers/repairedfloor/ship,/mob/living/simple_animal/hostile/human/voyage/spanish,/turf/floor/beach/water/deep/saltwater,/area/caribbean/sea/top/roofed)
"bx" = (/obj/covers/repairedfloor/ship,/obj/structure/bed/hammock,/turf/floor/beach/water/deep/saltwater,/area/caribbean/sea/top/roofed)
"by" = (/obj/structure/multiz/ladder/ww2/up,/obj/covers/repairedfloor/ship,/turf/floor/beach/water/deep/saltwater,/area/caribbean/sea/top/roofed)
"bE" = (/obj/covers/repairedfloor/ship,/obj/structure/barricade/ship/blue/b2,/obj/structure/barricade/ship/wood/a2,/turf/floor/broken_floor,/area/caribbean/sea/top/roofed)
"bH" = (/obj/covers/repairedfloor/ship,/obj/structure/closet/crate/rations/biscuits,/turf/floor/beach/water/deep/saltwater,/area/caribbean/sea/top/roofed)
"bJ" = (/obj/covers/repairedfloor/ship,/obj/covers/wood/stairs{dir = 8},/turf/floor/broken_floor,/area/caribbean/sea/top)
"bL" = (/obj/covers/repairedfloor/ship,/obj/structure/barricade/ship/blue/b15,/obj/structure/flag/spanish,/obj/structure/barricade/ship/blue/b17,/turf/floor/broken_floor,/area/caribbean/sea/top/roofed)
"bM" = (/obj/structure/barricade/ship/wood/a6,/obj/covers/repairedfloor/ship,/turf/floor/broken_floor,/area/caribbean/sea/top/roofed)
"bN" = (/obj/covers/repairedfloor/ship,/obj/item/weapon/reagent_containers/food/drinks/bottle/rum,/turf/floor/beach/water/deep/saltwater,/area/caribbean/sea/top/roofed)
"bO" = (/obj/covers/repairedfloor/ship,/obj/structure/closet/crate/musketball,/turf/floor/beach/water/deep/saltwater,/area/caribbean/sea/top/roofed)
"bP" = (/obj/covers/repairedfloor/ship,/obj/structure/vending/muskets/spanish,/turf/floor/beach/water/deep/saltwater,/area/caribbean/sea/top/roofed)
"bQ" = (/obj/structure/barricade/ship/blue/b9,/obj/covers/repairedfloor/ship,/turf/floor/broken_floor,/area/caribbean/sea/top/roofed)
"bR" = (/obj/covers/repairedfloor/ship,/obj/structure/closet/crate/rations/fruits,/turf/floor/beach/water/deep/saltwater,/area/caribbean/sea/top/roofed)
"bS" = (/obj/covers/repairedfloor/ship,/obj/covers/wood_wall,/turf/floor/beach/water/deep/saltwater,/area/caribbean/sea/top/roofed)
"bT" = (/obj/covers/repairedfloor/ship,/obj/structure/table/wood,/obj/item/weapon/paper_bundle,/turf/floor/beach/water/deep/saltwater,/area/caribbean/sea/top/roofed)
"bU" = (/obj/structure/barricade/ship/north/corners{dir = 8},/turf/floor/beach/water/deep/saltwater,/area/caribbean/sea/top/roofed)
"bV" = (/obj/structure/barricade/ship/blue/beast,/obj/covers/repairedfloor/ship,/obj/structure/barricade/ship{dir = 4},/obj/item/flashlight/lantern/on/anchored,/turf/floor/beach/water/deep/saltwater,/area/caribbean/sea/top/roofed)
"bW" = (/obj/covers/repairedfloor/ship,/obj/item/weapon/reagent_containers/glass/barrel/rum,/turf/floor/beach/water/deep/saltwater,/area/caribbean/sea/top/roofed)
"bX" = (/obj/covers/repairedfloor/ship,/obj/structure/closet/crate/chest,/obj/item/stack/money/real/fifty,/obj/item/stack/money/real/fifty,/obj/item/stack/money/real/fifty,/obj/item/flashlight/lantern/on/anchored,/turf/floor/beach/water/deep/saltwater,/area/caribbean/sea/top/roofed)
"bY" = (/obj/structure/barricade/ship/aport0,/obj/structure/cannon/modern/tank/voyage/autofire,/turf/floor/beach/water/deep/saltwater,/area/caribbean/sea/top/roofed)
"bZ" = (/obj/covers/repairedfloor/ship,/obj/structure/closet/crate/chest,/obj/item/stack/money/real/fifty,/obj/item/stack/money/real/fifty,/obj/item/stack/money/real/fifty,/turf/floor/beach/water/deep/saltwater,/area/caribbean/sea/top/roofed)
"ca" = (/obj/covers/repairedfloor/ship,/obj/structure/closet/crate/chest,/obj/item/stack/money/gems,/obj/item/stack/money/gems,/turf/floor/beach/water/deep/saltwater,/area/caribbean/sea/top/roofed)
"cc" = (/obj/covers/repairedfloor/ship,/obj/structure/closet/crate/chest,/obj/item/stack/money/pearls,/obj/item/stack/money/pearls,/obj/item/stack/money/pearls,/obj/item/flashlight/lantern/on/anchored,/turf/floor/beach/water/deep/saltwater,/area/caribbean/sea/top/roofed)
"cd" = (/obj/structure/barricade/ship/wood/a4,/turf/floor/broken_floor,/area/caribbean/sea/top/roofed)
"ce" = (/obj/structure/barricade/ship/wood/a7,/obj/covers/repairedfloor/ship,/turf/floor/broken_floor,/area/caribbean/sea/top/roofed)
"cf" = (/obj/covers/repairedfloor/ship,/turf/floor/beach/water/deep/saltwater,/area/caribbean/sea/top/roofed)
"cg" = (/obj/structure/barricade/ship/wood/a7,/obj/covers/repairedfloor/ship,/obj/item/flashlight/lantern/on/anchored,/turf/floor/broken_floor,/area/caribbean/sea/top/roofed)
"ch" = (/obj/structure/barricade/ship/wood/a7,/obj/covers/repairedfloor/ship,/obj/structure/sign/painting2,/turf/floor/broken_floor,/area/caribbean/sea/top/roofed)
"ci" = (/obj/covers/repairedfloor/ship,/turf/floor/broken_floor,/area/caribbean/sea/top/roofed)
"cj" = (/obj/structure/barricade/ship/wood/a7,/turf/floor/broken_floor,/area/caribbean/sea/top/roofed)
"ck" = (/obj/structure/barricade/ship/wood/a12,/obj/covers/repairedfloor/ship,/obj/structure/barricade/ship/wood/a9,/turf/floor/broken_floor,/area/caribbean/sea/top/roofed)
"cl" = (/obj/structure/window/barrier/ship/blue/bport_north,/obj/covers/repairedfloor/ship,/turf/floor/broken_floor,/area/caribbean/sea/top)
"cm" = (/obj/covers/repairedfloor/ship,/obj/structure/window/barrier/ship/wood/portl2,/obj/structure/window/barrier/ship/blue/bport_north,/turf/floor/broken_floor,/area/caribbean/sea/top)
"cn" = (/obj/covers/repairedfloor/ship,/obj/structure/window/barrier/ship/blue/bport_north,/turf/floor/broken_floor,/area/caribbean/sea/top)
"co" = (/obj/covers/repairedfloor/ship/south,/obj/structure/window/barrier/ship/blue/bport3{dir = 1},/turf/floor/broken_floor,/area/caribbean/sea/top)
"cp" = (/obj/structure/window/barrier/ship/blue/bport3{dir = 1},/obj/covers/repairedfloor/ship/south,/turf/floor/broken_floor,/area/caribbean/sea/top)
"cq" = (/obj/structure/window/barrier/ship/blue/bport_10,/obj/covers/repairedfloor/ship,/turf/floor/broken_floor,/area/caribbean/sea/top)
"cr" = (/obj/covers/repairedfloor/ship,/turf/floor/broken_floor,/area/caribbean/sea/top)
"cs" = (/obj/covers/repairedfloor/ship,/mob/living/simple_animal/hostile/human/voyage/spanish,/turf/floor/broken_floor,/area/caribbean/sea/top)
"ct" = (/obj/covers/repairedfloor/ship,/obj/structure/barricade/ship/blue/b1,/obj/structure/flag/spanish,/obj/structure/barricade/ship/wood/a4,/turf/floor/broken_floor,/area/caribbean/sea/top/roofed)
"cu" = (/obj/structure/barricade/ship/wood/a10,/turf/floor/broken_floor,/area/caribbean/sea/top/roofed)
"cv" = (/obj/covers/repairedfloor/ship,/obj/structure/closet/crate/musketball_pistol,/turf/floor/broken_floor,/area/caribbean/sea/top/roofed)
"ds" = (/obj/structure/window/barrier/ship/blue/bport3,/obj/covers/repairedfloor/ship,/obj/structure/cannon/modern/tank/voyage/autofire,/turf/floor/broken_floor,/area/caribbean/sea/top)
"eo" = (/obj/structure/window/barrier/ship/blue/bport9,/obj/covers/repairedfloor/ship,/turf/floor/broken_floor,/area/caribbean/sea/top)
"fn" = (/obj/covers/repairedfloor/ship,/obj/structure/cannon/modern/tank/voyage/autofire,/obj/structure/window/barrier/ship/blue/bport3,/turf/floor/broken_floor,/area/caribbean/sea/top)
"fC" = (/obj/structure/window/barrier/ship/blue/bport0,/obj/covers/repairedfloor/ship,/turf/floor/broken_floor,/area/caribbean/sea/top)
"gX" = (/obj/covers/repairedfloor/ship,/obj/structure/table/wood,/turf/floor/broken_floor,/area/caribbean/sea/top)
"hX" = (/obj/covers/repairedfloor/ship,/obj/structure/table/wood,/obj/item/weapon/gun/projectile/flintlock/pistoletmodelean1733,/turf/floor/broken_floor,/area/caribbean/sea/top/roofed)
"jD" = (/obj/covers/repairedfloor/ship,/mob/living/simple_animal/hostile/human/voyage/spanish/ranged/lt,/turf/floor/broken_floor,/area/caribbean/sea/top/roofed)
"jF" = (/obj/covers/repairedfloor/ship,/obj/structure/table/wood,/turf/floor/broken_floor,/area/caribbean/sea/top/roofed)
"pl" = (/obj/covers/repairedfloor/ship,/obj/structure/barricade/ship/mast/large,/obj/item/flashlight/lantern/on/anchored,/turf/floor/broken_floor,/area/caribbean/sea/top)
"qm" = (/obj/structure/window/barrier/ship/wood/portl2,/obj/covers/repairedfloor/ship,/turf/floor/broken_floor,/area/caribbean/sea/top)
"rO" = (/obj/covers/repairedfloor/ship,/obj/structure/voyage/ropeladder/thin{dir = 1},/obj/structure/cannon/modern/tank/voyage/autofire{dir = 1; icon_state = "cannon"},/turf/floor/broken_floor,/area/caribbean/sea/top)
"sR" = (/obj/covers/repairedfloor/ship,/obj/structure/window/barrier/ship/blue/bport3,/obj/structure/cannon/modern/tank/voyage/autofire,/turf/floor/broken_floor,/area/caribbean/sea/top)
"tI" = (/obj/covers/repairedfloor/ship,/obj/structure/grapplehook/auto,/turf/floor/broken_floor,/area/caribbean/sea/top)
"uC" = (/obj/covers/repairedfloor/ship,/obj/structure/voyage/grid/partial{dir = 5},/turf/floor/broken_floor,/area/caribbean/sea/top)
"wf" = (/obj/covers/repairedfloor/ship,/obj/structure/window/barrier/ship/blue/bport0,/turf/floor/broken_floor,/area/caribbean/sea/top)
"wX" = (/obj/covers/repairedfloor/ship,/obj/structure/table/wood,/obj/structure/voyage/tablemap{dir = 4; layer = 2.9},/turf/floor/broken_floor,/area/caribbean/sea/top/roofed)
"xp" = (/obj/covers/repairedfloor/ship,/obj/structure/cannon/modern/tank/voyage/autofire{dir = 1; icon_state = "cannon"},/turf/floor/broken_floor,/area/caribbean/sea/top)
"yl" = (/obj/structure/ship_bow,/turf/floor/beach/water/deep/saltwater,/area/caribbean/sea/top)
"yD" = (/obj/covers/repairedfloor/ship,/mob/living/simple_animal/hostile/human/voyage/spanish/ranged,/turf/floor/broken_floor,/area/caribbean/sea/top)
"AK" = (/obj/structure/barricade/ship/blue/beast,/obj/covers/repairedfloor/ship,/turf/floor/broken_floor,/area/caribbean/sea/top)
"AV" = (/obj/covers/repairedfloor/ship,/obj/structure/table/wood,/obj/structure/voyage/sextant,/turf/floor/broken_floor,/area/caribbean/sea/top/roofed)
"Dd" = (/obj/covers/repairedfloor/ship,/obj/structure/grapplehook/auto,/obj/structure/voyage/ropeladder/thin{dir = 1},/obj/structure/cannon/modern/tank/voyage/autofire{dir = 1; icon_state = "cannon"},/turf/floor/broken_floor,/area/caribbean/sea/top)
"Ea" = (/obj/covers/repairedfloor/ship,/obj/structure/bed/chair/wood/red{dir = 4},/mob/living/simple_animal/hostile/human/voyage/spanish/ranged/cpt,/turf/floor/broken_floor,/area/caribbean/sea/top/roofed)
"ET" = (/obj/covers/repairedfloor/ship,/obj/structure/table/wood,/obj/item/weapon/attachment/scope/adjustable/binoculars,/turf/floor/broken_floor,/area/caribbean/sea/top)
"Fl" = (/obj/structure/barricade/ship/blue/b8,/turf/floor/broken_floor,/area/caribbean/sea/top/roofed)
"Gi" = (/obj/structure/table/wood,/obj/covers/repairedfloor/ship,/turf/floor/broken_floor,/area/caribbean/sea/top)
"Hy" = (/obj/structure/barricade/ship/blue/b20,/turf/floor/broken_floor,/area/caribbean/sea/top/roofed)
"Lc" = (/obj/covers/repairedfloor/ship,/obj/structure/voyage/grid/partial{dir = 10},/turf/floor/broken_floor,/area/caribbean/sea/top)
"Ld" = (/obj/structure/window/barrier/ship/blue/bport3,/obj/covers/repairedfloor/ship,/obj/structure/voyage/ropeladder/thin,/obj/structure/cannon/modern/tank/voyage/autofire,/turf/floor/broken_floor,/area/caribbean/sea/top)
"Li" = (/obj/covers/repairedfloor/ship,/obj/structure/voyage/ropeladder/thin{dir = 1},/turf/floor/broken_floor,/area/caribbean/sea/top)
"Mu" = (/obj/structure/window/barrier/ship/blue/bport_6/corner,/obj/covers/repairedfloor/ship,/turf/floor/broken_floor,/area/caribbean/sea/top)
"MK" = (/obj/covers/repairedfloor/ship,/obj/structure/closet/cabinet,/turf/floor/broken_floor,/area/caribbean/sea/top/roofed)
"Ob" = (/obj/covers/repairedfloor/ship,/obj/structure/barricade/ship/blue/b15,/obj/structure/barricade/ship/blue/b17,/turf/floor/broken_floor,/area/caribbean/sea/top/roofed)
"Op" = (/obj/covers/repairedfloor/ship,/mob/living/simple_animal/hostile/human/voyage/spanish/ranged/sgt,/turf/floor/broken_floor,/area/caribbean/sea/top)
"Qn" = (/obj/covers/repairedfloor/ship,/obj/structure/voyage/grid/partial{dir = 6},/turf/floor/broken_floor,/area/caribbean/sea/top)
"RK" = (/obj/structure/multiz/ladder/ww2{area_id = "b1"},/obj/covers/repairedfloor/ship,/turf/floor/broken_floor,/area/caribbean/sea/top)
"Tn" = (/obj/covers/repairedfloor/ship,/obj/structure/voyage/grid/partial{dir = 9},/turf/floor/broken_floor,/area/caribbean/sea/top)
"Un" = (/obj/structure/window/barrier/ship/blue/bport0,/obj/covers/repairedfloor/ship,/obj/structure/voyage/ropeladder/thin,/turf/floor/broken_floor,/area/caribbean/sea/top)
"UV" = (/obj/structure/window/barrier/ship/blue/bport5/corner,/obj/covers/repairedfloor/ship,/turf/floor/broken_floor,/area/caribbean/sea/top)
"VH" = (/obj/structure/barricade/ship/blue/beast,/obj/covers/repairedfloor/ship,/obj/structure/flag/spanish,/turf/floor/broken_floor,/area/caribbean/sea/top)
"XJ" = (/obj/covers/repairedfloor/ship,/obj/structure/table/wood,/obj/item/weapon/reagent_containers/food/drinks/bottle/rum,/turf/floor/broken_floor,/area/caribbean/sea/top/roofed)
"YK" = (/obj/covers/repairedfloor/ship,/obj/structure/barricade/ship/blue/b2,/obj/item/flashlight/lantern/on/anchored,/obj/structure/barricade/ship/wood/a2,/turf/floor/broken_floor,/area/caribbean/sea/top/roofed)
"ZV" = (/obj/structure/barricade/ship/blue/b2{opacity = 0},/obj/structure/window/classic,/turf/floor/broken_floor,/area/caribbean/sea/top/roofed)

(1,1,1) = {"
aaaaaaaaaaaaaaaaaaaaaaaaaaaaaaaaaaaaaaaaaaaaaaaaaaaaaaaaaaaaaaaaaaaaaaaaaaaaaaaaaaaaaaaaaaaaaaaaaaaaaaaaaaaaaaaaaaaaaaaaaaaaaaaaaaaaaaaaaaaaaaaaaaaaaa
aaaaaaaaaaaaaaaaaaaaaaaaaaaaaaaaaaaaaaaaaaaaaaaaaaaaaaaaaaaaaaaaaaaaaaaaaaaaaaaaaaaaaaaaaaaaaaaaaaaaaaaaaaaaaaaaaaaaaaaaaaaaaaaaaaaaaaaaaaaaaaaaaaaaaa
aaaaaaaaaaaaaaaaaaaaaaaaaaaaaaaaaaaaaaaaaaaaaaaaaaaaaaaaaaaaaaaaaaaaaaaaaaaaaaaaaaaaaaaaaaaaaaaaaaaaaaaaaaaaaaaaaaaaaaaaaaaaaaaaaaaaaaaaaaaaaaaaaaaaaa
aaaaaaaaaaaaaaaaaaaaaaaaaaaaaaaaaaaaaaaaaaaaaaaaaaaaaaaaaaaaaaaaaaaaaaaaaaaaaaaaaaaaaaaaaaaaaaaaaaaaaaaaaaaaaaaaaaaaaaaaaaaaaaaaaaaaaaaaaaaaaaaaaaaaaa
aaaaaaaaaaaaaaaaaaaaaaaaaaaaaaaaaaaaaaaaaaaaaaaaaaaaaaaaaaaaaaaaaaaaaaaaaaaaaaaaaaaaaaaaaaaaaaaaaaaaaaaaaaaaaaaaaaaaaaaaaaaaaaaaaaaaaaaaaaaaaaaaaaaaaa
aaaaaaaaaaaaaaaaaaaaaaaaaaaaaaaaaaaaaaaaaaaaaaaaaaaaaaaaaaaaaaaaaaaaaaaaaaaaaaaaaaaaaaaaaaaaaaaaaaaaaaaaaaaaaaaaaaaaaaaaaaaaaaaaaaaaaaaaaaaaaaaaaaaaaa
aaaaaaaaaaaaaaaaaaaaaaaaaaaaaaaaaaaaaaaaaaaaaaaaaaaaaaaaaaaaaaaaaaaaaaaaaaaaaaaaaaaaaaaaaaaaaaaaaaaaaaaaaaaaaaaaaaaaaaaaaaaaaaaaaaaaaaaaaaaaaaaaaaaaaa
aaaaaaaaaaaaaaaaaaaaaaaaavawawawawawawawawawawawawaxawawaxawawaxawawaxawawaxawawaxawawaxawawaxawawawawaiaaaaaaaaaaaaaaaaaaaaaaaaaaaaaaaaaaaaaaaaaaaaaa
aaaaaaaaaaaaaaaaaaaaaaaaadazaAaAaAaAaAazbSaBaBcfasaCcfcfaCcfcfaCcfasaFcfcfaCascfaCcfcfaCcfcfaCasaGbSaHajaiaaaaaaaaaaaaaaaaaaaaaaaaaaaaaaaaaaaaaaaaaaaa
aaaaaaaaaaaaaaaaaaaaaaaaadcfcfcfcfcfcfcfbScfcfcfcfcfcfaLcfcfcfcfaLcfcfcfcfcfaLcfcfaLcfcfaLcfaLcfcfbSaHaHakaiaaaaaaaaaaaaaaaaaaaaaaaaaaaaaaaaaaaaaaaaaa
aaaaaaaaaaaaaaaaaaaaaaaaadcfcfcfcfcfcfcfbScfcfcfcfcfcfcfcfcfcfcfcfcfbocfcfcfaNcfcfaOcfcfcfcfcfcfcfbSaHaHaHajaiaaaaaaaaaaaaaaaaaaaaaaaaaaaaaaaaaaaaaaaa
aaaaaaaaaaaaaaaaaaaaaaaaadaQaQaQcfaOcfcfbScfcfcfcfbxcfbxcfbxcfbxcfbxcfbxcfbxcfbxcfbxcfbxcfbxcfbocfbScfcfcfaRaSaiaaaaaaaaaaaaaaaaaaaaaaaaaaaaaaaaaaaaaa
aaaaaaaaaaaaaaaaaaaaaaaaadcfcfaTcfcfcfcfaUcfcfcfcfcfcfcfcfcfcfcfcfcfcfcfaVcfcfcfcfcfcfcfcfcfcfcfcfaUcfcfcfaRaWaXaiaaaaaaaaaaaaaaaaaaaaaaaaaaaaaaaaaaaa
aaaaaaaaaaaaaaaaaaaaaaaaadcfaNaYcfcfcfcfaecfcfbycfbHbHbNcfcfbObObPbPbPbPbObOcfaObHbHbRbRcfalalcfcfaZcfcfcfaRaWaXaWaaaaaaaaaaaaaaaaaaaaaaaaaaaaaaaaaaaa
aaaaaaaaaaaaaaaaaaaaaaaaadcfcfbTcfaLcfcfaecfcfbycfbHbHcfbocfbObObPbPbPbPbObOcfcfbHbHbRbRcfalalcfcfaZcfcfcfaRaWaXaWaaaaaaaaaaaaaaaaaaaaaaaaaaaaaaaaaaaa
aaaaaaaaaaaaaaaaaaaaaaaaadcfcfcfcfcfcfcfaUcfcfcfcfcfcfcfcfcfcfcfcfcfcfcfcfcfcfcfcfcfcfcfcfcfcfcfcfaUcfcfcfaRaWaXbUaaaaaaaaaaaaaaaaaaaaaaaaaaaaaaaaaaaa
aaaaaaaaaaaaaaaaaaaaaaaaadcfcfcfcfcfcfcfbScfcfcfcfbxcfbxcfbxcfbxcfbxcfbxcfbxcfbxcfbxcfbxcfbxcfcfcfbScfcfcfaRbVbUaaaaaaaaaaaaaaaaaaaaaaaaaaaaaaaaaaaaaa
aaaaaaaaaaaaaaaaaaaaaaaaadcfcfcfaLcfcfcfbScfcfbocfcfcfcfaOcfcfcfcfaLcfcfcfcfcfcfcfbocfcfcfcfcfcfcfbSalalalambUaaaaaaaaaaaaaaaaaaaaaaaaaaaaaaaaaaaaaaaa
aaaaaaaaaaaaaaaaaaaaaaaaadcfcfcfcfcfcfcfbSbWbWbWcfcfcfcfcfaLcfcfcfcfcfcfaLcfcfaLcfcfcfcfcfaLcfcfcfbSaHaHanbUaaaaaaaaaaaaaaaaaaaaaaaaaaaaaaaaaaaaaaaaaa
aaaaaaaaaaaaaaaaaaaaaaaaadbXbZbZbZbZcaccbSbWbWbWascfcfcfcfcfcfcfcfascfcfcfcfascfcfcfcfcfcfcfcfasaGbSaHambUaaaaaaaaaaaaaaaaaaaaaaaaaaaaaaaaaaaaaaaaaaaa
aaaaaaaaaaaaaaaaaaaaaaaaaJaoaoaoaoaoaoaoaoaoaoaoaobYaoaobYaoaobYaoaobYaoaobYaoaobYaoaobYaoaobYaoaoaoaobUaaaaaaaaaaaaaaaaaaaaaaaaaaaaaaaaaaaaaaaaaaaaaa
aaaaaaaaaaaaaaaaaaaaaaaaaaaaaaaaaaaaaaaaaaaaaaaaaaaaaaaaaaaaaaaaaaaaaaaaaaaaaaaaaaaaaaaaaaaaaaaaaaaaaaaaaaaaaaaaaaaaaaaaaaaaaaaaaaaaaaaaaaaaaaaaaaaaaa
aaaaaaaaaaaaaaaaaaaaaaaaaaaaaaaaaaaaaaaaaaaaaaaaaaaaaaaaaaaaaaaaaaaaaaaaaaaaaaaaaaaaaaaaaaaaaaaaaaaaaaaaaaaaaaaaaaaaaaaaaaaaaaaaaaaaaaaaaaaaaaaaaaaaaa
aaaaaaaaaaaaaaaaaaaaaaaaaaaaaaaaaaaaaaaaaaaaaaaaaaaaaaaaaaaaaaaaaaaaaaaaaaaaaaaaaaaaaaaaaaaaaaaaaaaaaaaaaaaaaaaaaaaaaaaaaaaaaaaaaaaaaaaaaaaaaaaaaaaaaa
abaaaaaaaaaaaaaaaaaaaaaaaaaaaaaaaaaaaaaaaaaaaaaaaaaaaaaaaaaaaaaaaaaaaaaaaaaaaaaaaaaaaaaaaaaaaaaaaaaaaaaaaaaaaaaaaaaaaaaaaaaaaaaaaaaaaaaaaaaaaaaaaaaaaa
"}

(1,1,2) = {"
aaaaaaaaaaaaaaaaaaaaaaaaaaaaaaaaaaaaaaaaaaaaaaaaaaaaaaaaaaaaaaaaaaaaaaaaaaaaaaaaaaaaaaaaaaaaaaaaaaaaaaaaaaaaaaaaaaaaaaaaaaaaaaaaaaaaaaaaaaaaaaaaaaaaaa
aaaaaaaaaaaaaaaaaaaaaaaaaaaaaaaaaaaaaaaaaaaaaaaaaaaaaaaaaaaaaaaaaaaaaaaaaaaaaaaaaaaaaaaaaaaaaaaaaaaaaaaaaaaaaaaaaaaaaaaaaaaaaaaaaaaaaaaaaaaaaaaaaaaaaa
aaaaaaaaaaaaaaaaaaaaaaaaaaaaaaaaaaaaaaaaaaaaaaaaaaaaaaaaaaaaaaaaaaaaaaaaaaaaaaaaaaaaaaaaaaaaaaaaaaaaaaaaaaaaaaaaaaaaaaaaaaaaaaaaaaaaaaaaaaaaaaaaaaaaaa
aaaaaaaaaaaaaaaaaaaaaaaaaaaaaaaaaaaaaaaaaaaaaaaaaaaaaaaaaaaaaaaaaaaaaaaaaaaaaaaaaaaaaaaaaaaaaaaaaaaaaaaaaaaaaaaaaaaaaaaaaaaaaaaaaaaaaaaaaaaaaaaaaaaaaa
aaaaaaaaaaaaaaaaaaaaaaaaaaaaaaaaaaaaaaaaaaaaaaaaaaaaaaaaaaaaaaaaaaaaaaaaaaaaaaaaaaaaaaaaaaaaaaaaaaaaaaaaaaaaaaaaaaaaaaaaaaaaaaaaaaaaaaaaaaaaaaaaaaaaaa
aaaaaaaaaaaaaaaaaaaaaaaaaaaaaaaaaaaaaaaaaaaaaaaaaaaaaaaaaaaaaaaaaaaaaaaaaaaaaaaaaaaaaaaaaaaaaaaaaaaaaaaaaaaaaaaaaaaaaaaaaaaaaaaaaaaaaaaaaaaaaaaaaaaaaa
aaaaaaaaaaaaaaaaaaaaaaaaaaaaaaaaaaaaaaaaaaaaaaaaaaaaaaaaaaaaaaaaaaaaaaaaaaaaaaaaaaaaaaaaaaaaaaaaaaaaaaaaaaaaaaaaaaaaaaaaaaaaaaaaaaaaaaaaaaaaaaaaaaaaaa
aaaaaaaaaaaaaaaaaaaaaaaacdcecgchcecjcgckclclcmcncncocncncocncncocncncocncncpcncncpcncncpcncncpcncncncncqaaaaaaaaaaaaaaaaaaaaaaaaaaaaaaaaaaaaaaaaaaaaaa
aaaaaaaaaaaaaaaaaaaaaactcucicicicicicvbMcrcrqmcrcrrOcrapxpyDcrxpcrcrDdtIcrxpyDcrxpLicrxpapcrxpcrOpcrcrUVcqaaaaaaaaaaaaaaaaaaaaaaaaaaaaaaaaaaaaaaaaaaaa
aaaaaaaaaaaaaaaaaaaaaabEciciciciaLcicibgcrcrbJcrcrcrcrcrcrcrcrcrcrcrcrcrcrcrcrcrcrcrcrcrcrcrcrcrcrcrcrcrUVcqaaaaaaaaaaaaaaaaaaaaaaaaaaaaaaaaaaaaaaaaaa
aaaaaaaaaaaaaaaaaaaaaaYKciciciciciciciaqcrcrbJcrcrcrcrcrcrcrcrcrcrcrcrcrcrcrcrcrcrOpcrcrcrcrcrcrcrcrcscrcrUVcqaaaaaaaaaaaaaaaaaaaaaaaaaaaaaaaaaaaaaaaa
aaaaaaaaaaaaaaaaaaaaaaZVcicijFXJcicicibMcrcrbicrcrcscrcrcrcrcrcrcrcrcrcrcrcrcrcrcrcrcrcrcryDcrcrcrcrcrcrcrcrAKaaaaaaaaaaaaaaaaaaaaaaaaaaaaaaaaaaaaaaaa
aaaaaaaaaaaaaaaaaaaaaaZVciciciAVcicicibMcrETbicrcrcrcryDcrcrcrcrcrcrcrcscrcrcrcrcrcrcrcrcrcrcrcscrcrcrcrcrcrAKaaaaaaaaaaaaaaaaaaaaaaaaaaaaaaaaaaaaaaaa
aaaaaaaaaaaaaaaaaaaaaaZVciciEawXcijDciafcrgXbiRKcrcrcrcrcrcrQncrLccrcrcrcrcrcrcrcrcrcrcrcrcrcrcrcrcrcrcryDcrAKaaaaaaaaaaaaaaaaaaaaaaaaaaaaaaaaaaaaaaaa
aaaaaaaaaaaaaaaaaaaaaaZVcicicihXciciciafcrgXbiRKcrplcrcrcrcrcrcrcrcrplcrcscrcrcrcrplcrcscrcrcrcrcrcrcrcrcrcrVHaaaaaaaaaaaaaaaaaaaaaaaaaaaaaaaaaaaaaaaa
aaaaaaaaaaaaaaaaaaaaaaZVcicijFjFcicicibMcrGibicrcrcrcrcrcrcruCcrTncrcrcrcrcryDcrcrcrcrcrcrcrcrcrcrcrcrcrcrcrAKaaaaaaaaaaaaaaaaaaaaaaaaaaaaaaaaaaaaaaaa
aaaaaaaaaaaaaaaaaaaaaaZVcicicicicicicibgcrcrbicscrcrcrcrcrcrcrcrcrcrcrcrcrcrcrcrcrcrcrcrcrcrcrcrcrcrcrcrcrcrAKaaaaaaaaaaaaaaaaaaaaaaaaaaaaaaaaaaaaaaaa
aaaaaaaaaaaaaaaaaaaaaabkblciciciciciciaqcrcrbJcrcrcrcrcrcrcscrcrcrcrcrcrcrcrcrcrcrcscrcrcrcrcrcrcscrcrcrcrMueoylaaaaaaaaaaaaaaaaaaaaaaaaaaaaaaaaaaaaaa
aaaaaaaaaaaaaaaaaaaaaabEMKciciaLcicijFbMcrcrbJcrcrcrcrcrcrcrcrcrcrcrcrcrcrcrcrcrcrcrcrcrcrcrcrcrcrcrcrcrMueoaaaaaaaaaaaaaaaaaaaaaaaaaaaaaaaaaaaaaaaaaa
aaaaaaaaaaaaaaaaaaaaaabLHycicicicicijFbMcrcrqmOpcrcrcrtIcryDcrcrcrOpcrtIcrcryDcrcrcrcrcrtIcrcrOpcrcrcrMueoaaaaaaaaaaaaaaaaaaaaaaaaaaaaaaaaaaaaaaaaaaaa
aaaaaaaaaaaaaaaaaaaaaaaaObbQaDbQbQbQaDFlwfwfaEfCfCLdfCfCagfCfCdsfCfCLdahfCdsfCfCsRUnfCsRfCfCfnfCfCfCfCeoaaaaaaaaaaaaaaaaaaaaaaaaaaaaaaaaaaaaaaaaaaaaaa
aaaaaaaaaaaaaaaaaaaaaaaaaaaaaaaaaaaaaaaaaaaaaaaaaaaaaaaaacaaaaaaaaaaaaacaaaaaaaaaaaaaaaaaaaaaaaaaaaaaaaaaaaaaaaaaaaaaaaaaaaaaaaaaaaaaaaaaaaaaaaaaaaaaa
aaaaaaaaaaaaaaaaaaaaaaaaaaaaaaaaaaaaaaaaaaaaaaaaaaaaaaaaacaaaaaaaaaaaaacaaaaaaaaaaaaaaaaaaaaaaaaaaaaaaaaaaaaaaaaaaaaaaaaaaaaaaaaaaaaaaaaaaaaaaaaaaaaaa
aaaaaaaaaaaaaaaaaaaaaaaaaaaaaaaaaaaaaaaaaaaaaaaaaaaaaaaaacaaaaaaaaaaaaacaaaaaaaaaaaaaaaaaaaaaaaaaaaaaaaaaaaaaaaaaaaaaaaaaaaaaaaaaaaaaaaaaaaaaaaaaaaaaa
aaaaaaaaaaaaaaaaaaaaaaaaaaaaaaaaaaaaaaaaaaaaaaaaaaaaaaaaacaaaaaaaaaaaaacaaaaaaaaaaaaaaaaaaaaaaaaaaaaaaaaaaaaaaaaaaaaaaaaaaaaaaaaaaaaaaaaaaaaaaaaaaaaaa
"}
