"aa" = (/turf/floor/beach/water/deep/saltwater,/area/caribbean/sea/top)
"ab" = (/obj/structure/barricade/ship/north/corners{dir = 1},/turf/floor/beach/water/deep/saltwater,/area/caribbean/sea/top/roofed)
"ac" = (/obj/structure/barricade/ship/north/corners{dir = 9; icon_state = "boat1_up_corners"},/obj/item/flashlight/lantern/on/anchored,/turf/floor/beach/water/deep/saltwater,/area/caribbean/sea/top/roofed)
"ad" = (/obj/covers/wood_ship,/obj/structure/cannon/modern/tank/voyage/autofire{dir = 1; icon_state = "cannon"},/turf/floor/beach/water/deep/saltwater,/area/caribbean/sea/top/roofed)
"ae" = (/obj/covers/wood_ship,/obj/item/flashlight/lantern/on/anchored,/turf/floor/beach/water/deep/saltwater,/area/caribbean/sea/top/roofed)
"af" = (/obj/covers/wood_ship,/obj/structure/closet/crate/cannonball,/turf/floor/beach/water/deep/saltwater,/area/caribbean/sea/top/roofed)
"ag" = (/obj/structure/closet/crate/chest{code = 1999; locked = 1},/obj/covers/wood_ship,/obj/item/stack/money/real/fifty,/turf/floor/beach/water/deep/saltwater,/area/caribbean/sea/top/roofed)
"ai" = (/obj/covers/wood_ship,/obj/structure/bed/hammock,/turf/floor/beach/water/deep/saltwater,/area/caribbean/sea/top/roofed)
"aj" = (/obj/covers/wood_ship,/turf/floor/beach/water/deep/saltwater,/area/caribbean/sea/top/roofed)
"ak" = (/obj/covers/wood_ship,/obj/structure/closet/crate/cannonball/chainshot,/turf/floor/beach/water/deep/saltwater,/area/caribbean/sea/top/roofed)
"al" = (/obj/covers/wood_ship,/obj/structure/closet/crate/cannonball/grapeshot,/turf/floor/beach/water/deep/saltwater,/area/caribbean/sea/top/roofed)
"am" = (/obj/covers/wood_ship,/obj/item/weapon/reagent_containers/glass/barrel/gunpowder,/turf/floor/beach/water/deep/saltwater,/area/caribbean/sea/top/roofed)
"an" = (/obj/structure/barricade/ship/north/corners{dir = 5; icon_state = "boat1_up_corners"},/obj/item/flashlight/lantern/on/anchored,/turf/floor/beach/water/deep/saltwater,/area/caribbean/sea/top/roofed)
"ao" = (/obj/covers/wood_ship,/mob/living/simple_animal/hostile/human/voyage/spanish,/turf/floor/beach/water/deep/saltwater,/area/caribbean/sea/top/roofed)
"ap" = (/obj/covers/wood_ship,/obj/item/weapon/reagent_containers/glass/barrel/rum,/turf/floor/beach/water/deep/saltwater,/area/caribbean/sea/top/roofed)
"aq" = (/obj/structure/barricade/ship{dir = 4},/turf/floor/beach/water/deep/saltwater,/area/caribbean/sea/top/roofed)
"ar" = (/obj/structure/barricade/ship{dir = 8},/turf/floor/beach/water/deep/saltwater,/area/caribbean/sea/top/roofed)
"as" = (/obj/covers/wood_ship,/obj/structure/barricade/ship/wall2{dir = 8},/turf/floor/beach/water/deep/saltwater,/area/caribbean/sea/top/roofed)
"at" = (/obj/structure/barricade/ship/aport0/north,/turf/floor/beach/water/deep/saltwater,/area/caribbean/sea/top/roofed)
"au" = (/obj/covers/wood_ship,/obj/item/weapon/reagent_containers/glass/barrel/fat_oil,/turf/floor/beach/water/deep/saltwater,/area/caribbean/sea/top/roofed)
"av" = (/obj/covers/wood_ship,/obj/structure/multiz/ladder/ww2/up,/turf/floor/beach/water/deep/saltwater,/area/caribbean/sea/top/roofed)
"ax" = (/obj/structure/barricade/ship{dir = 1},/turf/floor/beach/water/deep/saltwater,/area/caribbean/sea/top/roofed)
"az" = (/obj/structure/barricade/ship/north/corners{dir = 6; icon_state = "boat1_up_corners"},/turf/floor/beach/water/deep/saltwater,/area/caribbean/sea/top/roofed)
"aA" = (/obj/covers/wood_ship,/obj/structure/barricade/ship/wall2{dir = 8},/obj/item/flashlight/lantern/on/anchored,/turf/floor/beach/water/deep/saltwater,/area/caribbean/sea/top/roofed)
"aB" = (/obj/structure/barricade/ship/north/corners{dir = 8},/turf/floor/beach/water/deep/saltwater,/area/caribbean/sea/top/roofed)
"aC" = (/obj/structure/barricade/ship/north/corners{dir = 5; icon_state = "boat1_up_corners"},/turf/floor/beach/water/deep/saltwater,/area/caribbean/sea/top/roofed)
"aD" = (/obj/structure/barricade/ship/north/corners{dir = 2},/turf/floor/beach/water/deep/saltwater,/area/caribbean/sea/top/roofed)
"aE" = (/obj/structure/barricade/ship/north/corners{dir = 4},/turf/floor/beach/water/deep/saltwater,/area/caribbean/sea/top/roofed)
"aF" = (/obj/structure/barricade/ship/north/corners{dir = 10; icon_state = "boat1_up_corners"},/obj/item/flashlight/lantern/on/anchored,/turf/floor/beach/water/deep/saltwater,/area/caribbean/sea/top/roofed)
"aH" = (/obj/covers/wood_ship,/obj/structure/barricade/ship/wall2/doorway,/turf/floor/beach/water/deep/saltwater,/area/caribbean/sea/top/roofed)
"aI" = (/obj/covers/wood_ship,/obj/structure/closet/crate/chest,/obj/item/weapon/reagent_containers/food/condiment/saltpile,/obj/item/weapon/reagent_containers/food/condiment/saltpile,/obj/item/weapon/reagent_containers/food/condiment/saltpile,/obj/item/weapon/reagent_containers/food/condiment/saltpile,/obj/item/weapon/reagent_containers/food/condiment/saltpile,/obj/item/weapon/reagent_containers/food/condiment/saltpile,/obj/item/weapon/reagent_containers/food/condiment/saltpile,/obj/item/weapon/reagent_containers/food/condiment/saltpile,/obj/item/weapon/reagent_containers/food/condiment/saltpile,/obj/item/weapon/reagent_containers/food/condiment/saltpile,/turf/floor/beach/water/deep/saltwater,/area/caribbean/sea/top/roofed)
"aJ" = (/obj/covers/wood_ship,/mob/living/simple_animal/hostile/human/voyage/spanish/ranged,/turf/floor/beach/water/deep/saltwater,/area/caribbean/sea/top/roofed)
"aK" = (/obj/covers/wood_ship,/obj/structure/barricade/ship/wall2{dir = 4; icon_state = "boat2"},/obj/item/flashlight/lantern/on/anchored,/turf/floor/beach/water/deep/saltwater,/area/caribbean/sea/top/roofed)
"aL" = (/obj/covers/wood_ship,/obj/structure/closet/crate/empty,/obj/item/weapon/reagent_containers/food/condiment/bsugar,/obj/item/weapon/reagent_containers/food/condiment/bsugar,/obj/item/weapon/reagent_containers/food/condiment/bsugar,/obj/item/weapon/reagent_containers/food/condiment/bsugar,/obj/item/weapon/reagent_containers/food/condiment/bsugar,/obj/item/weapon/reagent_containers/food/condiment/bsugar,/obj/item/weapon/reagent_containers/food/condiment/bsugar,/obj/item/weapon/reagent_containers/food/condiment/bsugar,/obj/item/weapon/reagent_containers/food/condiment/bsugar,/turf/floor/beach/water/deep/saltwater,/area/caribbean/sea/top/roofed)
"aM" = (/obj/covers/wood_ship,/obj/structure/barricade/ship/wall2{dir = 4; icon_state = "boat2"},/turf/floor/beach/water/deep/saltwater,/area/caribbean/sea/top/roofed)
"aN" = (/obj/covers/wood_ship,/obj/item/weapon/reagent_containers/food/condiment/flour,/obj/item/weapon/reagent_containers/food/condiment/flour,/obj/item/weapon/reagent_containers/food/condiment/flour,/obj/item/weapon/reagent_containers/food/condiment/flour,/obj/item/weapon/reagent_containers/food/condiment/flour,/obj/item/weapon/reagent_containers/food/condiment/flour,/obj/item/weapon/reagent_containers/food/condiment/flour,/obj/item/weapon/reagent_containers/food/condiment/flour,/obj/item/weapon/reagent_containers/food/condiment/flour,/obj/item/weapon/reagent_containers/food/condiment/flour,/obj/structure/closet/crate/empty,/turf/floor/beach/water/deep/saltwater,/area/caribbean/sea/top/roofed)
"aO" = (/obj/map_metadata/voyage,/turf/floor/beach/water/deep/saltwater,/area/caribbean/sea/top)
"aP" = (/obj/covers/wood_ship,/obj/structure/closet/crate/empty,/obj/item/weapon/reagent_containers/food/condiment/enzyme,/obj/item/weapon/reagent_containers/food/condiment/enzyme,/obj/item/weapon/reagent_containers/food/condiment/enzyme,/obj/item/weapon/reagent_containers/food/condiment/enzyme,/obj/item/weapon/reagent_containers/food/condiment/enzyme,/obj/item/weapon/reagent_containers/food/condiment/enzyme,/obj/item/weapon/reagent_containers/food/condiment/enzyme,/obj/item/weapon/reagent_containers/food/condiment/enzyme,/obj/item/weapon/reagent_containers/food/condiment/enzyme,/obj/item/weapon/reagent_containers/food/condiment/enzyme,/turf/floor/beach/water/deep/saltwater,/area/caribbean/sea/top/roofed)
"aQ" = (/obj/structure/barricade/ship/north/corners{dir = 6; icon_state = "boat1_up_corners"},/obj/item/flashlight/lantern/on/anchored,/turf/floor/beach/water/deep/saltwater,/area/caribbean/sea/top/roofed)
"aR" = (/obj/structure/barricade/ship{dir = 2},/turf/floor/beach/water/deep/saltwater,/area/caribbean/sea/top/roofed)
"aS" = (/obj/structure/barricade/ship/aport0,/obj/structure/cannon/modern/tank/voyage/autofire,/turf/floor/beach/water/deep/saltwater,/area/caribbean/sea/top/roofed)
"aT" = (/obj/covers/wood_ship,/obj/structure/barricade/ship/wood/a4,/turf/floor/broken_floor,/area/caribbean/sea/top/roofed)
"aU" = (/obj/covers/wood_ship,/obj/structure/window/barrier/ship/blue/bport_north,/turf/floor/broken_floor,/area/caribbean/sea/top)
"aV" = (/obj/covers/wood_ship,/obj/structure/window/barrier/ship/blue/bport_north,/obj/structure/closet/crate/cannonball,/turf/floor/broken_floor,/area/caribbean/sea/top)
"aW" = (/obj/covers/wood_ship,/obj/structure/window/barrier/ship/blue/bport_north,/obj/structure/closet/crate/musketball,/turf/floor/broken_floor,/area/caribbean/sea/top)
"aX" = (/obj/covers/wood_ship,/obj/structure/window/barrier/ship/blue/bport_10,/turf/floor/broken_floor,/area/caribbean/sea/top)
"aY" = (/obj/covers/wood_ship,/obj/structure/barricade/ship/wood/a7,/turf/floor/broken_floor,/area/caribbean/sea/top/roofed)
"aZ" = (/obj/covers/wood_ship,/turf/floor/broken_floor,/area/caribbean/sea/top/roofed)
"ba" = (/obj/covers/wood_ship,/obj/structure/barricade/ship/wood/a10,/obj/item/flashlight/lantern/on/anchored,/turf/floor/broken_floor,/area/caribbean/sea/top/roofed)
"bc" = (/obj/covers/wood_ship,/turf/floor/broken_floor,/area/caribbean/sea/top)
"bd" = (/obj/covers/wood_ship,/obj/structure/cannon/modern/tank/voyage/autofire{dir = 1; icon_state = "cannon"},/turf/floor/broken_floor,/area/caribbean/sea/top)
"be" = (/obj/covers/wood_ship,/obj/structure/barricade/ship/blue/beast,/turf/floor/broken_floor,/area/caribbean/sea/top)
"bf" = (/obj/covers/wood_ship,/obj/structure/barricade/ship/wood/a2,/turf/floor/broken_floor,/area/caribbean/sea/top/roofed)
"bg" = (/obj/covers/wood_ship,/obj/structure/grapplehook/auto{dir = 1},/turf/floor/broken_floor,/area/caribbean/sea/top)
"bh" = (/obj/covers/wood_ship,/obj/structure/bed/chair/wood/red{dir = 4},/mob/living/simple_animal/hostile/human/voyage/spanish/ranged/lt,/turf/floor/broken_floor,/area/caribbean/sea/top/roofed)
"bi" = (/obj/covers/wood_ship,/obj/structure/closet/cabinet,/obj/item/weapon/gun/projectile/flintlock/blunderbuss,/obj/item/ammo_casing/blunderbuss,/obj/item/weapon/key/civ{code = 1999; name = "Treasury Key"},/turf/floor/broken_floor,/area/caribbean/sea/top/roofed)
"bj" = (/obj/covers/wood_ship,/obj/structure/barricade/ship/wood/a12,/turf/floor/broken_floor,/area/caribbean/sea/top/roofed)
"bk" = (/obj/covers/wood_ship,/mob/living/simple_animal/hostile/human/voyage/spanish,/turf/floor/broken_floor,/area/caribbean/sea/top)
"bl" = (/obj/covers/wood_ship,/obj/structure/table/wood,/obj/item/weapon/pen,/obj/item/weapon/paper,/turf/floor/broken_floor,/area/caribbean/sea/top/roofed)
"bm" = (/obj/covers/wood_ship,/obj/structure/barricade/ship/wood/a9,/turf/floor/broken_floor,/area/caribbean/sea/top/roofed)
"bn" = (/obj/structure/window/barrier/ship/blue/bport3{dir = 1},/obj/covers/repairedfloor/ship/south,/turf/floor/broken_floor,/area/caribbean/sea/top)
"bo" = (/obj/covers/wood_ship,/mob/living/simple_animal/hostile/human/voyage/spanish/ranged,/turf/floor/broken_floor,/area/caribbean/sea/top)
"bp" = (/obj/structure/simple_door/key_door/custom/singledoor/privacy{code = 1999; locked = 1; unique_door_name = "Captain's Quarters"},/obj/covers/wood_ship,/turf/floor/broken_floor,/area/caribbean/sea/top/roofed)
"bq" = (/obj/covers/wood_ship,/mob/living/simple_animal/hostile/human/voyage/spanish/ranged/sgt,/turf/floor/broken_floor,/area/caribbean/sea/top)
"br" = (/obj/covers/wood_ship,/obj/structure/multiz/ladder/ww2,/turf/floor/broken_floor,/area/caribbean/sea/top)
"bs" = (/obj/covers/wood_ship,/obj/structure/table/wood,/turf/floor/broken_floor,/area/caribbean/sea/top/roofed)
"bt" = (/obj/covers/wood_ship,/obj/structure/barricade/ship/blue/b17,/turf/floor/broken_floor,/area/caribbean/sea/top/roofed)
"bu" = (/obj/covers/wood_ship,/obj/item/flashlight/lantern/on/anchored,/obj/structure/barricade/ship/blue/b20{dir = 2},/turf/floor/broken_floor,/area/caribbean/sea/top/roofed)
"bv" = (/obj/covers/wood_ship,/obj/structure/bed/padded,/obj/item/weapon/bedsheet/brown,/turf/floor/broken_floor,/area/caribbean/sea/top/roofed)
"bw" = (/obj/covers/wood_ship,/mob/living/simple_animal/hostile/human/voyage/spanish/ranged,/turf/floor/broken_floor,/area/caribbean/sea/top/roofed)
"bx" = (/obj/covers/wood_ship,/obj/structure/barricade/ship/wood/a12,/obj/item/flashlight/lantern/on/anchored,/turf/floor/broken_floor,/area/caribbean/sea/top/roofed)
"bz" = (/obj/covers/wood_ship,/obj/structure/bookcase,/turf/floor/broken_floor,/area/caribbean/sea/top/roofed)
"bA" = (/obj/covers/wood_ship,/obj/structure/closet/crate/cannonball,/turf/floor/broken_floor,/area/caribbean/sea/top)
"bB" = (/obj/covers/wood_ship,/obj/structure/grapplehook/auto,/turf/floor/broken_floor,/area/caribbean/sea/top)
"bC" = (/obj/effect/landmark{name = "Grappling Hook area - do not block"},/turf/floor/beach/water/deep/saltwater,/area/caribbean/sea/top)
"bD" = (/obj/covers/wood_ship,/obj/structure/barricade/ship/mast/large,/obj/item/flashlight/lantern/on/anchored,/turf/floor/broken_floor,/area/caribbean/sea/top)
"bE" = (/obj/covers/wood_ship,/obj/structure/barricade/ship/blue/b9,/turf/floor/broken_floor,/area/caribbean/sea/top/roofed)
"cY" = (/obj/covers/wood_ship,/obj/structure/barricade/ship/blue/b10,/turf/floor/broken_floor,/area/caribbean/sea/top/roofed)
"yN" = (/obj/covers/wood_ship,/obj/structure/window/barrier/ship/blue/bport0/south,/obj/effect/landmark{name = "Grappling Hook area - do not block"},/turf/floor/broken_floor,/area/caribbean/sea/top)
"DV" = (/obj/structure/ship_bow,/turf/floor/beach/water/deep/saltwater,/area/caribbean/sea/top)
"Ro" = (/obj/covers/wood_ship,/obj/structure/window/barrier/ship/blue/bport0/south,/turf/floor/broken_floor,/area/caribbean/sea/top)
"Xl" = (/obj/covers/wood_ship,/obj/structure/window/barrier/ship/blue/bport3/south,/obj/structure/cannon/modern/tank/voyage/autofire,/turf/floor/broken_floor,/area/caribbean/sea/top)
"XJ" = (/obj/covers/wood_ship,/obj/structure/window/barrier/ship/blue/bport9,/turf/floor/broken_floor,/area/caribbean/sea/top)

(1,1,1) = {"
aaaaaaaaaaaaaaaaaaaaaaaaaaaaaaaaaaaaaaaaaaaaaaaaaaaaaaaaaaaaaaaaaaaaaaaaaaaaaaaaaaaaaaaaaaaaaaaaaaaaaaaaaaaaaaaaaaaaaaaaaaaaaaaaaaaaaaaaaaaaaaaaaaaaaa
aaaaaaaaaaaaaaaaaaaaaaaaaaaaaaaaaaaaaaaaaaaaaaaaaaaaaaaaaaaaaaaaaaaaaaaaaaaaaaaaaaaaaaaaaaaaaaaaaaaaaaaaaaaaaaaaaaaaaaaaaaaaaaaaaaaaaaaaaaaaaaaaaaaaaa
aaaaaaaaaaaaaaaaaaaaaaaaaaaaaaaaaaaaaaaaaaaaaaaaaaaaaaaaaaaaaaaaaaaaaaaaaaaaaaaaaaaaaaaaaaaaaaaaaaaaaaaaaaaaaaaaaaaaaaaaaaaaaaaaaaaaaaaaaaaaaaaaaaaaaa
aaaaaaaaaaaaaaaaaaaaaaaaaaaaaaaaaaaaaaaaaaaaaaaaaaaaaaaaaaaaaaaaaaaaaaaaaaaaaaaaaaaaaaaaaaaaaaaaaaaaaaaaaaaaaaaaaaaaaaaaaaaaaaaaaaaaaaaaaaaaaaaaaaaaaa
aaaaaaaaaaaaaaaaaaaaaaaaaaaaaaaaaaaaaaaaaaaaaaaaaaaaaaaaaaaaaaaaaaaaaaaaaaaaaaaaaaaaaaaaaaaaaaaaaaaaaaaaaaaaaaaaaaaaaaaaaaaaaaaaaaaaaaaaaaaaaaaaaaaaaa
aaaaaaaaaaaaaaaaaaaaaaaaaaaaaaaaaaaaaaaaaaaaaaaaaaaaaaaaaaaaaaaaaaaaaaaaaaaaaaaaaaaaaaaaaaaaaaaaaaaaaaaaaaaaaaaaaaaaaaaaaaaaaaaaaaaaaaaaaaaaaaaaaaaaaa
aaaaaaaaaaaaaaaaaaaaaaaaaaaaaaaaaaaaaaaaaaaaaaaaaaaaaaaaaaaaaaaaaaaaaaaaaaaaaaaaaaaaaaaaaaaaaaaaaaaaaaaaaaaaaaaaaaaaaaaaaaaaaaaaaaaaaaaaaaaaaaaaaaaaaa
aaaaaaaaaaaaaaaaaaaaaaaaaaaaaaaaaaaaaaaaaaaaaaaaaaaaaaaaaaaaaaaaaaaaaaaaaaaaaaaaaaaaaaaaaaaaaaaaaaaaaaaaaaaaaaaaaaaaaaaaaaaaaaaaaaaaaaaaaaaaaaaaaaaaaa
aaaaaaaaaaaaaaaaaaaaaaaaaaaaaaaaaaaaaaaaaaaaaaaaaaaaaaaaaaaaaaaaaaaaaaaaaaaaaaaaaaaaaaaaaaaaaaaaaaaaaaaaaaaaaaaaaaaaaaaaaaaaaaaaaaaaaaaaaaaaaaaaaaaaaa
aaaaaaaaaaaaaaaaaaaaaaaaaaaaaaaaaaaaaaaaaaaaaaaaaaaaaaaaaaaaaaaaaaaaaaaaaaaaaaaaaaaaaaaaaaaaaaaaaaaaaaaaaaaaaaaaaaaaaaaaaaaaaaaaaaaaaaaaaaaaaaaaaaaaaa
aaaaaaaaaaaaaaaaaaaaaaaaaaaaaaaaaaaaaaaaaaaaaaaaaaaaaaaaaaaaaaaaaaaaaaaaaaaaaaaaaaaaaaaaaaaaaaaaaaaaaaaaaaaaaaaaaaaaaaaaaaaaaaaaaaaaaaaaaaaaaaaaaaaaaa
aaaaaaaaaaaaaaaaaaaaaaaaaaaaaaaaaaaaaaaaaaaaaaaaaaaaaaaaaaaaaaaaaaaaaaaaaaaaaaaaaaaaaaaaaaaaaaaaaaaaaaaaaaaaaaaaaaaaaaaaaaaaaaaaaaaaaaaaaaaaaaaaaaaaaa
aaaaaaaaaaaaaaaaaaaaaaaaaaaaaaaaaaaaaaaaaaaaaaaaaaaaaaaaaaaaaaaaaaaaaaaaaaaaaaaaaaaaaaaaaaaaaaaaaaaaaaaaaaaaaaaaaaaaaaaaaaaaaaaaaaaaaaaaaaaaaaaaaaaaaa
aaaaaaaaaaaaaaaaaaaaaaaaaaaaaaaaaaaaaaaaaaaaaaaaaaaaaaaaaaaaaaaaaaaaaaaaaaaaaaaaaaaaaaaaaaaaaaaaaaaaaaaaaaaaaaaaaaaaaaaaaaaaaaaaaaaaaaaaaaaaaaaaaaaaaa
aaaaaaaaaaaaaaaaaaaaaaaaaaaaaaaaaaaaaaaaaaaaaaaaaaaaaaaaaaaaaaaaaaaaaaaaaaaaaaaaaaaaaaaaaaaaaaaaaaaaaaaaaaaaaaaaaaaaaaaaaaaaaaaaaaaaaaaaaaaaaaaaaaaaaa
aaaaaaaaaaaaaaaaaaaaaaaaaaaaaaaaaaaaaaaaaaaaaaaaaaaaaaaaaaaaaaaaaaaaaaaaaaaaaaaaaaaaaaaaaaaaaaaaaaaaaaaaaaaaaaaaaaaaaaaaaaaaaaaaaaaaaaaaaaaaaaaaaaaaaa
aaaaaaaaaaaaaaaaaaaaaaaaaaaaaaaaaaaaaaaaabaxaxaxaxaxaxaxaxaxataxaxaxaxaxataxaxaxaxaxaxaxaxaDaaaaaaaaaaaaaaaaaaaaaaaaaaaaaaaaaaaaaaaaaaaaaaaaaaaaaaaaaa
aaaaaaaaaaaaaaaaaaaaaaaaaaaaaaaaaaaaaaabacagagaAaiajaiajaiajadajajaeajajadajajaAafakalamamanaDaaaaaaaaaaaaaaaaaaaaaaaaaaaaaaaaaaaaaaaaaaaaaaaaaaaaaaaa
aaaaaaaaaaaaaaaaaaaaaaaaaaaaaaaaaaaaaaaragajajasajajajaoajajajajajajaoajajajajasajajajajajauaCaDaaaaaaaaaaaaaaaaaaaaaaaaaaaaaaaaaaaaaaaaaaaaaaaaaaaaaa
aaaaaaaaaaaaaaaaaaaaaaaaaaaaaaaaaaaaaaaragaJajaHajajajajajajaoajajajajajajajajaHajajaJajajajapaqaaaaaaaaaaaaaaaaaaaaaaaaaaaaaaaaaaaaaaaaaaaaaaaaaaaaaa
aaaaaaaaaaaaaaaaaaaaaaaaaaaaaaaaaaaaaaaragajajaMaiajaiajaiajajajajajajajajajajasajajajajajajapaqaaaaaaaaaaaaaaaaaaaaaaaaaaaaaaaaaaaaaaaaaaaaaaaaaaaaaa
aaaaaaaaaaaaaaaaaaaaaaaaaaaaaaaaaaaaaaaragajajaMajavajajajajajajajajajajajajajasajajajajajauazaBaaaaaaaaaaaaaaaaaaaaaaaaaaaaaaaaaaaaaaaaaaaaaaaaaaaaaa
aaaaaaaaaaaaaaaaaaaaaaaaaaaaaaaaaaaaaaaEaFaIaIaKaiajaiajaiajajajajaeajajajajajaAaLaLaNaNaPaQaBaaaaaaaaaaaaaaaaaaaaaaaaaaaaaaaaaaaaaaaaaaaaaaaaaaaaaaaa
aaaaaaaaaaaaaaaaaaaaaaaaaaaaaaaaaaaaaaaaaEaRaRaRaRaRaRaRaRaRaSaRaRaRaRaRaSaRaRaRaRaRaRaRaRaBaaaaaaaaaaaaaaaaaaaaaaaaaaaaaaaaaaaaaaaaaaaaaaaaaaaaaaaaaa
aOaaaaaaaaaaaaaaaaaaaaaaaaaaaaaaaaaaaaaaaaaaaaaaaaaaaaaaaaaaaaaaaaaaaaaaaaaaaaaaaaaaaaaaaaaaaaaaaaaaaaaaaaaaaaaaaaaaaaaaaaaaaaaaaaaaaaaaaaaaaaaaaaaaaa
"}
(1,1,2) = {"
aaaaaaaaaaaaaaaaaaaaaaaaaaaaaaaaaaaaaaaaaaaaaaaaaaaaaaaaaaaaaaaaaaaaaaaaaaaaaaaaaaaaaaaaaaaaaaaaaaaaaaaaaaaaaaaaaaaaaaaaaaaaaaaaaaaaaaaaaaaaaaaaaaaaaa
aaaaaaaaaaaaaaaaaaaaaaaaaaaaaaaaaaaaaaaaaaaaaaaaaaaaaaaaaaaaaaaaaaaaaaaaaaaaaaaaaaaaaaaaaaaaaaaaaaaaaaaaaaaaaaaaaaaaaaaaaaaaaaaaaaaaaaaaaaaaaaaaaaaaaa
aaaaaaaaaaaaaaaaaaaaaaaaaaaaaaaaaaaaaaaaaaaaaaaaaaaaaaaaaaaaaaaaaaaaaaaaaaaaaaaaaaaaaaaaaaaaaaaaaaaaaaaaaaaaaaaaaaaaaaaaaaaaaaaaaaaaaaaaaaaaaaaaaaaaaa
aaaaaaaaaaaaaaaaaaaaaaaaaaaaaaaaaaaaaaaaaaaaaaaaaaaaaaaaaaaaaaaaaaaaaaaaaaaaaaaaaaaaaaaaaaaaaaaaaaaaaaaaaaaaaaaaaaaaaaaaaaaaaaaaaaaaaaaaaaaaaaaaaaaaaa
aaaaaaaaaaaaaaaaaaaaaaaaaaaaaaaaaaaaaaaaaaaaaaaaaaaaaaaaaaaaaaaaaaaaaaaaaaaaaaaaaaaaaaaaaaaaaaaaaaaaaaaaaaaaaaaaaaaaaaaaaaaaaaaaaaaaaaaaaaaaaaaaaaaaaa
aaaaaaaaaaaaaaaaaaaaaaaaaaaaaaaaaaaaaaaaaaaaaaaaaaaaaaaaaaaaaaaaaaaaaaaaaaaaaaaaaaaaaaaaaaaaaaaaaaaaaaaaaaaaaaaaaaaaaaaaaaaaaaaaaaaaaaaaaaaaaaaaaaaaaa
aaaaaaaaaaaaaaaaaaaaaaaaaaaaaaaaaaaaaaaaaaaaaaaaaaaaaaaaaaaaaaaaaaaaaaaaaaaaaaaaaaaaaaaaaaaaaaaaaaaaaaaaaaaaaaaaaaaaaaaaaaaaaaaaaaaaaaaaaaaaaaaaaaaaaa
aaaaaaaaaaaaaaaaaaaaaaaaaaaaaaaaaaaaaaaaaaaaaaaaaaaaaaaaaaaaaaaaaaaaaaaaaaaaaaaaaaaaaaaaaaaaaaaaaaaaaaaaaaaaaaaaaaaaaaaaaaaaaaaaaaaaaaaaaaaaaaaaaaaaaa
aaaaaaaaaaaaaaaaaaaaaaaaaaaaaaaaaaaaaaaaaaaaaaaaaaaaaaaaaaaaaaaaaaaaaaaaaaaaaaaaaaaaaaaaaaaaaaaaaaaaaaaaaaaaaaaaaaaaaaaaaaaaaaaaaaaaaaaaaaaaaaaaaaaaaa
aaaaaaaaaaaaaaaaaaaaaaaaaaaaaaaaaaaaaaaaaaaaaaaaaaaaaaaaaaaaaaaaaaaaaaaaaaaaaaaaaaaaaaaaaaaaaaaaaaaaaaaaaaaaaaaaaaaaaaaaaaaaaaaaaaaaaaaaaaaaaaaaaaaaaa
aaaaaaaaaaaaaaaaaaaaaaaaaaaaaaaaaaaaaaaaaaaaaaaaaaaaaaaaaaaaaaaaaaaaaaaaaaaaaaaaaaaaaaaaaaaaaaaaaaaaaaaaaaaaaaaaaaaaaaaaaaaaaaaaaaaaaaaaaaaaaaaaaaaaaa
aaaaaaaaaaaaaaaaaaaaaaaaaaaaaaaaaaaaaaaaaaaaaaaaaaaaaaaaaaaaaaaaaaaaaaaaaaaaaaaaaaaaaaaaaaaaaaaaaaaaaaaaaaaaaaaaaaaaaaaaaaaaaaaaaaaaaaaaaaaaaaaaaaaaaa
aaaaaaaaaaaaaaaaaaaaaaaaaaaaaaaaaaaaaaaaaaaaaaaaaaaaaaaaaaaaaaaaaaaaaaaaaaaaaaaaaaaaaaaaaaaaaaaaaaaaaaaaaaaaaaaaaaaaaaaaaaaaaaaaaaaaaaaaaaaaaaaaaaaaaa
aaaaaaaaaaaaaaaaaaaaaaaaaaaaaaaaaaaaaaaaaaaaaaaaaaaaaaaaaaaaaaaaaaaaaaaaaaaaaaaaaaaaaaaaaaaaaaaaaaaaaaaaaaaaaaaaaaaaaaaaaaaaaaaaaaaaaaaaaaaaaaaaaaaaaa
aaaaaaaaaaaaaaaaaaaaaaaaaaaaaaaaaaaaaaaaaaaaaaaaaaaaaaaaaaaaaaaaaaaaaaaaaaaaaaaaaaaaaaaaaaaaaaaaaaaaaaaaaaaaaaaaaaaaaaaaaaaaaaaaaaaaaaaaaaaaaaaaaaaaaa
aaaaaaaaaaaaaaaaaaaaaaaaaaaaaaaaaaaaaaaaaaaaaaaaaaaaaaaaaaaaaaaaaaaaaaaaaaaaaaaaaaaaaaaaaaaaaaaaaaaaaaaaaaaaaaaaaaaaaaaaaaaaaaaaaaaaaaaaaaaaaaaaaaaaaa
aaaaaaaaaaaaaaaaaaaaaaaaaaaaaaaaaaaaaaaaaTaYaYaYbmaUaUbnaVaUaUaUaUbnaUaUaUaUaVbnaUaUaUaWaWaXaaaaaaaaaaaaaaaaaaaaaaaaaaaaaaaaaaaaaaaaaaaaaaaaaaaaaaaaaa
aaaaaaaaaaaaaaaaaaaaaaaaaaaaaaaaaaaaaaaTbabsaZbibjbcbcbdbcbcbcbgbcbdbcbcbcbcbcbdbcbgbcbcbcbeaaaaaaaaaaaaaaaaaaaaaaaaaaaaaaaaaaaaaaaaaaaaaaaaaaaaaaaaaa
aaaaaaaaaaaaaaaaaaaaaaaaaaaaaaaaaaaaaabfbhblaZbwbxbcbcbcbcbkbcbcbcbcbcbcbcbkbcbcbcbcbcbcbobeaaaaaaaaaaaaaaaaaaaaaaaaaaaaaaaaaaaaaaaaaaaaaaaaaaaaaaaaaa
aaaaaaaaaaaaaaaaaaaaaaaaaaaaaaaaaaaaaabfaZbsaZaZbpbcbcbcbcbcbcbcbcbqbcbcbcbcbcbcbcbcbcbcbcbeaaaaaaaaaaaaaaaaaaaaaaaaaaaaaaaaaaaaaaaaaaaaaaaaaaaaaaaaaa
aaaaaaaaaaaaaaaaaaaaaaaaaaaaaaaaaaaaaabfaZaZaZbwbxbcbcbcbDbcbcbcbcbcbcbcbDbcbcbcbcbcbcbcbcbeaaaaaaaaaaaaaaaaaaaaaaaaaaaaaaaaaaaaaaaaaaaaaaaaaaaaaaaaaa
aaaaaaaaaaaaaaaaaaaaaaaaaaaaaaaaaaaaaabfaZaZaZaZbjbrbcbcbcbkbcbcbcbcbcbcbcbkbcbcbcbcbcbcbcbeaaaaaaaaaaaaaaaaaaaaaaaaaaaaaaaaaaaaaaaaaaaaaaaaaaaaaaaaaa
aaaaaaaaaaaaaaaaaaaaaaaaaaaaaaaaaaaaaabtbubvaZbzbjbcbcbcbAbcbcbBbcbcbcbcbcbcbAbcbcbBbcbcbobeaaaaaaaaaaaaaaaaaaaaaaaaaaaaaaaaaaaaaaaaaaaaaaaaaaaaaaaaaa
aaaaaaaaaaaaaaaaaaaaaaaaaaaaaaaaaaaaaaaabtbEbEbEcYRoRoXlyNRoRoRoRoXlRoyNRoRoRoXlRoRoRoRoRoXJDVaaaaaaaaaaaaaaaaaaaaaaaaaaaaaaaaaaaaaaaaaaaaaaaaaaaaaaaa
aaaaaaaaaaaaaaaaaaaaaaaaaaaaaaaaaaaaaaaaaaaaaaaaaaaaaaaabCaaaaaaaaaaaabCaaaaaaaaaaaaaaaaaaaaaaaaaaaaaaaaaaaaaaaaaaaaaaaaaaaaaaaaaaaaaaaaaaaaaaaaaaaaaa
"}
