"a" = (/turf/floor/dirt/burned,/area/caribbean)
"b" = (/turf/floor/plating/cobblestone/vertical/dark,/area/caribbean)
"c" = (/turf/floor/plating/road,/area/caribbean)
"d" = (/obj/covers/brick_wall,/turf/wall/brick,/area/caribbean)
"e" = (/obj/covers/brick_wall/incomplete,/turf/floor/dirt/burned,/area/caribbean)
"f" = (/turf/floor/plating/tiled,/area/caribbean)
"g" = (/obj/covers/brick_wall/incomplete,/turf/floor/plating/tiled,/area/caribbean)

(1,1,1) = {"
aaaaaaaaaaaaaaaaaaaaaaaaaaaaaaaaaaaaaaaaaaaaaaaaaaaaaaaaaaaaaaaaaaaaaaabbccccccbbaaaaaaaaaaaaaaaaaaaaaaaaaaaaaaaaaaaaaaaaaaaaaaaaaaaaaaaaaaaaaaaaaaaaa
aaaaaaaaaaaaaaaaaaaaaaaaaaaaaaaaaaaaaaaaaaaaaaaaaaaaaaaaaaaaaaaaaaaaaaabbccccccbbaaaaaaaaaaaaaaaaaaaaaaaaaaaaaaaaaaaaaaaaaaaaaaaaaaaaaaaaaaaaaaaaaaaaa
aaaaaaaaaaaaaaaaaaaaaaaaaaaaaaaaaaaaaaaaaaaaaaaaaaaaaaaaaaaaaaaaaaaaaaabbccccccbbaaaaaaaaaaaaaaaaaaaaaaaaaaaaaaaaaaaaaaaaaaaaaaaaaaaaaaaaaaaaaaaaaaaaa
aaaaaaaaaaaaaaaaaaaaaaaaaaaaaaaaaaaaaaaaaaaaaaaaaaaaaaaaaaaaaaaaaaaaaaabbccccccbbaaaaaaaaaaaaaaaaaaaaaaaaaaaaaaaaaaaaaaaaaaaaaaaaaaaaaaaaaaaaaaaaaaaaa
aaaaaaaaaaaaaaaaaaaaaaaaaaaaaaaaaaaaaaaaaaaaaaaaaaaaaaaaaaaaaaaaaaaaaaabbccccccbbaaaaaaaaaaaaaaaaaaaaaaaaaaaaaaaaaaaaaaaaaaaaaaaaaaaaaaaaaaaaaaaaaaaaa
aaaaaaaaaaaaaaaaaaaaaaaaaaaaaaaaaaaaaaaaaaaaaaaaaaaaaaaaaaaaaaaaaaaaaaabbccccccbbaaaaaaaaaaaaaaaaaaaaaaaaaaaaaaaaaaaaaaaaaaaaaaaaaaaaaaaaaaaaaaaaaaaaa
aaaaaaaaaaaaaaaaaaaaaaaaaaaaaaaaaaaaaaaaaaaaaaaaaaaaaaaaaaaaaaaaaaaaaaabbccccccbbaaaaaaaaaaaaaaaaaaaaaaaaaaaaaaaaaaaaaaaaaaaaaaaaaaaaaaaaaaaaaaaaaaaaa
aaaaaaaaaaaaaaaaaaaaaaaaaaaaaaaaaaaaaaaaaaaaaaaaaaaaaaaaaaaaaaaaaaaaaaabbccccccbbaaaaaaaaaaaaaaaaaaaaaaaaaaaaaaaaaaaaaaaaaaaaaaaaaaaaaaaaaaaaaaaaaaaaa
aaaaaaaaaaaaaaaaaaaaaaaaaaaaaaaaaaaaaaaaaaaaaaaaaaaaaaaaaaaaaaaaaaaaaaabbccccccbbaaaaaaaaaaaaaaaaaaaaaaaaaaaaaaaaaaaaaaaaaaaaaaaaaaaaaaaaaaaaaaaaaaaaa
aaaaaaaaaaaaaaaaaaaaaaaaaaaaaaaaaaaaaaaaaaaaaaaaaaaaaaaaaaaaaaaaaaaaaaabbccccccbbaaaaaaaaaaaaaaaaaaaaaaaaaaaaaaaaaaaaaaaaaaaaaaaaaaaaaaaaaaaaaaaaaaaaa
aaaaaaaaaaaaaaaaaaaaaaaaaaaaaaaaaaaaaaaaaaaaaaaaaaaaaaaaaaaaaaaaaaaaaaabbccccccbbaaaaaaaaaaaaaaaaaaaaaaaaaaaaaaaaaaaaaaaaaaaaaaaaaaaaaaaaaaaaaaaaaaaaa
aaaaaaaaaaaaaaaaaaaaaaaaaaaaaaaaaaaaaaaaaaaaaaaaaaaaaaaaaaaaaaaaaaaaaaabbccccccbbaaaaaaaaaaaaaaaaaaaaaaaaaaaaaaaaaaaaaaaaaaaaaaaaaaaaaaaaaaaaaaaaaaaaa
aaaaaaaaaaaaaaaaaaaaaaaaaaaaaaaaaaaaaaaaaaaaaaaaaaaaaaaaaaaaaaaaaaaaaaabbccccccbbaaaaaaaaaaaaaaaaaaaaaaaaaaaaaaaaaaaaaaaaaaaaaaaaaaaaaaaaaaaaaaaaaaaaa
aaaaaaaaaaaaaaaaaaaaaaaaaaaaaaaaaaaaaaaaaaaaaaaaaaaaaaaaaaaaaaaaaaaaaaabbccccccbbaaaaaaaaaaaaaaaaaaaaaaaaaaaaaaaaaaaaaaaaaaaaaaaaaaaaaaaaaaaaaaaaaaaaa
aaaaaaaaaaaaaaaaaaaaaaaaaaaaaaaaaaaaaaaaaaaaaaaaaaaaaaaaaaaaaaaaaaaaaaabbccccccbbaaaaaaaaaaaaaaaaaaaaaaaaaaaaaaaaaaaaaaaaaaaaaaaaaaaaaaaaaaaaaaaaaaaaa
aaaaaaaaaaaaaaaaaaaaaaaaaaaaaaaaaaaaaaaaaaaaaaaaaaaaaaaaaaaaaaaaaaaaaaabbccccccbbaaaaaaaaaaaaaaaaaaaaaaaaaaaaaaaaaaaaaaaaaaaaaaaaaaaaaaaaaaaaaaaaaaaaa
aaaaaaaaaaaaaaaaaaaaaaaaaaaaaaaaaaaaaaaaaaaaaaaaaaaaaaaaaaaaaaaaaaaaaaabbccccccbbaaaaaaaaaaaaaaaaaaaaaaaaaaaaaaaaaaaaaaaaaaaaaaaaaaaaaaaaaaaaaaaaaaaaa
aaaaaaaaaaaaaaaaaaaaaaaaaaaaaaaaaaaaaaaaaaaaaaaaaaaaaaaaaaaaaaaaaaaaaaabbccccccbbaaaaaaaaaaaaaaaaaaaaaaaaaaaaaaaaaaaaaaaaaaaaaaaaaaaaaaaaaaaaaaaaaaaaa
aaaaaaaaaaaaaaaaaaaaaaaaaaaaaaaaaaaaaaaaaaaaaaaaaaaaaaaaaaaaaaaaaaaaaaabbccccccbbaaaaaaaaaaaaaaaaaaaaaaaaaaaaaaaaaaaaaaaaaaaaaaaaaaaaaaaaaaaaaaaaaaaaa
aaaaaaaaaaaaaaaaaaaaaaaaaaaaaaaaaaaaaaaaaaaaaaaaaaaaaaaaaaaaaaaaaaaaaaabbccccccbbaaaaaaaaaaaaaaaaaaaaaaaaaaaaaaaaaaaaaaaaaaaaaaaaaaaaaaaaaaaaaaaaaaaaa
aaaaaaaaaaaaaaaaaaaaaaaaaaaaaaaaaaaaaaaaaaaaaaaaaaaaaaaaaaaaaaaaaaaaaaabbccccccbbaaaaaaaaaaaaaaaaaaaaaaaaaaaaaaaaaaaaaaaaaaaaaaaaaaaaaaaaaaaaaaaaaaaaa
aaaaaaaaaaaaaaaaaaaaaaaaaaaaaaaaaaaaaaaaaaaaaaaaaaaaaaaaaaaaaaaaaaaaaaabbccccccbbaaaaaaaaaaaaaaaaaaaaaaaaaaaaaaaaaaaaaaaaaaaaaaaaaaaaaaaaaaaaaaaaaaaaa
aaaaaaaaaaaaaaaaaaaaaaaaaaaaaaaaaaaaaaaaaaaaaaaaaaaaaaaaaaaaaaaaaaaaaaabbccccccbbaaaaaaaaaaaaaaaaaaaaaaaaaaaaaaaaaaaaaaaaaaaaaaaaaaaaaaaaaaaaaaaaaaaaa
aaaaaaaaaaaaaaaaaaaaaaaaaaaaaaaaaaaaaaaaaaaaaaaaaaaaaaaaaaaaaaaaaaaaaaabbccccccbbaaaaaaaaaaaaaaaaaaaaaaaaaaaaaaaaaaaaaaaaaaaaaaaaaaaaaaaaaaaaaaaaaaaaa
aaaaaaaaaaaaaaaaaaaaaaaaaaaaaaaaaaaaaaaaaaaaaaaaaaaaaaaaaaaaaaaaaaaaaaabbccccccbbaaaaaaaaaaaaaaaaaaaaaaaaaaaaaaaaaaaaaaaaaaaaaaaaaaaaaaaaaaaaaaaaaaaaa
aaaaaaaaaaaaaaaaaaaaaaaaaaaaaaaaaaaaaaaaaaaaaaaaaaaaaaaaaaaaaaaaaaaaaaabbccccccbbaaaaaaaaaaaaaaaaaaaaaaaaaaaaaaaaaaaaaaaaaaaaaaaaaaaaaaaaaaaaaaaaaaaaa
aaaaaaaaaaaaaaaaaaaaaaaaaaaaaaaaaaaaaaaaaaaaaaaaaaaaaaaaaaaaaaaaaaaaaaabbccccccbbaaaaaaaaaaaaaaaaaaaaaaaaaaaaaaaaaaaaaaaaaaaaaaaaaaaaaaaaaaaaaaaaaaaaa
aaaaaaaaaaaaaaaaaaaaaaaaaaaaaaaaaaaaaaaaaaaaaaaaaaaaaaaaaaaaaaaaaaaaaaabbccccccbbaaaaaaaaaaaaaaaaaaaaaaaaaaaaaaaaaaaaaaaaaaaaaaaaaaaaaaaaaaaaaaaaaaaaa
aaaaaaaaaaaaaaaaaaaaaaaaaaaaaaaaaaaaaaaaaaaaaaaaaaaaaaaaaaaaaaaaaaaaaaabbccccccbbaaaaaaaaaaaaaaaaaaaaaaaaaaaaaaaaaaaaaaaaaaaaaaaaaaaaaaaaaaaaaaaaaaaaa
aaaaaaaaaaaaaaaaaaaaaaaaaaaaaaaaaaaaaaaaaaaaaaaaaaaaaaaaaaaaaaaaaaaaaaabbccccccbbaaaaaaaaaaaaaaaaaaaaaaaaaaaaaaaaaaaaaaaaaaaaaaaaaaaaaaaaaaaaaaaaaaaaa
bbbbbbbbbbbbbbbbbbbbbbbbbbbbbbbbbbbbbbbbbbbbbbbbbbbbbbbbbbbbbbbbbbbbbbbbbccccccbbaaaaaaaaaaaaaaaaaaaaaaaaaaaaaaaaaaaaaaaaaaaaaaaaaaaaaaaaaaaaaaaaaaaaa
bbbbbbbbbbbbbbbbbbbbbbbbbbbbbbbbbbbbbbbbbbbbbbbbbbbbbbbbbbbbbbbbbbbbbbbbbccccccbbaaaaaaaaaaaaaaaaaaaaaaaaaaaaaaaaaaaaaaaaaaaaaaaaaaaaaaaaaaaaaaaaaaaaa
cccccccccccccccccccccccccccccccccccccccccccccccccccccccccccccccccccccccccccccccbbaaaaaaaaaaaaaaaaaaaaaaaaaaaaaaaaaaaaaaaaaaaaaaaaaaaaaaaaaaaaaaaaaaaaa
cccccccccccccccccccccccccccccccccccccccccccccccccccccccccccccccccccccccccccccccbbaaaaaaaaaaaaaaaaaaaaaaaaaaaaaaaaaaaaaaaaaaaaaaaaaaaaaaaaaaaaaaaaaaaaa
cccccccccccccccccccccccccccccccccccccccccccccccccccccccccccccccccccccccccccccccbbaaaaaaaaaaaaaaaaaaaaaaaaaaaaaaaaaaaaaaaaaaaaaaaaaaaaaaaaaaaaaaaaaaaaa
cccccccccccccccccccccccccccccccccccccccccccccccccccccccccccccccccccccccccccccccbbaaaaaaaaaaaaaaaaaaaaaaaaaaaaaaaaaaaaaaaaaaaaaaaaaaaaaaaaaaaaaaaaaaaaa
cccccccccccccccccccccccccccccccccccccccccccccccccccccccccccccccccccccccccccccccbbaaaaaaaaaaaaaaaaaaaaaaaaaaaaaaaaaaaaaaaaaaaaaaaaaaaaaaaaaaaaaaaaaaaaa
cccccccccccccccccccccccccccccccccccccccccccccccccccccccccccccccccccccccccccccccbbaaaaaaaaaaaaaaaaaaaaaaaaaaaaaaaaaaaaaaaaaaaaaaaaaaaaaaaaaaaaaaaaaaaaa
bbbbbbbbbbbbbbbbbbbbbbbbbbbbbbbbbbcccbbbbbbbbbbbbbbbbbbbbbbbbbbbbbbbbbbbbccccccbbaaaaaaaaaaaaaaaaaaaaaaaaaaaaaaaaaaaaaaaaaaaaaaaaaaaaaaaaaaaaaaaaaaaaa
bbbbbbbbbbbbbbbbbbbbbbbbbbbbbbbbbbcccbbbbbbbbbbbbbbbbbbbbbbbbbbbbbbbbbbbbccccccbbaaaaaaaaaaaaaaaaaaaaaaaaaaaaaaaaaaaaaaaaaaaaaaaaaaaaaaaaaaaaaaaaaaaaa
aaaaaaaaaaaaaaaaaaaaaaaaaaaaaaaabbcccbbaaaaaaaaaaaaaaaaaaaaaaaaaaaaaaaabbccccccbbaaaaaaaaaaaaaaaaaaaaaaaaaaaaaaaaaaaaaaaaaaaaaaaaaaaaaaaaaaaaaaaaaaaaa
aaaaaaaaaaaaaaaaaaaaaaaaaaaaaaaabbcccbbaaaaaaaaaaaaaaaaaaaaaaaaaaaaaaaabbccccccbbaaaaaaaaaaaaaaaaaaaaaaaaaaaaaaaaaaaaaaaaaaaaaaaaaaaaaaaaaaaaaaaaaaaaa
aaaaaaaaaaaaaaaaaaaaaaaaaaaaaaaabbcccbbaaaaaaaaaaaaaaaaaaaaaaaaaaaaaaaabbccccccbbaaaaaaaaaaaaaaaaaaaaaaaaaaaaaaaaaaaaaaaaaaaaaaaaaaaaaaaaaaaaaaaaaaaaa
aaaaaaaaaaaaaaaaaaaaaaaaaaaaaaaabbcccbbaaaaaaaaaaaaaaaaaaaaaaaaaaaaaaaabbccccccbbaaaaaaaaaaaaaaaaaaaaaaaaaaaaaaaaaaaaaaaaaaaaaaaaaaaaaaaaaaaaaaaaaaaaa
aaaaaaaaaaaaaaaaaaaaaaaaaaaaaaaabbcccbbaaaaaaaaaaaaaaaaaaaaaaaaaaaaaaaabbccccccbbaaaaaaaaaaaaaaaaaaaaaaaaaaaaaaaaaaaaaaaaaaaaaaaaaaaaaaaaaaaaaaaaaaaaa
aaaaaaaaaaaaaaaaaaaaaaaaaaaaaaaabbcccbbaaaaaaaaaaaaaaaaaaaaaaaaaaaaaaaabbccccccbbaaaaaaaaaaaaaaaaaaaaaaaaaaaaaaaaaaaaaaaaaaaaaaaaaaaaaaaaaaaaaaaaaaaaa
aaaaaaaaaaaaaaaaaaaaaaaaaaaaaaaabbcccbbaaaaaaaaaaaaaaaaaaaaaaaaaaaaaaaabbccccccbbaaaaaaaaaaaaaaaaaaaaaaaaaaaaaaaaaaaaaaaaaaaaaaaaaaaaaaaaaaaaaaaaaaaaa
aaaaaaaaaaaaaaaaaaaaaaaaaaaaaaaabbcccbbaaaaaaaaaaaaaaaaaaaaaaaaaaaaaaaabbccccccbbaaaaaaaaaaaaaaaaaaaaaaaaaaaaaaaaaaaaaaaaaaaaaaaaaaaaaaaaaaaaaaaaaaaaa
aaaaaaaaaaaaaaaaaaaaaaaaaaaaaaaabbcccbbaaaaaaaaaaaaaaaaaaaaaaaaaaaaaaaabbccccccbbaaaaaaaaaaaaaaaaaaaaaaaaaaaaaaaaaaaaaaaaaaaaaaaaaaaaaaaaaaaaaaaaaaaaa
aaaaaaaaaaaaaaaaaaaaaaaaaaaaaaaabbcccbbaaaaaaaaaaaaaaaaaaaaaaaaaaaaaaaabbccccccbbaaaaaaaaaaaaaaaaaaaaaaaaaaaaaaaaaaaaaaaaaaaaaaaaaaaaaaaaaaaaaaaaaaaaa
aaaaaaaaaaaaaaaaaaaaaaaaaaaaaaaabbcccbbaaaaaaaaaaaaaaaaaaaaaaaaaaaaaaaabbccccccbbaaaaaaaaaaaaaaaaaaaaaaaaaaaaaaaaaaaaaaaaaaaaaaaaaaaaaaaaaaaaaaaaaaaaa
aaaaaaaaaaaaaaaaaaaaaaaaaaaaaaaabbcccbbaaaaaaaaaaaaaaaaaaaaaaaaaaaaaaaabbccccccbbaaaaaaaaaaaaaaaaaaaaaaaaaaaaaaaaaaaaaaaaaaaaaaaaaaaaaaaaaaaaaaaaaaaaa
aaaaaaaaaaaaaaaaaaaaaaaaaaaaaaaabbcccbbaaaaaaaaaaaaaaaaaaaaaaaaaaaaaaaabbccccccbbaaaaaaaaaaaaaaaaaaaaaaaaaaaaaaaaaaaaaaaaaaaaaaaaaaaaaaaaaaaaaaaaaaaaa
aaaaaaaaaaaaaaaaaaaaaaaaaaaaaaaabbcccbbaaaaaaaaaaaaaaaaaaaaaaaaaaaaaaaabbccccccbbaaaaaaaaaaaaaaaaaaaaaaaaaaaaaaaaaaaaaaaaaaaaaaaaaaaaaaaaaaaaaaaaaaaaa
aaaaaaaaaaaaaaaaaaaaaaaaaaaaaaaabbcccbbaaaaaaaaaaaaaaaaaaaaaaaaaaaaaaaabbccccccbbaaaaaaaaaaaaaaaaaaaaaaaaaaaaaaaaaaaaaaaaaaaaaaaaaaaaaaaaaaaaaaaaaaaaa
aaaaaaaaaaaaaaaaaaaaaaaaaaaaaaaabbcccbbaaaaaaaaaaaaaaaaaaaaaaaaaaaaaaaabbccccccbbaaaaaaaaaaaaaaaaaaaaaaaaaaaaaaaaaaaaaaaaaaaaaaaaaaaaaaaaaaaaaaaaaaaaa
aaaaaaaaaaaaaaaaaaaaaaaaaaaaaaaabbcccbbaaaaaaaaaaaaaaaaaaaaaaaaaaaaaaaabbccccccbbaaaaaaaaaaaaaaaaaaaaaaaaaaaaaaaaaaaaaaaaaaaaaaaaaaaaaaaaaaaaaaaaaaaaa
aaaaaaaaaaaaaaaaaaaaaaaaaaaaaaaabbcccbbaaaaaaaaaaaaaaaaaaaaaaaaaaaaaaaabbccccccbbaaaaaaaaaaaaaaaaaaaaaaaaaaaaaaaaaaaaaaaaaaaaaaaaaaaaaaaaaaaaaaaaaaaaa
aaaaaaaaaaaaaaaaaaaaaaaaaaaaaaaabbcccbbaaaaaaaaaaaaaaaaaaaaaaaaaaaaaaaabbccccccbbaaaaaaaaaaaaaaaaaaaaaaaaaaaaaaaaaaaaaaaaaaaaaaaaaaaaaaaaaaaaaaaaaaaaa
aaaaaaaaaaaaaaaaaaaaaaaaaaaaaaaabbcccbbaaaaaaaaaaaaaaaaaaaaaaaaaaaaaaaabbccccccbbaaaaaaaaaaaaaaaaaaaaaaaaaaaaaaaaaaaaaaaaaaaaaaaaaaaaaaaaaaaaaaaaaaaaa
aaaaaaaaaaaaaaaaaaaaaaaaaaaaaaaabbcccbbaaaaaaaaaaaaaaaaaaaaaaaaaaaaaaaabbccccccbbaaaaaaaaaaaaaaaaaaaaaaaaaaaaaaaaaaaaaaaaaaaaaaaaaaaaaaaaaaaaaaaaaaaaa
aaaaaaaaaaaaaaaaaaaaaaaaaaaaaaaabbcccbbaaaaaaaaaaaaaaaaaaaaaaaaaaaaaaaabbccccccbbaaaaaaaaaaaaaaaaaaaaaaaaaaaaaaaaaaaaaaaaaaaaaaaaaaaaaaaaaaaaaaaaaaaaa
aaaaaaaaaaaaaaaaaaaaaaaaaaaaaaaabbcccbbaaaaaaaaaaaaaaaaaaaaaaaaaaaaaaaabbccccccbbaaaaaaaaaaaaaaaaaaaaaaaaaaaaaaaaaaaaaaaaaaaaaaaaaaaaaaaaaaaaaaaaaaaaa
aaaaaaaaaaaaaaaaaaaaaaaaaaaaaaaabbcccbbaaaaaaaaaaaaaaaaaaaaaaaaaaaaaaaabbccccccbbaaaaaaaaaaaaaaaaaaaaaaaaaaaaaaaaaaaaaaaaaaaaaaaaaaaaaaaaaaaaaaaaaaaaa
aaaaaaaaaaaaaaaaaaaaaaaaaaaaaaaabbcccbbaaaaaaaaaaaaaaaaaaaaaaaaaaaaaaaabbccccccbbaaaaaaaaaaaaaaaaaaaaaaaaaaaaaaaaaaaaaaaaaaaaaaaaaaaaaaaaaaaaaaaaaaaaa
aaaaaaaaaaaaaaaaaaaaaaaaaaaaaaaabbcccbbaaaaaaaaaaaaaaaaaaaaaaaaaaaaaaaabbccccccbbbbbbbbbbbbbbbbbbbbbbbbbbbbbbbbbbbbbbbbbbbbbbbbbbbbbbbbbbbbbbbbbbbbbbb
aaaaaaaaaaaaaaaaaaaaaaaaaaaaaaaabbcccbbaaaaaaaaaaaaaaaaaaaaaaaaaaaaaaaabbccccccbbbbbbbbbbbbbbbbbbbbbbbbbbbbbbbbbbbbbbbbbbbbbbbbbbbbbbbbbbbbbbbbbbbbbbb
aaaaaaaaaaaaaaaaaaaaaaaaaaaaaaaabbcccbbaaaaaaaaaaaaaaaaaaaaaaaaaaaaaaaabbccccccccccccccccccccccccccccccccccccccccccccccccccccccccccccccccccccccccccccc
aaaaaaaaaaaaaaaaaaaaaaaaaaaaaaaabbcccbbaaaaaaaaaaaaaaaaaaaaaaaaaaaaaaaabbccccccccccccccccccccccccccccccccccccccccccccccccccccccccccccccccccccccccccccc
aaaaaaaaaaaaaaaaaaaaaaaaaaaaaaaabbcccbbaaaaaaaaaaaaaaaaaaaaaaaaaaaaaaaabbccccccccccccccccccccccccccccccccccccccccccccccccccccccccccccccccccccccccccccc
aaaaaaaaaaaaaaaaaaaaaaaaaaaaaaaabbcccbbaaaaaaaaaaaaaaaaaaaaaaaaaaaaaaaabbccccccccccccccccccccccccccccccccccccccccccccccccccccccccccccccccccccccccccccc
aaaaaaaaaaaaaaaaaaaaaaaaaaaaaaaabbcccbbaaaaaaaaaaaaaaaaaaaaaaaaaaaaaaaabbccccccccccccccccccccccccccccccccccccccccccccccccccccccccccccccccccccccccccccc
aaaaaaaaaaaaaaaaaaaaaaaaaaaaaaaabbcccbbaaaaaaaaaaaaaaaaaaaaaaaaaaaaaaaabbccccccccccccccccccccccccccccccccccccccccccccccccccccccccccccccccccccccccccccc
aaaaaaaaaaaaaaaaaaaaaaaaaaaaaaaabbcccbbaaaaaaaaaaaaaaaaaaaaaaaaaaaaaaaabbccccccccccccccccccccccccccccccccccccccccccccccccccccccccccccccccccccccccccccc
aaaaaaaaaaaaaaaaaaaaaaaaaaaaaaaabbcccbbaaaaaaaaaaaaaaaaaaaaaaaaaaaaaaaabbccccccbbbbbbbbbbbbbbbbbbbbbbbbbbbbbbbbbbbbbbbbbbbcccbbbbbbbbbbbbbbbbbbbbbbbbb
aaaaaaaaaaaaaaaaaaaaaaaaaaaaaaaabbcccbbaaaaaaaaaaaaaaaaaaaaaaaaaaaaaaaabbccccccbbbbbbbbbbbbbbbbbbbbbbbbbbbbbbbbbbbbbbbbbbbcccbbbbbbbbbbbbbbbbbbbbbbbbb
aaaaaaaaaaaaaaaaaaaaaaaaaaaaaaaabbcccbbaaaaaaaaaaaaaaaaaaaaaaaaaaaaaaaabbccccccbbaaaaaaaaaaaaaaaaaaaaaaaaaaaaaaaaaaaaaaabbcccbbaaaaaaaaaaaaaaaaaaaaaaa
aaaaaaaaaaaaaaaaaaaaaaaaaaaaaaaabbcccbbaaaaaaaaaaaaaaaaaaaaaaaaaaaaaaaabbccccccbbaaaaaaaaaaaaaaaaaaaaaaaaaaaaaaaaaaaaaaabbcccbbaaaaaaaaaaaaaaaaaaaaaaa
aaaaaaaaaaaaaaaaaaaaaaaaaaaaaaaabbcccbbaaaaaaaaaaaaaaaaaaaaaaaaaaaaaaaabbccccccbbaaaaaaaaaaaaaaaaaaaaaaaaaaaaaaaaaaaaaaabbcccbbaaaaaaaaaaaaaaaaaaaaaaa
aaaaaaaaaaaaaaaaaaaaaaaaaaaaaaaabbcccbbaaaaaaaaaaaaaaaaaaaaaaaaaaaaaaaabbccccccbbaaaaaaaaaaaaaaaaaaaaaaaaaaaaaaaaaaaaaaabbcccbbaaaaaaaaaaaaaaaaaaaaaaa
aaaaaaaaaaaaaaaaaaaaaaaaaaaaaaaabbcccbbaaaaaaaaaaaaaaaaaaaaaaaaaaaaaaaabbccccccbbaaaaaaaaaaaaaaaaaaaaaaaaaaaaaaaaaaaaaaabbcccbbaaaaaaaaaaaaaaaaaaaaaaa
aaaaaaaaaaaaaaaaaaaaaaaaaaaaaaaabbcccbbaaaaaaaaaaaaaaaaaaaaaaaaaaaaaaaabbccccccbbaaaaaaaaaaaaaaaaaaaaaaaaaaaaaaaaaaaaaaabbcccbbaaaaaaaaaaaaaaaaaaaaaaa
aaaaaaaaaaaaaaaaaaaaaaaaaaaaaaaabbcccbbaaaaaaaaaaaaaaaaaaaaaaaaaaaaaaaabbccccccbbaaaaaaaaaaaaaaaaaaaaaaaaaaaaaaaaaaaaaaabbcccbbaaaaaaaaaaaaaaaaaaaaaaa
aaaaaaaaaaaaaaaaaaaaaaaaaaaaaaaabbcccbbaaaaaaaaaaaaaaaaaaaaaaaaaaaaaaaabbccccccbbaaaaaaaaaaaaaaaaaaaaaaaaaaaaaaaaaaaaaaabbcccbbaaaaaaaaaaaaaaaaaaaaaaa
aaaaaaaaaaaaaaaaaaaaaaaaaaaaaaaabbcccbbaaaaaaaaaaaaaaaaaaaaaaaaaaaaaaaabbccccccbbaaaaaaaaaaaaaaaaaaaaaaaaaaaaaaaaaaaaaaabbcccbbaaaaaaaaaaaaaaaaaaaaaaa
aaaaaaaaaaaaaaaaaaaaaaaaaaaaaaaabbcccbbaaaaaaaaaaaaaaaaaaaaaaaaaaaaaaaabbccccccbbaaaaaaaaaaaaaaaaaaaaaaaaaaaaaaaaaaaaaaabbcccbbaaaaaaaaaaaaaaaaaaaaaaa
aaaaaaaaaaaaaaaaaaaaaaaaaaaaaaaabbcccbbaaaaaaaaaaaaaaaaaaaaaaaaaaaaaaaabbccccccbbaaaaaaaaaaaaaaaaaaaaaaaaaaaaaaaaaaaaaaabbcccbbaaaaaaaaaaaaaaaaaaaaaaa
aaaaaaaaaaaaaaaaaaaaaaaaaaaaaaaabbcccbbaaaaaaaaaaaaaaaaaaaaaaaaaaaaaaaabbccccccbbaaaaaaaaaaaaaaaaaaaaaaaaaaaaaaaaaaaaaaabbcccbbaaaaaaaaaaaaaaaaaaaaaaa
aaaaaaaaaaaaaaaaaaaaaaaaaaaaaaaabbcccbbaaaaaaaaaaaaaaaaaaaaaaaaaaaaaaaabbccccccbbaaaaaaaaaaaaaaaaaaaaaaaaaaaaaaaaaaaaaaabbcccbbaaaaaaaaaaaaaaaaaaaaaaa
aaaaaaaaaaaaaaaaaaaaaaaaaaaaaaaabbcccbbaaaaaaaaaaaaaaaaaaaaaaaaaaaaaaaabbccccccbbaaaaaaaaaaaaaaaaaaaaaaaaaaaaaaaaaaaaaaabbcccbbaaaaaaaaaaaaaaaaaaaaaaa
aaaaaaaaaaaaaaaaaaaaaaaaaaaaaaaabbcccbbaaaaaaaaaaaaaaaaaaaaaaaaaaaaaaaabbccccccbbaaaaaaaaaaaaaaaaaaaaaaaaaaaaaaaaaaaaaaabbcccbbaaaaaaaaaaaaaaaaaaaaaaa
aaaaaaaaaaaaaaaaaaaaaaaaaaaaaaaabbcccbbaaaaaaaaaaaaaaaaaaaaaaaaaaaaaaaabbccccccbbaaaaaaaaaaaaaaaaaaaaaaaaaaaaaaaaaaaaaaabbcccbbaaaaaaaaaaaaaaaaaaaaaaa
aaaaaaaaaaaaaaaaaaaaaaaaaaaaaaaabbcccbbaaaaaaaaaaaaaaaaaaaaaaaaaaaaaaaabbccccccbbaaaaaaaaaaaaaaaaaaaaaaaaaaaaaaaaaaaaaaabbcccbbaaaaaaaaaaaaaaaaaaaaaaa
aaaaaaaaaaaaaaaaaaaaaaaaaaaaaaaabbcccbbaaaaaaaaaaaaaaaaaaaaaaaaaaaaaaaabbccccccbbaaaaaaaaaaaaaaaaaaaaaaaaaaaaaaaaaaaaaaabbcccbbaaaaaaaaaaaaaaaaaaaaaaa
aaaaaaaaaaaaaaaaaaaaaaaaaaaaaaaabbcccbbaaaaaaaaaaaaaaaaaaaaaaaaaaaaaaaabbccccccbbaaaaaaaaaaaaaaaaaaaaaaaaaaaaaaaaaaaaaaabbcccbbaaaaaaaaaaaaaaaaaaaaaaa
aaaaaaaaaaaaaaaaaaaaaaaaaaaaaaaabbcccbbaaaaaaaaaaaaaaaaaaaaaaaaaaaaaaaabbccccccbbaaaaaaaaaaaaaaaaaaaaaaaaaaaaaaaaaaaaaaabbcccbbaaaaaaaaaaaaaaaaaaaaaaa
aaaaaaaaaaaaaaaaaaaaaaaaaaaaaaaabbcccbbaaaaaaaaaaaaaaaaaaaaaaaaaaaaaaaabbccccccbbaaaaaaaaaaaaaaaaaaaaaaaaaaaaaaaaaaaaaaabbcccbbaaaaaaaaaaaaaaaaaaaaaaa
aaaaaaaaaaaaaaaaaaaaaaaaaaaaaaaabbcccbbaaaaaaaaaaaaaaaaaaaaaaaaaaaaaaaabbccccccbbaaaaaaaaaaaaaaaaaaaaaaaaaaaaaaaaaaaaaaabbcccbbaaaaaaaaaaaaaaaaaaaaaaa
aaaaaaaaaaaaaaaaaaaaaaaaaaaaaaaabbcccbbaaaaaaaaaaaaaaaaaaaaaaaaaaaaaaaabbccccccbbaaaaaaaaaaaaaaaaaaaaaaaaaaaaaaaaaaaaaaabbcccbbaaaaaaaaaaaaaaaaaaaaaaa
aaaaaaaaaaaaaaaaaaaaaaaaaaaaaaaabbcccbbaaaaaaaaaaaaaaaaaaaaaaaaaaaaaaaabbccccccbbaaaaaaaaaaaaaaaaaaaaaaaaaaaaaaaaaaaaaaabbcccbbaaaaaaaaaaaaaaaaaaaaaaa
aaaaaaaaaaaaaaaaaaaaaaaaaaaaaaaabbcccbbaaaaaaaaaaaaaaaaaaaaaaaaaaaaaaaabbccccccbbaaaaaaaaaaaaaaaaaaaaaaaaaaaaaaaaaaaaaaabbcccbbaaaaaaaaaaaaaaaaaaaaaaa
aaaaaaaaaaaaaaaaaaaaaaaaaaaaaaaabbcccbbaaaaaaaaaaaaaaaaaaaaaaaaaaaaaaaabbccccccbbaaaaaaaaaaaaaaaaaaaaaaaaaaaaaaaaaaaaaaabbcccbbaaaaaaaaaaaaaaaaaaaaaaa
aaaaaaaaaaaaaaaaaaaaaaaaaaaaaaaabbcccbbaaaaaaaaaaaaaaaaaaaaaaaaaaaaaaaabbccccccbbaaaaaaaaaaaaaaaaaaaaaaaaaaaaaaaaaaaaaaabbcccbbaaaaaaaaaaaaaaaaaaaaaaa
aaaaaaaaaaaaaaaaaaaaaaaaaaaaaaaabbcccbbaaaaaaaaaaaaaaaaaaaaaaaaaaaaaaaabbccccccbbaaaaaaaaaaaaaaaaaaaaaaaaaaaaaaaaaaaaaaabbcccbbaaaaaaaaaaaaaaaaaaaaaaa
aaaaaaaaaaaaaaaaaaaaaaaaaaaaaaaabbcccbbaaaaaaaaaaaaaaaaaaaaaaaaaaaaaaaabbccccccbbaaaaaaaaaaaaaaaaaaaaaaaaaaaaaaaaaaaaaaabbcccbbaaaaaaaaaaaaaaaaaaaaaaa
aaaaaaaaaaaaaaaaaaaaaaaaaaaaaaaabbcccbbaaaaaaaaaaaaaaaaaaaaaaaaaaaaaaaabbccccccbbaaaaaaaaaaaaaaaaaaaaaaaaaaaaaaaaaaaaaaabbcccbbaaaaaaaaaaaaaaaaaaaaaaa
aaaaaaaaaaaaaaaaaaaaaaaaaaaaaaaabbcccbbaaaaaaaaaaaaaaaaaaaaaaaaaaaaaaaabbccccccbbaaaaaaaaaaaaaaaaaaaaaaaaaaaaaaaaaaaaaaabbcccbbaaaaaaaaaaaaaaaaaaaaaaa
bbbbbbbbbbbbbbbbbbbbbbbbbbbbbbbbbbcccbbbbbbbbbbbbbbbbbbbbbbbbbbbbbbbbbbbbccccccbbaaaaaaaaaaaaaaaaaaaaaaaaaaaaaaaaaaaaaaabbcccbbaaaaaaaaaaaaaaaaaaaaaaa
bbbbbbbbbbbbbbbbbbbbbbbbbbbbbbbbbbcccbbbbbbbbbbbbbbbbbbbbbbbbbbbbbbbbbbbbccccccbbaaaaaaaaaaaaaaaaaaaaaaaaaaaaaaaaaaaaaaabbcccbbaaaaaaaaaaaaaaaaaaaaaaa
cccccccccccccccccccccccccccccccccccccccccccccccccccccccccccccccccccccccccccccccbbaaaaaaaaaaaaaaaaaaaaaaaaaaaaaaaaaaaaaaabbcccbbaaaaaaaaaaaaaaaaaaaaaaa
cccccccccccccccccccccccccccccccccccccccccccccccccccccccccccccccccccccccccccccccbbaaaaaaaaaaaaaaaaaaaaaaaaaaaaaaaaaaaaaaabbcccbbaaaaaaaaaaaaaaaaaaaaaaa
cccccccccccccccccccccccccccccccccccccccccccccccccccccccccccccccccccccccccccccccbbaaaaaaaaaaaaaaaaaaaaaaaaaaaaaaaaaaaaaaabbcccbbaaaaaaaaaaaaaaaaaaaaaaa
cccccccccccccccccccccccccccccccccccccccccccccccccccccccccccccccccccccccccccccccbbaaaaaaaaaaaaaaaaaaaaaaaaaaaaaaaaaaaaaaabbcccbbaaaaaaaaaaaaaaaaaaaaaaa
cccccccccccccccccccccccccccccccccccccccccccccccccccccccccccccccccccccccccccccccbbaaaaaaaaaaaaaaaaaaaaaaaaaaaaaaaaaaaaaaabbcccbbaaaaaaaaaaaaaaaaaaaaaaa
cccccccccccccccccccccccccccccccccccccccccccccccccccccccccccccccccccccccccccccccbbaaaaaaaaaaaaaaaaaaaaaaaaaaaaaaaaaaaaaaabbcccbbaaaaaaaaaaaaaaaaaaaaaaa
bbbbbbbbbbbbbbbbbbbbbbbbbbbbbbbbbbbbbbbbbbbbbbbbbbbbbbbbbbbbbbbbbbbbbbbbbccccccbbaaaaaaaaaaaaaaaaaaaaaaaaaaaaaaaaaaaaaaabbcccbbaaaaaaaaaaaaaaaaaaaaaaa
bbbbbbbbbbbbbbbbbbbbbbbbbbbbbbbbbbbbbbbbbbbbbbbbbbbbbbbbbbbbbbbbbbbbbbbbbccccccbbaaaaaaaaaaaaaaaaaaaaaaaaaaaaaaaaaaaaaaabbcccbbaaaaaaaaaaaaaaaaaaaaaaa
aaaaaaaaaaaaaaaaaaaaaaaaaaaaaaaaaaaaaaaaaaaaaaaaaaaaaaaaaaaaaaaaaaaaaaabbccccccbbaaaaaaaaaaaaaaaaaaaaaaaaaaaaaaaaaaaaaaabbcccbbaaaaaaaaaaaaaaaaaaaaaaa
aaaaaaaaaaaaaaaaaaaaaaaaaaaaaaaaaaaaaaaaaaaaaaaaaaaaaaaaaaaaaaaaaaaaaaabbccccccbbaaaaaaaaaaaaaaaaaaaaaaaaaaaaaaaaaaaaaaabbcccbbaaaaaaaaaaaaaaaaaaaaaaa
aaaaaaaaaaaaaaaaaaaaaaaaaaaaaaaaaaaaaaaaaaaaaaaaaaaaaaaaaaaaaaaaaaaaaaabbccccccbbaaaaaaaaaaaaaaaaaaaaaaaaaaaaaaaaaaaaaaabbcccbbaaaaaaaaaaaaaaaaaaaaaaa
aaaaaaaaaaaaaaaaaaaaaaaaaaaaaaaaaaaaaaaaaaaaaaaaaaaaaaaaaaaaaaaaaaaaaaabbccccccbbaaaaaaaaaaaaaaaaaaaaaaaaaaaaaaaaaaaaaaabbcccbbaaaaaaaaaaaaaaaaaaaaaaa
aaaaaaaaaaaaaaaaaaaaaaaaaaaaaaaaaaaaaaaaaaaaaaaaaaaaaaaaaaaaaaaaaaaaaaabbccccccbbaaaaaaaaaaaaaaaaaaaaaaaaaaaaaaaaaaaaaaabbcccbbaaaaaaaaaaaaaaaaaaaaaaa
aaaaaaaaaaaaaaaaaaaaaaaaaaaaaaaaaaaaaaaaaaaaaaaaaaaaaaaaaaaaaaaaaaaaaaabbccccccbbaaaaaaaaaaaaaaaaaaaaaaaaaaaaaaaaaaaaaaabbcccbbbaaaaaabaaaaaaaaaaaaaaa
aaaaaaaaaaaaaaaaaaaaaaaaaaaaaaaaaaaaaaaaaaaaaaaaaaaaaaaaaaaaaaaaaaaaaaabbccccccbbaaaaaaaaaaaaaaaaaaaaaaaaaaaaaaaaaaaaaaabbcccbbbaaabadddeddddddeddddaa
aaaaaaaaaaaaaaaaaaaaaaaaaaaaaaaaaaaaaaaaaaaaaaaaaaaaaaaaaaaaaaaaaaaaaaabbccccccbbaaaaaaaaaaaaaaaaaaaaaaaaaaaaaaaaaaaaaaabbcccbbbaaabbdffffaaaaffaffdab
aaaaaaaaaaaaaaaaaaaaaaaaaaaaaaaaaaaaaaaaaaaaaaaaaaaaaaaaaaaaaaaaaaaaaaabbccccccbbaaaaaaaaaaaaaaaaaaaaaaaaaaaaaaaaaaaaaaabbcccbbbaaaabdfaffffaaffaffdaa
aaaaaaaaaaaaaaaaaaaaaaaaaaaaaaaaaaaaaaaaaaaaaaaaaaaaaaaaaaaaaaaaaaaaaaabbccccccbbaaaaaaaaaaaaaaaaaaaaaaaaaaaaaaaaaaaaaaabbcccbbbabaaaeffffffaaaaafadba
aaaaaaaaaaaaaaaaaaaaaaaaaaaaaaaaaaaaaaaaaaaaaaaaaaaaaaaaaaaaaaaaaaaaaaabbccccccbbaaaaaaaaaaaaaaaaaaaaaaaaaaaaaaaaaaaaaaabbcccbbaaaaaaaaffaaaffffffadaa
aaaaaaaaaaaaaaaaaaaaaaaaaaaaaaaaaaaaaaaaaaaaaaaaaaaaaaaaaaaaaaaaaaaaaaabbccccccbbaaaaaaaaaaaaaaaaaaaaaaaaaaaaaaaaaaaaaaabbcccbbbaaabaaaafaaffffffffeab
aaaaaaaaaaaaaaaaaaaaaaaaaaaaaaaaaaaaaaaaaaaaaaaaaaaaaaaaaaaaaaaaaaaaaaabbccccccbbaaaaaaaaaaaaaaaaaaaaaaaaaaaaaaaaaaaaaaabbcccbbabaaaadfffffffffffffeba
aaaaaaaaaaaaaaaaaaaaaaaaaaaaaaaaaaaaaaaaaaaaaaaaaaaaaaaaaaaaaaaaaaaaaaabbccccccbbaaaaaaaaaaaaaaaaaaaaaaaaaaaaaaaaaaaaaaabbcccbbabaaaadfffffffffffffdaa
aaaaaaaaaaaaaaaaaaaaaaaaaaaaaaaaaaaaaaaaaaaaaaaaaaaaaaaaaaaaaaaaaaaaaaabbccccccbbaaaaaaaaaaaaaaaaaaaaaaaaaaaaaaaaaaaaaaabbcccbbbaabaadfffffffffffffdab
aaaaaaaaaaaaaaaaaaaaaaaaaaaaaaaaaaaaaaaaaaaaaaaaaaaaaaaaaaaaaaaaaaaaaaabbccccccbbaaaaaaaaaaaaaaaaaaaaaaaaaaaaaaaaaaaaaaabbcccbbabaaaaffffffffffffffabb
aaaaaaaaaaaaaaaaaaaaaaaaaaaaaaaaaaaaaaaaaaaaaaaaaaaaaaaaaaaaaaaaaaaaaaabbccccccbbaaaaaaaaaaaaaaaaaaaaaaaaaaaaaaaaaaaaaaabbcccbbaabaaagfffffffffffffaba
aaaaaaaaaaaaaaaaaaaaaaaaaaaaaaaaaaaaaaaaaaaaaaaaaaaaaaaaaaaaaaaaaaaaaaabbccccccbbaaaaaaaaaaaaaaaaaaaaaaaaaaaaaaaaaaaaaaabbcccbbbbaaaaaaffffffffffffeab
aaaaaaaaaaaaaaaaaaaaaaaaaaaaaaaaaaaaaaaaaaaaaaaaaaaaaaaaaaaaaaaaaaaaaaabbccccccbbaaaaaaaaaaaaaaaaaaaaaaaaaaaaaaaaaaaaaaabbcccbbbababaeafffffaaffaaaaaa
aaaaaaaaaaaaaaaaaaaaaaaaaaaaaaaaaaaaaaaaaaaaaaaaaaaaaaaaaaaaaaaaaaaaaaabbccccccbbaaaaaaaaaaaaaaaaaaaaaaaaaaaaaaaaaaaaaaabbcccbbbbaaaaeaefdddaedeeaeaab
aaaaaaaaaaaaaaaaaaaaaaaaaaaaaaaaaaaaaaaaaaaaaaaaaaaaaaaaaaaaaaaaaaaaaaabbccccccbbbbbbbbbbbbbbbbbbbbbbbbbbbbbbbbbbbbbbbbbbbcccbbbbbbbbbbbbbbbbbbbbbbbbb
aaaaaaaaaaaaaaaaaaaaaaaaaaaaaaaaaaaaaaaaaaaaaaaaaaaaaaaaaaaaaaaaaaaaaaabbccccccbbbbbbbbbbbbbbbbbbbbbbbbbbbbbbbbbbbbbbbbbbbcccbbbbbbbbbbbbbbbbbbbbbbbbb
aaaaaaaaaaaaaaaaaaaaaaaaaaaaaaaaaaaaaaaaaaaaaaaaaaaaaaaaaaaaaaaaaaaaaaabbccccccccccccccccccccccccccccccccccccccccccccccccccccccccccccccccccccccccccccc
aaaaaaaaaaaaaaaaaaaaaaaaaaaaaaaaaaaaaaaaaaaaaaaaaaaaaaaaaaaaaaaaaaaaaaabbccccccccccccccccccccccccccccccccccccccccccccccccccccccccccccccccccccccccccccc
aaaaaaaaaaaaaaaaaaaaaaaaaaaaaaaaaaaaaaaaaaaaaaaaaaaaaaaaaaaaaaaaaaaaaaabbccccccccccccccccccccccccccccccccccccccccccccccccccccccccccccccccccccccccccccc
aaaaaaaaaaaaaaaaaaaaaaaaaaaaaaaaaaaaaaaaaaaaaaaaaaaaaaaaaaaaaaaaaaaaaaabbccccccccccccccccccccccccccccccccccccccccccccccccccccccccccccccccccccccccccccc
aaaaaaaaaaaaaaaaaaaaaaaaaaaaaaaaaaaaaaaaaaaaaaaaaaaaaaaaaaaaaaaaaaaaaaabbccccccccccccccccccccccccccccccccccccccccccccccccccccccccccccccccccccccccccccc
aaaaaaaaaaaaaaaaaaaaaaaaaaaaaaaaaaaaaaaaaaaaaaaaaaaaaaaaaaaaaaaaaaaaaaabbccccccccccccccccccccccccccccccccccccccccccccccccccccccccccccccccccccccccccccc
aaaaaaaaaaaaaaaaaaaaaaaaaaaaaaaaaaaaaaaaaaaaaaaaaaaaaaaaaaaaaaaaaaaaaaabbccccccbbbbbbbbbbbbbbbbbbbbbbbbbbbbbbbbbbbbbbbbbbbbbbbbbbbbbbbbbbbbbbbbbbbbbbb
aaaaaaaaaaaaaaaaaaaaaaaaaaaaaaaaaaaaaaaaaaaaaaaaaaaaaaaaaaaaaaaaaaaaaaabbccccccbbbbbbbbbbbbbbbbbbbbbbbbbbbbbbbbbbbbbbbbbbbbbbbbbbbbbbbbbbbbbbbbbbbbbbb
aaaaaaaaaaaaaaaaaaaaaaaaaaaaaaaaaaaaaaaaaaaaaaaaaaaaaaaaaaaaaaaaaaaaaaabbccccccbbaaaaaaaaaaaaaaaaaaaaaaaaaaaaaaaaaaaaaaaaaaaaaaaaaaaaaaaaaaaaaaaaaaaaa
aaaaaaaaaaaaaaaaaaaaaaaaaaaaaaaaaaaaaaaaaaaaaaaaaaaaaaaaaaaaaaaaaaaaaaabbccccccbbaaaaaaaaaaaaaaaaaaaaaaaaaaaaaaaaaaaaaaaaaaaaaaaaaaaaaaaaaaaaaaaaaaaaa
aaaaaaaaaaaaaaaaaaaaaaaaaaaaaaaaaaaaaaaaaaaaaaaaaaaaaaaaaaaaaaaaaaaaaaabbccccccbbaaaaaaaaaaaaaaaaaaaaaaaaaaaaaaaaaaaaaaaaaaaaaaaaaaaaaaaaaaaaaaaaaaaaa
"}
