"aa" = (/turf/floor/beach/water/deep/saltwater,/area/caribbean/sea/bottom)
"ab" = (/obj/structure/barricade/ship/north/corners,/turf/floor/beach/water/deep/saltwater,/area/caribbean/sea/bottom/roofed)
"ac" = (/obj/structure/barricade/ship,/turf/floor/beach/water/deep/saltwater,/area/caribbean/sea/bottom/roofed)
"ad" = (/obj/structure/barricade/ship/aport1/north,/turf/floor/beach/water/deep/saltwater,/area/caribbean/sea/bottom/roofed)
"ae" = (/obj/structure/barricade/ship/north/corners{icon_state = "boat1_up_corners"; dir = 2},/turf/floor/beach/water/deep/saltwater,/area/caribbean/sea/bottom/roofed)
"af" = (/obj/structure/barricade/ship/north/corners{icon_state = "boat1_up_corners"; dir = 9},/obj/item/flashlight/lantern/on/anchored,/turf/floor/beach/water/deep/saltwater,/area/caribbean/sea/bottom/roofed)
"ag" = (/obj/covers/repairedfloor/ship,/obj/structure/closet/crate/chest,/obj/item/stack/money/doubloon/ten,/obj/item/stack/money/doubloon/ten,/turf/floor/beach/water/deep/saltwater,/area/caribbean/sea/bottom/roofed)
"ah" = (/obj/structure/barricade/ship/wall2{icon_state = "boat2"; dir = 2},/obj/item/flashlight/lantern/on/anchored,/turf/floor/beach/water/deep/saltwater,/area/caribbean/sea/bottom/roofed)
"ai" = (/obj/covers/repairedfloor/ship,/obj/structure/vending/craftable/rifles/wood/filled_musket_spanish,/turf/floor/beach/water/deep/saltwater,/area/caribbean/sea/bottom/roofed)
"aj" = (/obj/covers/repairedfloor/ship,/turf/floor/beach/water/deep/saltwater,/area/caribbean/sea/bottom/roofed)
"ak" = (/obj/covers/repairedfloor/ship,/mob/living/simple_animal/hostile/human/voyage/spanish/ranged,/turf/floor/beach/water/deep/saltwater,/area/caribbean/sea/bottom/roofed)
"al" = (/obj/covers/repairedfloor/ship,/obj/structure/cannon/modern/tank/voyage/autofire{icon_state = "cannon"; dir = 1},/turf/floor/beach/water/deep/saltwater,/area/caribbean/sea/bottom/roofed)
"am" = (/obj/covers/repairedfloor/ship,/obj/structure/voyage/ropeladder/thin{icon_state = "ropeladder_thin"; dir = 1},/turf/floor/beach/water/deep/saltwater,/area/caribbean/sea/bottom/roofed)
"an" = (/obj/covers/repairedfloor/ship,/obj/structure/voyage/ropeladder{icon_state = "ropeladder"; dir = 1},/obj/structure/cannon/modern/tank/voyage/autofire{icon_state = "cannon"; dir = 1},/turf/floor/beach/water/deep/saltwater,/area/caribbean/sea/bottom/roofed)
"ao" = (/obj/structure/barricade/ship/north/corners{icon_state = "boat1_up_corners"; dir = 5},/turf/floor/beach/water/deep/saltwater,/area/caribbean/sea/bottom/roofed)
"ap" = (/obj/structure/barricade/ship/wall2{icon_state = "boat2"; dir = 2},/turf/floor/beach/water/deep/saltwater,/area/caribbean/sea/bottom/roofed)
"aq" = (/obj/covers/repairedfloor/ship,/obj/structure/table/wood,/turf/floor/beach/water/deep/saltwater,/area/caribbean/sea/bottom/roofed)
"ar" = (/obj/covers/repairedfloor/ship,/mob/living/simple_animal/hostile/human/voyage/spanish,/turf/floor/beach/water/deep/saltwater,/area/caribbean/sea/bottom/roofed)
"as" = (/obj/covers/repairedfloor/ship,/obj/structure/table/wood,/obj/item/stack/medical/advanced/bruise_pack,/obj/item/stack/medical/advanced/bruise_pack,/obj/item/stack/medical/advanced/bruise_pack,/turf/floor/beach/water/deep/saltwater,/area/caribbean/sea/bottom/roofed)
"at" = (/obj/covers/repairedfloor/ship,/obj/structure/table/wood,/obj/item/stack/medical/advanced/ointment,/obj/item/stack/medical/advanced/ointment,/obj/item/stack/medical/advanced/ointment,/turf/floor/beach/water/deep/saltwater,/area/caribbean/sea/bottom/roofed)
"au" = (/obj/structure/barricade/ship{icon_state = "boat1"; dir = 8},/turf/floor/beach/water/deep/saltwater,/area/caribbean/sea/bottom/roofed)
"av" = (/obj/structure/multiz/ladder/ww2/up,/obj/covers/repairedfloor/ship,/turf/floor/beach/water/deep/saltwater,/area/caribbean/sea/bottom/roofed)
"aw" = (/obj/covers/repairedfloor/ship,/obj/structure/bed/hammock,/turf/floor/beach/water/deep/saltwater,/area/caribbean/sea/bottom/roofed)
"ax" = (/obj/covers/repairedfloor/ship,/obj/structure/bed/wood,/turf/floor/beach/water/deep/saltwater,/area/caribbean/sea/bottom/roofed)
"ay" = (/obj/covers/repairedfloor/ship,/obj/structure/table/wood/flipped{dir = 4},/mob/living/simple_animal/hostile/human/voyage/spanish/ranged,/turf/floor/beach/water/deep/saltwater,/area/caribbean/sea/bottom/roofed)
"az" = (/obj/covers/repairedfloor/ship,/obj/item/flashlight/lantern/on/anchored,/turf/floor/beach/water/deep/saltwater,/area/caribbean/sea/bottom/roofed)
"aA" = (/obj/covers/repairedfloor/ship,/obj/structure/table/wood,/obj/item/stack/medical/advanced/bruise_pack,/obj/item/stack/medical/advanced/bruise_pack,/obj/item/stack/medical/advanced/bruise_pack,/obj/item/stack/medical/advanced/bruise_pack,/turf/floor/beach/water/deep/saltwater,/area/caribbean/sea/bottom/roofed)
"aB" = (/obj/structure/barricade/ship{icon_state = "boat1"; dir = 4},/turf/floor/beach/water/deep/saltwater,/area/caribbean/sea/bottom/roofed)
"aC" = (/obj/covers/repairedfloor/ship,/obj/structure/closet/crate/rations/beer,/turf/floor/beach/water/deep/saltwater,/area/caribbean/sea/bottom/roofed)
"aD" = (/obj/covers/repairedfloor/ship,/obj/structure/closet/crate/rations/ale,/turf/floor/beach/water/deep/saltwater,/area/caribbean/sea/bottom/roofed)
"aE" = (/obj/covers/repairedfloor/ship,/obj/structure/closet/crate/rations/biscuits,/turf/floor/beach/water/deep/saltwater,/area/caribbean/sea/bottom/roofed)
"aF" = (/obj/covers/repairedfloor/ship,/obj/structure/closet/crate/rations/fruits,/turf/floor/beach/water/deep/saltwater,/area/caribbean/sea/bottom/roofed)
"aG" = (/obj/covers/repairedfloor/ship,/obj/structure/closet/crate/rations/vegetables,/turf/floor/beach/water/deep/saltwater,/area/caribbean/sea/bottom/roofed)
"aH" = (/obj/covers/repairedfloor/ship,/obj/structure/closet/crate/musketball,/turf/floor/beach/water/deep/saltwater,/area/caribbean/sea/bottom/roofed)
"aI" = (/obj/covers/repairedfloor/ship,/obj/structure/closet/crate/musketball_pistol,/turf/floor/beach/water/deep/saltwater,/area/caribbean/sea/bottom/roofed)
"aJ" = (/obj/covers/repairedfloor/ship,/obj/structure/closet/crate/cannonball,/turf/floor/beach/water/deep/saltwater,/area/caribbean/sea/bottom/roofed)
"aK" = (/obj/covers/repairedfloor/ship,/obj/structure/closet/crate/cannonball/chainshot,/turf/floor/beach/water/deep/saltwater,/area/caribbean/sea/bottom/roofed)
"aL" = (/obj/covers/repairedfloor/ship,/obj/structure/closet/crate/cannonball/grapeshot,/turf/floor/beach/water/deep/saltwater,/area/caribbean/sea/bottom/roofed)
"aM" = (/obj/covers/repairedfloor/ship,/obj/structure/closet/crate/bayonets,/turf/floor/beach/water/deep/saltwater,/area/caribbean/sea/bottom/roofed)
"aN" = (/obj/covers/repairedfloor/ship,/obj/structure/closet/crate/webbings,/turf/floor/beach/water/deep/saltwater,/area/caribbean/sea/bottom/roofed)
"aO" = (/obj/structure/simple_door/key_door/anyone/wood/ship,/obj/covers/repairedfloor/ship,/turf/floor/beach/water/deep/saltwater,/area/caribbean/sea/bottom/roofed)
"aP" = (/obj/structure/barricade/ship/north/corners{icon_state = "boat1_up_corners"; dir = 6},/turf/floor/beach/water/deep/saltwater,/area/caribbean/sea/bottom/roofed)
"aQ" = (/obj/structure/barricade/ship/north/corners{icon_state = "boat1_up_corners"; dir = 8},/turf/floor/beach/water/deep/saltwater,/area/caribbean/sea/bottom/roofed)
"aR" = (/obj/structure/ship_bow,/turf/floor/beach/water/deep/saltwater,/area/caribbean/sea/bottom)
"aS" = (/obj/structure/barricade/ship/north/corners{icon_state = "boat1_up_corners"; dir = 4},/turf/floor/beach/water/deep/saltwater,/area/caribbean/sea/bottom/roofed)
"aT" = (/obj/structure/barricade/ship/north/corners{icon_state = "boat1_up_corners"; dir = 10},/obj/item/flashlight/lantern/on/anchored,/turf/floor/beach/water/deep/saltwater,/area/caribbean/sea/bottom/roofed)
"aU" = (/obj/structure/barricade/ship{icon_state = "boat1"; dir = 2},/turf/floor/beach/water/deep/saltwater,/area/caribbean/sea/bottom/roofed)
"aV" = (/obj/structure/barricade/ship/aport1,/obj/structure/cannon/modern/tank/voyage/autofire,/turf/floor/beach/water/deep/saltwater,/area/caribbean/sea/bottom/roofed)
"aW" = (/obj/map_metadata/voyage,/turf/floor/beach/water/deep/saltwater,/area/caribbean/sea/bottom)
"aX" = (/obj/effect/landmark{name = "Grappling Hook area - do not block"},/turf/floor/beach/water/deep/saltwater,/area/caribbean/sea/bottom)
"aY" = (/obj/covers/repairedfloor/ship,/obj/structure/barricade/ship/wood/a4,/turf/floor/broken_floor,/area/caribbean/sea/bottom/roofed)
"aZ" = (/obj/covers/repairedfloor/ship,/obj/structure/barricade/ship/wood/a7,/turf/floor/broken_floor,/area/caribbean/sea/bottom/roofed)
"ba" = (/obj/structure/barricade/ship/wood/a8,/turf/floor/broken_floor,/area/caribbean/sea/bottom/roofed)
"bb" = (/obj/covers/repairedfloor/ship,/obj/structure/barricade/ship/wood/a8,/turf/floor/broken_floor,/area/caribbean/sea/bottom/roofed)
"bc" = (/obj/covers/repairedfloor/ship,/obj/structure/window/barrier/ship/blue/bport_north,/turf/floor/broken_floor,/area/caribbean/sea/bottom)
"bd" = (/obj/structure/window/barrier/ship/blue/bport3{icon_state = "boat_b_port3"; dir = 1},/obj/covers/repairedfloor/ship/south,/turf/floor/broken_floor,/area/caribbean/sea/bottom)
"be" = (/obj/covers/repairedfloor/ship,/obj/structure/window/barrier/ship/blue/bport_north,/mob/living/simple_animal/hostile/human/voyage/spanish/ranged,/turf/floor/broken_floor,/area/caribbean/sea/bottom)
"bf" = (/obj/covers/repairedfloor/ship,/obj/structure/window/barrier/ship/blue/bport_10,/turf/floor/broken_floor,/area/caribbean/sea/bottom)
"bg" = (/obj/covers/repairedfloor/ship,/obj/structure/barricade/ship/wood/a10,/obj/item/flashlight/lantern/on/anchored,/turf/floor/broken_floor,/area/caribbean/sea/bottom/roofed)
"bh" = (/obj/covers/repairedfloor/ship,/obj/structure/closet/cabinet,/obj/item/weapon/gun/projectile/flintlock/pistoletmodelean1733,/turf/floor/broken_floor,/area/caribbean/sea/bottom/roofed)
"bi" = (/obj/covers/repairedfloor/ship,/obj/structure/bed/padded,/obj/item/weapon/bedsheet/red,/turf/floor/broken_floor,/area/caribbean/sea/bottom/roofed)
"bj" = (/obj/covers/repairedfloor/ship,/obj/structure/barricade/ship/wood/a6,/obj/item/flashlight/lantern/on/anchored,/turf/floor/broken_floor,/area/caribbean/sea/bottom/roofed)
"bk" = (/obj/covers/repairedfloor/ship,/obj/structure/table/modern/table,/turf/floor/broken_floor,/area/caribbean/sea/bottom/roofed)
"bl" = (/obj/covers/repairedfloor/ship,/turf/floor/broken_floor,/area/caribbean/sea/bottom/roofed)
"bm" = (/obj/covers/repairedfloor/ship,/obj/structure/bed/padded,/obj/item/weapon/bedsheet/brown,/turf/floor/broken_floor,/area/caribbean/sea/bottom/roofed)
"bn" = (/obj/covers/repairedfloor/ship,/obj/structure/barricade/ship/wood/a12,/obj/item/flashlight/lantern/on/anchored,/turf/floor/broken_floor,/area/caribbean/sea/bottom/roofed)
"bo" = (/obj/covers/repairedfloor/ship,/turf/floor/broken_floor,/area/caribbean/sea/bottom)
"bp" = (/obj/covers/repairedfloor/ship,/obj/structure/cannon/modern/tank/voyage/autofire{icon_state = "cannon"; dir = 1},/turf/floor/broken_floor,/area/caribbean/sea/bottom)
"bq" = (/obj/covers/repairedfloor/ship,/obj/structure/voyage/ropeladder/thin{icon_state = "ropeladder_thin"; dir = 1},/turf/floor/broken_floor,/area/caribbean/sea/bottom)
"br" = (/obj/covers/repairedfloor/ship,/obj/structure/voyage/ropeladder{icon_state = "ropeladder"; dir = 1},/obj/structure/cannon/modern/tank/voyage/autofire{icon_state = "cannon"; dir = 1},/turf/floor/broken_floor,/area/caribbean/sea/bottom)
"bs" = (/obj/covers/repairedfloor/ship,/obj/structure/window/barrier/ship/blue/bport5/corner,/turf/floor/broken_floor,/area/caribbean/sea/bottom)
"bt" = (/obj/covers/repairedfloor/ship,/obj/structure/barricade/ship/wood/a6,/turf/floor/broken_floor,/area/caribbean/sea/bottom/roofed)
"bu" = (/obj/covers/repairedfloor/ship,/obj/structure/bed/chair/wood/red{icon_state = "wooden_chair_red"; dir = 8},/turf/floor/broken_floor,/area/caribbean/sea/bottom/roofed)
"bv" = (/obj/covers/repairedfloor/ship,/obj/structure/closet/cabinet,/obj/item/weapon/gun/projectile/flintlock/duellingpistol,/turf/floor/broken_floor,/area/caribbean/sea/bottom/roofed)
"bw" = (/obj/covers/repairedfloor/ship,/obj/structure/barricade/ship/wood/a12,/turf/floor/broken_floor,/area/caribbean/sea/bottom/roofed)
"bx" = (/obj/covers/repairedfloor/ship,/mob/living/simple_animal/hostile/human/voyage/spanish,/turf/floor/broken_floor,/area/caribbean/sea/bottom)
"by" = (/obj/covers/repairedfloor/ship,/mob/living/simple_animal/hostile/human/voyage/spanish/ranged/lt,/turf/floor/broken_floor,/area/caribbean/sea/bottom/roofed)
"bz" = (/obj/covers/repairedfloor/ship,/obj/structure/barricade/ship/wood/a2,/turf/floor/broken_floor,/area/caribbean/sea/bottom/roofed)
"bA" = (/obj/covers/repairedfloor/ship,/mob/living/simple_animal/hostile/human/voyage/spanish/ranged,/turf/floor/broken_floor,/area/caribbean/sea/bottom/roofed)
"bB" = (/obj/covers/repairedfloor/ship,/obj/structure/multiz/ladder/ww2,/turf/floor/broken_floor,/area/caribbean/sea/bottom)
"bC" = (/obj/covers/repairedfloor/ship,/obj/structure/barricade/ship/blue/beast,/turf/floor/broken_floor,/area/caribbean/sea/bottom)
"bD" = (/obj/covers/repairedfloor/ship,/obj/structure/table/modern/table,/obj/item/weapon/paper_bin,/turf/floor/broken_floor,/area/caribbean/sea/bottom/roofed)
"bE" = (/obj/covers/repairedfloor/ship,/obj/structure/closet/crate/musketball,/turf/floor/broken_floor,/area/caribbean/sea/bottom)
"bF" = (/obj/covers/repairedfloor/ship,/obj/structure/vending/craftable/rifles/wood/filled_musket_spanish,/turf/floor/broken_floor,/area/caribbean/sea/bottom)
"bG" = (/obj/covers/repairedfloor/ship,/mob/living/simple_animal/hostile/human/voyage/spanish/ranged/sgt,/turf/floor/broken_floor,/area/caribbean/sea/bottom)
"bH" = (/obj/covers/repairedfloor/ship,/obj/structure/bed/chair/wood/red{icon_state = "wooden_chair_red"; dir = 4},/mob/living/simple_animal/hostile/human/voyage/spanish/ranged/cpt,/turf/floor/broken_floor,/area/caribbean/sea/bottom/roofed)
"bI" = (/obj/covers/repairedfloor/ship,/obj/structure/table/modern/table,/obj/item/weapon/paper,/obj/item/weapon/pen,/turf/floor/broken_floor,/area/caribbean/sea/bottom/roofed)
"bJ" = (/obj/covers/repairedfloor/ship,/obj/structure/simple_door/key_door/custom/singledoor/privacy{unique_door_name = ""},/turf/floor/broken_floor,/area/caribbean/sea/bottom/roofed)
"bK" = (/obj/covers/repairedfloor/ship,/obj/structure/voyage/grid/partial{icon_state = "grid_partial"; dir = 6},/turf/floor/broken_floor,/area/caribbean/sea/bottom)
"bL" = (/obj/covers/repairedfloor/ship,/obj/structure/voyage/grid/partial{icon_state = "grid_partial"; dir = 10},/turf/floor/broken_floor,/area/caribbean/sea/bottom)
"bM" = (/obj/covers/repairedfloor/ship,/obj/structure/table/modern/table,/obj/structure/voyage/tablemap{icon_state = "table_map"; dir = 8},/turf/floor/broken_floor,/area/caribbean/sea/bottom/roofed)
"bN" = (/obj/covers/repairedfloor/ship,/obj/structure/barricade/ship/mast/large,/obj/item/flashlight/lantern/on/anchored,/turf/floor/broken_floor,/area/caribbean/sea/bottom)
"bO" = (/obj/covers/repairedfloor/ship,/obj/structure/table/modern/table,/obj/structure/voyage/sextant,/turf/floor/broken_floor,/area/caribbean/sea/bottom/roofed)
"bP" = (/obj/covers/repairedfloor/ship,/obj/structure/voyage/grid/partial{icon_state = "grid_partial"; dir = 5},/turf/floor/broken_floor,/area/caribbean/sea/bottom)
"bQ" = (/obj/covers/repairedfloor/ship,/obj/structure/voyage/grid/partial{icon_state = "grid_partial"; dir = 9},/turf/floor/broken_floor,/area/caribbean/sea/bottom)
"bR" = (/obj/covers/repairedfloor/ship,/obj/structure/window/barrier/ship/blue/bport_6/corner,/turf/floor/broken_floor,/area/caribbean/sea/bottom)
"bS" = (/obj/covers/repairedfloor/ship,/obj/structure/window/barrier/ship/blue/bport9,/turf/floor/broken_floor,/area/caribbean/sea/bottom)
"bT" = (/obj/covers/repairedfloor/ship,/obj/structure/barricade/ship/blue/b17,/turf/floor/broken_floor,/area/caribbean/sea/bottom/roofed)
"bU" = (/obj/covers/repairedfloor/ship,/obj/structure/barricade/ship/blue/b20{icon_state = "boat_b20"; dir = 2},/obj/item/flashlight/lantern/on/anchored,/turf/floor/broken_floor,/area/caribbean/sea/bottom/roofed)
"bV" = (/obj/covers/repairedfloor/ship,/obj/structure/window/barrier/ship/blue/bport0/south,/turf/floor/broken_floor,/area/caribbean/sea/bottom)
"bW" = (/obj/covers/repairedfloor/ship,/obj/structure/bed/chair/wood/red,/turf/floor/broken_floor,/area/caribbean/sea/bottom/roofed)
"bX" = (/obj/covers/repairedfloor/ship,/obj/structure/barricade/ship/blue/b9,/turf/floor/broken_floor,/area/caribbean/sea/bottom/roofed)
"bY" = (/obj/covers/repairedfloor/ship,/obj/structure/closet/crate/treasurechest,/obj/item/stack/money/escudo/ten,/obj/item/stack/money/escudo/ten,/obj/item/stack/money/escudo/ten,/obj/item/stack/money/escudo/ten,/obj/item/stack/money/escudo/ten,/turf/floor/broken_floor,/area/caribbean/sea/bottom/roofed)
"bZ" = (/obj/covers/repairedfloor/ship,/obj/structure/closet/crate/musketball_pistol,/turf/floor/broken_floor,/area/caribbean/sea/bottom/roofed)
"ca" = (/obj/covers/repairedfloor/ship,/obj/structure/barricade/ship/blue/b9,/obj/structure/voyage/anchor,/turf/floor/broken_floor,/area/caribbean/sea/bottom/roofed)
"cb" = (/obj/covers/repairedfloor/ship,/obj/structure/barricade/ship/blue/b8,/turf/floor/broken_floor,/area/caribbean/sea/bottom/roofed)
"cc" = (/obj/structure/window/barrier/ship/blue/bport3,/obj/covers/repairedfloor/ship,/obj/structure/cannon/modern/tank/voyage/autofire,/turf/floor/broken_floor,/area/caribbean/sea/bottom)
"cd" = (/obj/covers/repairedfloor/ship,/obj/structure/window/barrier/ship/blue/bport0/south,/mob/living/simple_animal/hostile/human/voyage/spanish/ranged,/turf/floor/broken_floor,/area/caribbean/sea/bottom)
"ce" = (/obj/covers/repairedfloor/ship,/obj/structure/window/barrier/ship/blue/bport0/south,/obj/structure/voyage/ropeladder/thin,/turf/floor/broken_floor,/area/caribbean/sea/bottom)
"cf" = (/obj/effect/landmark{name = "Grappling Hook area - do not block"},/obj/covers/repairedfloor/ship,/obj/structure/window/barrier/ship/blue/bport0/south,/mob/living/simple_animal/hostile/human/voyage/spanish/ranged,/turf/floor/broken_floor,/area/caribbean/sea/bottom)
"cg" = (/obj/effect/landmark{name = "Grappling Hook area - do not block"},/obj/covers/repairedfloor/ship,/obj/structure/window/barrier/ship/blue/bport0/south,/turf/floor/broken_floor,/area/caribbean/sea/bottom)
"ch" = (/obj/structure/window/barrier/ship/blue/bport3,/obj/structure/voyage/ropeladder,/obj/covers/repairedfloor/ship,/obj/structure/cannon/modern/tank/voyage/autofire,/turf/floor/broken_floor,/area/caribbean/sea/bottom)

(1,1,1) = {"
aaaaaaaaaaaaaaaaaaaaaaaaaaaaaaaaaaaaaaaaaaaaaaaaaaaaaaaaaaaaaaaaaaaaaaaaaaaaaaaaaaaaaaaaaaaaaaaaaaaaaaaaaaaaaaaaaaaaaaaaaaaaaaaaaaaaaaaaaaaaaaaaaaaaaa
aaaaaaaaaaaaaaaaaaaaaaaaaaaaaaaaaaaaaaaaaaaaaaaaaaaaaaaaaaaaaaaaaaaaaaaaaaaaaaaaaaaaaaaaaaaaaaaaaaaaaaaaaaaaaaaaaaaaaaaaaaaaaaaaaaaaaaaaaaaaaaaaaaaaaa
aaaaaaaaaaaaaaaaaaaaaaaaaaaaaaaaaaaaaaaaaaaaaaaaaaaaaaaaaaaaaaaaaaaaaaaaaaaaaaaaaaaaaaaaaaaaaaaaaaaaaaaaaaaaaaaaaaaaaaaaaaaaaaaaaaaaaaaaaaaaaaaaaaaaaa
aaaaaaaaaaaaaaaaaaaaaaaaaaaaaaaaaaaaaaaaaaaaaaaaaaaaaaaaaaaaaaaaaaaaaaaaaaaaaaaaaaaaaaaaaaaaaaaaaaaaaaaaaaaaaaaaaaaaaaaaaaaaaaaaaaaaaaaaaaaaaaaaaaaaaa
aaaaaaaaaaaaaaaaabacacacacacacacacacacacadacacadacacadacacadacacadacacadacacadacacadacacadacacadacacadacacadacacaeaaaaaaaaaaaaaaaaaaaaaaaaaaaaaaaaaaaa
aaaaaaaaaaaaabacafagagahaiaiaiajakakahajalajajalajamalajajalajajalajajanajajalajajalajajalajamalajajalajajalajajaoacaeaaaaaaaaaaaaaaaaaaaaaaaaaaaaaaaa
aaaaaaaaaaabafagagajajapajajajajaqaqapajajajajajajajajajajajajajajajajajajajajajajajajajajajajarajajajajajajajajajajaoacaeaaaaaaaaaaaaaaaaaaaaaaaaaaaa
aaaaaaaaabafagajajajajapajajajajajajapajajarajajajajajarajajajajajarajajajajarajajarajajajajajajajajajarajajajarajajasataoacaeaaaaaaaaaaaaaaaaaaaaaaaa
aaaaaaaaauagajajajajajapajajaqaqajajapavajajajajajajajajajajawajawajawajawajawajawajawajawajawajawajawajajajajajajajajaxajaxaoaeaaaaaaaaaaaaaaaaaaaaaa
aaaaaaaaauagajajajakajapajajajayajajapavajajajajakajajazajajajajajajajajajazajajajajajajajazajajajajajajazajajajajajajajajajaAaBaaaaaaaaaaaaaaaaaaaaaa
aaaaaaaaauagajajajajajahajajajayajajahajajajajajakajajajajajajajaCaDajaEaFaGaGajaHaHaIajaJaJaKaLajaMaMaNajajajajajajajaxajaxaAaBaaaaaaaaaaaaaaaaaaaaaa
aaaaaaaaauagajakajajajaOajajajayajajaOajajajajajakajajajajajajajaCaDajaEaFaGaGajaHaHaIajaJaJaKaLajaMaMaNajajajajajajajajajajaAaBaaaaaaaaaaaaaaaaaaaaaa
aaaaaaaaauagajakajajajaOajajajayajajaOajajajajajakajajajajajajajaCaDajaEaFaGaGajaHaHaIajaJaJaKaLajaMaMaNajajajajajajajaxajaxataBaaaaaaaaaaaaaaaaaaaaaa
aaaaaaaaauagajajajajajahajajajayajajahajajajajajakajajazajajajajajajajajajazajajajajajajajazajajajajajajazajajajajajajajajajataBaaaaaaaaaaaaaaaaaaaaaa
aaaaaaaaauagajajajakajapajajajayajajapavajajajajajajajajajajawajawajawajawajawajawajawarawajawajawajawajajajajajajajajaxajaxataBaaaaaaaaaaaaaaaaaaaaaa
aaaaaaaaauagajajajajajapajajaqaqajajapavajarajajajarajajarajajajajajajajarajajajarajajajajajajajajajajajarajajajajajajajaqaqaPaQaRaaaaaaaaaaaaaaaaaaaa
aaaaaaaaaSaTagajajajajapajajajajajajapajajajajajajajajajajajajarajajajajajajajajajajajajajajajarajajajajajajajajajajaqaqaPaUaQaaaaaaaaaaaaaaaaaaaaaaaa
aaaaaaaaaaaSaTagagajajapajajajajaqaqapajajajajajajajajajajajajajajajajajajajajajajajajajajajajajajajajajajajajajaqaqaPaUaQaaaaaaaaaaaaaaaaaaaaaaaaaaaa
aaaaaaaaaaaaaSaUaTagagahajajajajakakahajajajajajajajajajajajajajajajajajajajajajajajajajajajajajajajajajajajajajaPaUaQaaaaaaaaaaaaaaaaaaaaaaaaaaaaaaaa
aaaaaaaaaaaaaaaaaSaUaUaUaUaUaUaUaUaUaUaUaVaUaUaVaUaUaVaUaUaVaUaUaVaUaUaVaUaUaVaUaUaVaUaUaVaUaUaVaUaUaVaUaUaVaUaUaQaaaaaaaaaaaaaaaaaaaaaaaaaaaaaaaaaaaa
aaaaaaaaaaaaaaaaaaaaaaaaaaaaaaaaaaaaaaaaaaaaaaaaaaaaaaaaaaaaaaaaaaaaaaaaaaaaaaaaaaaaaaaaaaaaaaaaaaaaaaaaaaaaaaaaaaaaaaaaaaaaaaaaaaaaaaaaaaaaaaaaaaaaaa
aaaaaaaaaaaaaaaaaaaaaaaaaaaaaaaaaaaaaaaaaaaaaaaaaaaaaaaaaaaaaaaaaaaaaaaaaaaaaaaaaaaaaaaaaaaaaaaaaaaaaaaaaaaaaaaaaaaaaaaaaaaaaaaaaaaaaaaaaaaaaaaaaaaaaa
aaaaaaaaaaaaaaaaaaaaaaaaaaaaaaaaaaaaaaaaaaaaaaaaaaaaaaaaaaaaaaaaaaaaaaaaaaaaaaaaaaaaaaaaaaaaaaaaaaaaaaaaaaaaaaaaaaaaaaaaaaaaaaaaaaaaaaaaaaaaaaaaaaaaaa
aaaaaaaaaaaaaaaaaaaaaaaaaaaaaaaaaaaaaaaaaaaaaaaaaaaaaaaaaaaaaaaaaaaaaaaaaaaaaaaaaaaaaaaaaaaaaaaaaaaaaaaaaaaaaaaaaaaaaaaaaaaaaaaaaaaaaaaaaaaaaaaaaaaaaa
aWaaaaaaaaaaaaaaaaaaaaaaaaaaaaaaaaaaaaaaaaaaaaaaaaaaaaaaaaaaaaaaaaaaaaaaaaaaaaaaaaaaaaaaaaaaaaaaaaaaaaaaaaaaaaaaaaaaaaaaaaaaaaaaaaaaaaaaaaaaaaaaaaaaaa
"}

(1,1,2) = {"
aaaaaaaaaaaaaaaaaaaaaaaaaaaaaaaaaaaaaaaaaaaaaaaaaaaaaaaaaXaaaaaaaaaaaaaXaaaaaaaaaaaaaaaaaaaaaaaaaaaaaaaaaaaaaaaaaaaaaaaaaaaaaaaaaaaaaaaaaaaaaaaaaaaaaa
aaaaaaaaaaaaaaaaaaaaaaaaaaaaaaaaaaaaaaaaaaaaaaaaaaaaaaaaaXaaaaaaaaaaaaaXaaaaaaaaaaaaaaaaaaaaaaaaaaaaaaaaaaaaaaaaaaaaaaaaaaaaaaaaaaaaaaaaaaaaaaaaaaaaaa
aaaaaaaaaaaaaaaaaaaaaaaaaaaaaaaaaaaaaaaaaaaaaaaaaaaaaaaaaXaaaaaaaaaaaaaXaaaaaaaaaaaaaaaaaaaaaaaaaaaaaaaaaaaaaaaaaaaaaaaaaaaaaaaaaaaaaaaaaaaaaaaaaaaaaa
aaaaaaaaaaaaaaaaaaaaaaaaaaaaaaaaaaaaaaaaaaaaaaaaaaaaaaaaaXaaaaaaaaaaaaaXaaaaaaaaaaaaaaaaaaaaaaaaaaaaaaaaaaaaaaaaaaaaaaaaaaaaaaaaaaaaaaaaaaaaaaaaaaaaaa
aaaaaaaaaaaaaaaaaYaZaZbaaZaZaZaZaZaZbbbcbdbebebdbcbebdbcbebdbcbebdbcbebdbcbebdbebcbdbebcbdbebcbdbebcbdbebcbdbebcbfaaaaaaaaaaaaaaaaaaaaaaaaaaaaaaaaaaaa
aaaaaaaaaaaaaYaZbgbhbibjbkbkblblblbmbnbobpbobobpbobqbpbobobpbobobpbobobrbobobpbobobpbobobpbobqbpbobobpbobobpbobobsbcbfaaaaaaaaaaaaaaaaaaaaaaaaaaaaaaaa
aaaaaaaaaaaYbgblblblblbtbkbublblblbvbwbobobobobobobobobobobobobobobobobobobobobobobobobobobobobxbobobobobobobobobobobsbcbfaaaaaaaaaaaaaaaaaaaaaaaaaaaa
aaaaaaaaaYbgblblblblblbtbkblblbyblblbwbobobxbobobobobobxbobobobobobxbobobobobxbobobxbobobobobobobobobobxbobobobxbobobobobsbcbfaaaaaaaaaaaaaaaaaaaaaaaa
aaaaaaaabzblblblblblblbtblbAblblblbAbwbBbobobobobobobobobobobobobobobobobobobobobobobobobobobobobobobobobobobobobobobobobobobsbfaaaaaaaaaaaaaaaaaaaaaa
aaaaaaaabzblbkbkblblblbtblblblblblblbwbBbobobobobobobobobobobobobobobobobobobobobobobobobobobobobobobobobobobobobobobobobobobobCaaaaaaaaaaaaaaaaaaaaaa
aaaaaaaabzblblbDblblblbjblblblblblblbnbobobobobobobEbEbobobobobobobobobFbFbobobobobGbobobobobEbEbobobobobobobobobobobobobobobobCaaaaaaaaaaaaaaaaaaaaaa
aaaaaaaabzblbHbIblblblbJblblblblblblbJbobobobobobGbobobobobKbobLbobobobobobobobobobobobobobobobobobobobobobobobobobobobobobobobCaaaaaaaaaaaaaaaaaaaaaa
aaaaaaaabzblblbMblblblbJblblblblblblbJbobobobobobobNbobobobobobobobGbobNbobobobobobobobobobobNbobobobobobobobobobobobobobobobobCaaaaaaaaaaaaaaaaaaaaaa
aaaaaaaabzblbkbOblblblbjblblblblblblbnbobobobobobobFbFbobobPbobQbobobobEbEbobobobobobobobobobFbFbobobobobobobobobobobobobobobobCaaaaaaaaaaaaaaaaaaaaaa
aaaaaaaabzblblblblblblbtblblblblblblbwbBbobobobobobobobobobobobobobobobobobobobobobobobxbobobobobobobobobobobobobobobobobobobobCaaaaaaaaaaaaaaaaaaaaaa
aaaaaaaabzblblblblblblbtblblblblblblbwbBbobxbobobobxbobobxbobobobobobobobxbobobobxbobobobobobobobobobobobxbobobobobobobobobobRbSaRaaaaaaaaaaaaaaaaaaaa
aaaaaaaabTbUblblblblblbtbAbyblblblbAbwbobobobobobobobobobobobobxbobobobobobobobobobobobobobobobxbobobobobobobobobobobobobRbVbSaaaaaaaaaaaaaaaaaaaaaaaa
aaaaaaaaaabTbUblblblblbtbkbWblblblbvbwbobobobobobobobobobobobobobobobobobobobobobobobobobobobobobobobobobobobobobobobRbVbSaaaaaaaaaaaaaaaaaaaaaaaaaaaa
aaaaaaaaaaaabTbXbUbYbZbjbkbkbkblblbmbnbobobobobobobobobobobobobobobobobobobobobobobobobobobobobobobobobobobobobobRbVbSaaaaaaaaaaaaaaaaaaaaaaaaaaaaaaaa
aaaaaaaaaaaaaaaabTbXbXbXbXbXcabXbXbXcbbVcccdbVcccdcecccfbVcccdbVcccdcgchcdbVcccdbVcccdbVcccdcecccdbVcccdbVcccdbVbSaaaaaaaaaaaaaaaaaaaaaaaaaaaaaaaaaaaa
aaaaaaaaaaaaaaaaaaaaaaaaaaaaaaaaaaaaaaaaaaaaaaaaaaaaaaaaaaaaaaaaaaaaaaaaaaaaaaaaaaaaaaaaaaaaaaaaaaaaaaaaaaaaaaaaaaaaaaaaaaaaaaaaaaaaaaaaaaaaaaaaaaaaaa
aaaaaaaaaaaaaaaaaaaaaaaaaaaaaaaaaaaaaaaaaaaaaaaaaaaaaaaaaaaaaaaaaaaaaaaaaaaaaaaaaaaaaaaaaaaaaaaaaaaaaaaaaaaaaaaaaaaaaaaaaaaaaaaaaaaaaaaaaaaaaaaaaaaaaa
aaaaaaaaaaaaaaaaaaaaaaaaaaaaaaaaaaaaaaaaaaaaaaaaaaaaaaaaaaaaaaaaaaaaaaaaaaaaaaaaaaaaaaaaaaaaaaaaaaaaaaaaaaaaaaaaaaaaaaaaaaaaaaaaaaaaaaaaaaaaaaaaaaaaaa
aaaaaaaaaaaaaaaaaaaaaaaaaaaaaaaaaaaaaaaaaaaaaaaaaaaaaaaaaaaaaaaaaaaaaaaaaaaaaaaaaaaaaaaaaaaaaaaaaaaaaaaaaaaaaaaaaaaaaaaaaaaaaaaaaaaaaaaaaaaaaaaaaaaaaa
aaaaaaaaaaaaaaaaaaaaaaaaaaaaaaaaaaaaaaaaaaaaaaaaaaaaaaaaaaaaaaaaaaaaaaaaaaaaaaaaaaaaaaaaaaaaaaaaaaaaaaaaaaaaaaaaaaaaaaaaaaaaaaaaaaaaaaaaaaaaaaaaaaaaaa
"}
