"aa" = (/obj/covers/repairedfloor/ship,/obj/structure/grapplehook/auto{dir = 1},/turf/floor/beach/water/deep/saltwater,/area/caribbean/sea/bottom)
"ab" = (/obj/covers/repairedfloor/ship,/obj/structure/grapplehook/auto,/turf/floor/beach/water/deep/saltwater,/area/caribbean/sea/bottom)
"aV" = (/obj/structure/window/barrier/ship/wood/port0,/obj/covers/repairedfloor/ship/south,/turf/floor/beach/water/deep/saltwater,/area/caribbean/sea/bottom)
"aX" = (/obj/covers/repairedfloor/ship,/obj/structure/closet/crate/rations/ale,/turf/floor/beach/water/deep/saltwater,/area/caribbean/sea/bottom/roofed)
"bc" = (/obj/structure/barricade/ship/wood/a12,/obj/covers/repairedfloor/ship,/turf/floor/beach/water/deep/saltwater,/area/caribbean/sea/bottom/roofed)
"bs" = (/obj/structure/window/barrier/ship/blue/bport3,/obj/structure/cannon/modern/tank/voyage/autofire,/obj/covers/repairedfloor/ship,/turf/floor/beach/water/deep/saltwater,/area/caribbean/sea/bottom)
"fF" = (/obj/covers/repairedfloor/ship,/obj/structure/bed/hammock,/turf/floor/beach/water/deep/saltwater,/area/caribbean/sea/bottom/roofed)
"gW" = (/obj/structure/barricade/ship/wood/a2,/obj/covers/repairedfloor/ship,/turf/floor/beach/water/deep/saltwater,/area/caribbean/sea/bottom/roofed)
"hc" = (/obj/covers/repairedfloor/ship,/obj/structure/barricade/ship/blue/b2,/turf/floor/beach/water/deep/saltwater,/area/caribbean/sea/bottom/roofed)
"hD" = (/obj/covers/repairedfloor/ship,/turf/floor/beach/water/deep/saltwater,/area/caribbean/sea/bottom)
"iB" = (/obj/map_metadata/voyage,/turf/floor/beach/water/deep/saltwater,/area/caribbean/sea/bottom)
"ki" = (/obj/structure/barricade/ship/wood/a7,/obj/covers/repairedfloor/ship,/turf/floor/beach/water/deep/saltwater,/area/caribbean/sea/bottom/roofed)
"kV" = (/obj/structure/barricade/ship/wood/a1,/obj/covers/repairedfloor/ship,/turf/floor/beach/water/deep/saltwater,/area/caribbean/sea/bottom/roofed)
"la" = (/obj/covers/repairedfloor/ship,/obj/structure/cannon/modern/tank/voyage/autofire{dir = 1; icon_state = "cannon"},/turf/floor/beach/water/deep/saltwater,/area/caribbean/sea/bottom)
"mt" = (/obj/covers/repairedfloor/ship,/mob/living/simple_animal/hostile/human/voyage/pirate/ranged,/turf/floor/beach/water/deep/saltwater,/area/caribbean/sea/bottom)
"nk" = (/obj/structure/barricade/ship/wood/a6,/obj/covers/repairedfloor/ship,/turf/floor/beach/water/deep/saltwater,/area/caribbean/sea/bottom/roofed)
"oi" = (/obj/structure/window/barrier/ship/wood/port2,/obj/covers/repairedfloor/ship/south,/mob/living/simple_animal/hostile/human/voyage/pirate,/turf/floor/beach/water/deep/saltwater,/area/caribbean/sea/bottom)
"qm" = (/obj/structure/barricade/ship/mast,/obj/covers/repairedfloor/ship,/turf/floor/beach/water/deep/saltwater,/area/caribbean/sea/bottom)
"rY" = (/obj/structure/barricade/ship/blue/b9,/obj/covers/repairedfloor/ship,/turf/floor/beach/water/deep/saltwater,/area/caribbean/sea/bottom/roofed)
"se" = (/obj/structure/table/wood,/obj/covers/repairedfloor/ship,/obj/structure/voyage/tablemap{dir = 4; layer = 2.9},/obj/item/weapon/gun/projectile/flintlock/pistoletmodelean1733,/turf/floor/beach/water/deep/saltwater,/area/caribbean/sea/bottom/roofed)
"sI" = (/obj/covers/repairedfloor/ship,/obj/structure/bookcase,/obj/item/weapon/book,/obj/item/weapon/book,/obj/item/weapon/book,/turf/floor/beach/water/deep/saltwater,/area/caribbean/sea/bottom/roofed)
"tJ" = (/obj/structure/barricade/ship/blue/b18,/obj/covers/repairedfloor/ship,/turf/floor/beach/water/deep/saltwater,/area/caribbean/sea/bottom/roofed)
"vf" = (/obj/covers/repairedfloor/ship,/obj/structure/table/rack/coatrack,/turf/floor/beach/water/deep/saltwater,/area/caribbean/sea/bottom/roofed)
"wu" = (/obj/structure/simple_door/key_door/anyone/wood,/obj/covers/repairedfloor/ship,/turf/floor/beach/water/deep/saltwater,/area/caribbean/sea/bottom/roofed)
"ys" = (/obj/structure/window/barrier/ship/wood/port2,/obj/covers/repairedfloor/ship/south,/turf/floor/beach/water/deep/saltwater,/area/caribbean/sea/bottom)
"Bo" = (/obj/covers/repairedfloor/ship,/turf/floor/beach/water/deep/saltwater,/area/caribbean/sea/bottom/roofed)
"BF" = (/obj/structure/flag/pirates,/obj/covers/repairedfloor/ship,/turf/floor/beach/water/deep/saltwater,/area/caribbean/sea/bottom)
"BQ" = (/obj/covers/repairedfloor/ship,/obj/structure/wallclock,/turf/floor/beach/water/deep/saltwater,/area/caribbean/sea/bottom/roofed)
"CF" = (/obj/structure/barricade/ship/blue/b10,/obj/covers/repairedfloor/ship,/turf/floor/beach/water/deep/saltwater,/area/caribbean/sea/bottom/roofed)
"IK" = (/obj/covers/repairedfloor/ship,/obj/item/stack/money/goldvaluables,/obj/item/stack/money/goldvaluables,/obj/structure/closet/crate/chest,/turf/floor/beach/water/deep/saltwater,/area/caribbean/sea/bottom/roofed)
"KE" = (/obj/structure/window/barrier/ship/blue/bport3,/obj/covers/repairedfloor/ship,/turf/floor/beach/water/deep/saltwater,/area/caribbean/sea/bottom)
"KK" = (/obj/structure/barricade/ship/blue/b17,/obj/covers/repairedfloor/ship,/obj/structure/barricade/ship/blue/b15,/turf/floor/beach/water/deep/saltwater,/area/caribbean/sea/bottom/roofed)
"KV" = (/obj/structure/window/barrier/ship/blue/bport0,/obj/covers/repairedfloor/ship,/turf/floor/beach/water/deep/saltwater,/area/caribbean/sea/bottom)
"LU" = (/obj/structure/window/barrier/ship/wood/port0,/obj/covers/repairedfloor/ship,/turf/floor/beach/water/deep/saltwater,/area/caribbean/sea/bottom)
"Nk" = (/turf/wall/wood,/area/caribbean/sea/bottom/roofed)
"NB" = (/obj/structure/table/wood,/obj/covers/repairedfloor/ship,/obj/structure/potted_plant{dir = 5},/turf/floor/beach/water/deep/saltwater,/area/caribbean/sea/bottom/roofed)
"Ou" = (/obj/structure/window/barrier/ship/blue/bport3,/obj/covers/repairedfloor/ship,/obj/structure/cannon/modern/tank/voyage/autofire,/turf/floor/beach/water/deep/saltwater,/area/caribbean/sea/bottom)
"PM" = (/obj/structure/barricade/ship/wood/a3,/obj/covers/repairedfloor/ship,/turf/floor/beach/water/deep/saltwater,/area/caribbean/sea/bottom/roofed)
"Qa" = (/obj/covers/repairedfloor/ship,/obj/structure/cannon{dir = 1},/turf/floor/beach/water/deep/saltwater,/area/caribbean/sea/bottom)
"Qk" = (/obj/structure/barricade/ship/blue/b8,/obj/covers/repairedfloor/ship,/obj/covers/repairedfloor/ship,/turf/floor/beach/water/deep/saltwater,/area/caribbean/sea/bottom/roofed)
"QE" = (/obj/covers/repairedfloor/ship,/mob/living/simple_animal/hostile/human/voyage/pirate,/turf/floor/beach/water/deep/saltwater,/area/caribbean/sea/bottom)
"RC" = (/obj/covers/repairedfloor/ship,/obj/structure/oven,/turf/floor/beach/water/deep/saltwater,/area/caribbean/sea/bottom/roofed)
"RD" = (/obj/structure/barricade/ship/wood/a4,/obj/covers/repairedfloor/ship,/obj/structure/barricade/ship/blue/b1,/turf/floor/beach/water/deep/saltwater,/area/caribbean/sea/bottom/roofed)
"RQ" = (/obj/structure/barricade/ship/wood/a9,/obj/covers/repairedfloor/ship,/turf/floor/beach/water/deep/saltwater,/area/caribbean/sea/bottom/roofed)
"Sh" = (/obj/covers/repairedfloor/ship,/obj/structure/bookcase,/obj/item/weapon/book,/obj/item/weapon/book,/obj/item/weapon/book,/obj/item/weapon/book,/obj/item/weapon/book,/turf/floor/beach/water/deep/saltwater,/area/caribbean/sea/bottom/roofed)
"TP" = (/obj/covers/repairedfloor/ship,/obj/structure/bed/chair/comfy/blue{dir = 8},/mob/living/simple_animal/hostile/human/voyage/pirate/ranged/captain,/turf/floor/beach/water/deep/saltwater,/area/caribbean/sea/bottom/roofed)
"TX" = (/obj/structure/barricade/ship/blue/b19,/obj/covers/repairedfloor/ship,/turf/floor/beach/water/deep/saltwater,/area/caribbean/sea/bottom/roofed)
"Uk" = (/obj/covers/repairedfloor/ship,/obj/structure/bed/chair{dir = 4},/turf/floor/beach/water/deep/saltwater,/area/caribbean/sea/bottom/roofed)
"Ut" = (/obj/structure/barricade/ship/wood/a5,/obj/covers/repairedfloor/ship,/turf/floor/beach/water/deep/saltwater,/area/caribbean/sea/bottom/roofed)
"Vg" = (/obj/covers/repairedfloor/ship,/obj/structure/table/fancy,/obj/item/weapon/reagent_containers/food/snacks/applepie,/turf/floor/beach/water/deep/saltwater,/area/caribbean/sea/bottom/roofed)
"VJ" = (/obj/structure/barricade/ship/wood/a7,/obj/covers/repairedfloor/ship,/obj/structure/sign/painting9,/turf/floor/beach/water/deep/saltwater,/area/caribbean/sea/bottom/roofed)
"We" = (/obj/covers/repairedfloor/ship,/obj/item/stack/money/goldvaluables,/obj/structure/closet/crate/chest,/turf/floor/beach/water/deep/saltwater,/area/caribbean/sea/bottom/roofed)
"Wt" = (/obj/structure/barricade/ship/blue/b16,/obj/covers/repairedfloor/ship,/turf/floor/beach/water/deep/saltwater,/area/caribbean/sea/bottom/roofed)
"Xi" = (/obj/covers/repairedfloor/ship,/obj/item/stack/money/goldcoin,/obj/structure/closet/crate/chest,/turf/floor/beach/water/deep/saltwater,/area/caribbean/sea/bottom/roofed)
"YO" = (/turf/floor/beach/water/deep/saltwater,/area/caribbean/sea/bottom)
"Ze" = (/obj/covers/repairedfloor/ship,/obj/structure/closet/crate/rations/fruits,/turf/floor/beach/water/deep/saltwater,/area/caribbean/sea/bottom/roofed)

(1,1,1) = {"
YOYOYOYOYOYOYOYOYOYOYOYOYOYOYOYOYOYOYOYOYOYOYOYOYOYOYOYOYOYOYOYOYOYOYOYOYOYOYOYOYOYOYOYOYOYOYOYOYOYOYOYOYOYOYOYOYOYOYOYOYOYOYOYOYOYOYOYOYOYOYOYOYOYOYO
YOYOYOYOYOYOYOYOYOYOYOYOYOYOYOYOYOYOYOYOYOYOYOYOYOYOYOYOYOYOYOYOYOYOYOYOYOYOYOYOYOYOYOYOYOYOYOYOYOYOYOYOYOYOYOYOYOYOYOYOYOYOYOYOYOYOYOYOYOYOYOYOYOYOYO
YOYOYOYOYOYOYOYOYOYOYOYOYOYOYOYOYOYOYOYOYOYOYOYOYOYOYOYOYOYOYOYOYOYOYOYOYOYOYOYOYOYOYOYOYOYOYOYOYOYOYOYOYOYOYOYOYOYOYOYOYOYOYOYOYOYOYOYOYOYOYOYOYOYOYO
YOYOYOYOYOYOYOYOYOYOYOYOYOYOYOYOYOYOYOYOYOYOYOYOYOYOYOYOYOYOYOYOYOYOYOYOYOYOYOYOYOYOYOYOYOYOYOYOYOYOYOYOYOYOYOYOYOYOYOYOYOYOYOYOYOYOYOYOYOYOYOYOYOYOYO
YOYOYOYOYOYOYOYOYOYOYOYOYOYOYOYOYOYOYOYOYOYOYOYOYOYOYOYOYOYOYOYOYOYOYOYOYOYOYOYOYOYOYOYOYOYOYOYOYOYOYOYOYOYOYOYOYOYOYOYOYOYOYOYOYOYOYOYOYOYOYOYOYOYOYO
YOYOYOYOYOYOYOYOYOYOYOYOYOYOYOYOYOYOYOYOYOYOYOYOYOYOYOYOYOYOYOYOYOYOYOYOYOYOYOYOYOYOYOYOYOYOYOYOYOYOYOYOYOYOYOYOYOYOYOYOYOYOYOYOYOYOYOYOYOYOYOYOYOYOYO
YOYOYOYOYOYOYOYOYOYOYOYOYOYOYOYOYOYOYOYOYOYOYOYOYOYOYOYOYOYOYOYOYOYOYOYOYOYOYOYOYOYOYOYOYOYOYOYOYOYOYOYOYOYOYOYOYOYOYOYOYOYOYOYOYOYOYOYOYOYOYOYOYOYOYO
YOYOYOYOYOYOYOYOYOYOYOYOYOYOYOYOYOYOYOYOYOYOYOYOYOYOYOYOYOYOYOYOYOYOYOYOYOYOYOYOYOYOYOYOYOYOYOYOYOYOYOYOYOYOYOYOYOYOYOYOYOYOYOYOYOYOYOYOYOYOYOYOYOYOYO
YOYOYOYOYOYOYOYOYOYOYOYOYOYOYOYOYOYOYOYOYOYOYOYOYOYOYOYOYOYOYOYOYOYOYOYOYOYOYOYOYOYOYOYOYOYOYOYOYOYOYOYOYOYOYOYOYOYOYOYOYOYOYOYOYOYOYOYOYOYOYOYOYOYOYO
YOYOYOYOYOYOYOYOYOYOYOYOYOYOYOYOYOYOYOYOYOYOYOYOYOYOYOYOYOYOYOYOYOYOYOYOYOYOYOYOYOYOYOYOYOYOYOYOYOYOYOYOYOYOYOYOYOYOYOYOYOYOYOYOYOYOYOYOYOYOYOYOYOYOYO
YOYOYOYOYOYOYOYOYOYOYOYOYOYOYOYOYOYOYOYOYOYOYOYOYOYOYOYOYOYOYOYOYOYOYOYOYOYOYOYOYOYOYOYOYOYOYOYOYOYOYOYOYOYOYOYOYOYOYOYOYOYOYOYOYOYOYOYOYOYOYOYOYOYOYO
YOYOYOYOYOYOYOYOYOYOYOYOYOYOYOYOYOYOYOYOYOYOYOYOYOYOYOYOYOYOYOYOYOYOYOYOYOYOYOYOYOYOYOYOYOYOYOYOYOYOYOYOYOYOYOYOYOYOYOYOYOYOYOYOYOYOYOYOYOYOYOYOYOYOYO
YOYOYOYOYOYOYOYOYOYOYOYOYOYOYOYOYOYOYOYOYOYOYOYOYOYOYOYOYOYOYOYOYOYOYOYOYOYOYOYOYOYOYOYOYOYOYOYOYOYOYOYOYOYOYOYOYOYOYOYOYOYOYOYOYOYOYOYOYOYOYOYOYOYOYO
YOYOYOYOYOYOYOYOYOYOYOYOYOYOYOYOYOYOYOYOYOYOYOYOYOYOYOYOYOYOYOYOYOYOYOYOYOYOYOYOYOYOYOYOYOYOYOYOYOYOYOYOYOYOYOYOYOYOYOYOYOYOYOYOYOYOYOYOYOYOYOYOYOYOYO
YOYOYOYOYOYOYOYOYOYOYOYOYOYOYOYOYOYOYOYOYOYOYOYOYOYOYOYOYOYOYOYOYOYOYOYOYOYOYOYOYOYOYOYOYOYOYOYOYOYOYOYOYOYOYOYOYOYOYOYOYOYOYOYOYOYOYOYOYOYOYOYOYOYOYO
YOYOYOYOYOYOYOYOYOYOYOYOYOYOYOYOYOYOYOYOYOYOYOYOYOYOYOYOYOYOYOYOYOYOYOYOYOYOYOYOYOYOYOYOYOYOYOYOYOYOYOYOYOYOYOYOYOYOYOYOYOYOYOYOYOYOYOYOYOYOYOYOYOYOYO
YOYOYOYOYOYOYOYOYOYOYOYOYOYOYOYOYOYOYOYOYOYOYOYOYOYOYOYOYOYOYOYOYOYOYOYOYOYOYOYOYOYOYOYOYOYOYOYOYOYOYOYOYOYOYOYOYOYOYOYOYOYOYOYOYOYOYOYOYOYOYOYOYOYOYO
YOYOYOYOYOYOYOYOYOYOYOYOYOYOYOYOYOYOYOYOYOYOYOYOYOYOYOYOYOYOYOYOYOYOYOYOYOYOYOYOYOYOYOYOYOYOYOYOYOYOYOYOYOYOYOYOYOYOYOYOYOYOYOYOYOYOYOYOYOYOYOYOYOYOYO
YOYOYOYOYOYOYOYOYOYOYOYOYOYOYOYOYOYOYOYOYOYOYOYOYOYOYOYOYOYOYOYOYOYOYOYOYOYOYOYOYOYOYOYOYOYOYOYOYOYOYOYOYOYOYOYOYOYOYOYOYOYOYOYOYOYOYOYOYOYOYOYOYOYOYO
YOYOYOYOYOYOYOYOYOYOYOYOYOYOYOYOYOYOYOYOYOYOYOYOYOYOYOYOYOYOYOYOYOYOYOYOYOYOYOYOYOYOYOYOYOYOYOYOYOYOYOYOYOYOYOYOYOYOYOYOYOYOYOYOYOYOYOYOYOYOYOYOYOYOYO
YOYOYOYOYOYOYOYOYOYOYOYOYOYOYOYOYOYOYOYOYOYOYOYOYOYOYOYOYOYOYOYOYOYOYOYOYOYOYOYOYOYOYOYOYOYOYOYOYOYOYOYOYOYOYOYOYOYOYOYOYOYOYOYOYOYOYOYOYOYOYOYOYOYOYO
YOYOYOYOYOYOYOYOYOYOYOYOYOYOYOYOYOYOYOYOYOYOYOYOYOYOYOYOYOYOYOYOYOYOYOYOYOYOYOYOYOYOYOYOYOYOYOYOYOYOYOYOYOYOYOYOYOYOYOYOYOYOYOYOYOYOYOYOYOYOYOYOYOYOYO
YOYOYOYOYOYOYOYOYOYOYOYOYOYOYOYOYOYOYOYOYOYOYOYOYOYOYOYOYOYOYOYOYOYOYOYOYOYOYOYOYOYOYOYOYOYOYOYOYOYOYOYOYOYOYOYOYOYOYOYOYOYOYOYOYOYOYOYOYOYOYOYOYOYOYO
YOYOYOYOYOYOYOYOYOYOYOYOYOYOYOYOYOYOYOYOYOYOYOYOYOYOYOYOYOYOYOYOYOYOYOYOYOYOYOYOYOYOYOYOYOYOYOYOYOYOYOYOYOYOYOYOYOYOYOYOYOYOYOYOYOYOYOYOYOYOYOYOYOYOYO
iBYOYOYOYOYOYOYOYOYOYOYOYOYOYOYOYOYOYOYOYOYOYOYOYOYOYOYOYOYOYOYOYOYOYOYOYOYOYOYOYOYOYOYOYOYOYOYOYOYOYOYOYOYOYOYOYOYOYOYOYOYOYOYOYOYOYOYOYOYOYOYOYOYOYO
"}
(1,1,2) = {"
YOYOYOYOYOYOYOYOYOYOYOYOYOYOYOYOYORDkikikikiRQYOYOYOYOYOYOYOYOYOYOYOYOYOYOYOYOYOYOYOYOYOYOYOYOYOYOYOYOYOYOYOYOYOYOYOYOYOYOYOYOYOYOYOYOYOYOYOYOYOYOYOYO
YOYOYOYOYOYOYOYOYOYOYOYOYOYOYOYOYOhcfFBoBofFbcysLUoiLUysaVysLUysLUysLUysLUysLUysLUysLUPMkiVJkiRQYOYOYOYOYOYOYOYOYOYOYOYOYOYOYOYOYOYOYOYOYOYOYOYOYOYOYO
YOYOYOYOYOYOYOYOYOYOYOYOYOYOYOYOYOhcZeBoBofFbchDhDhDhDlahDaahDhDhDQaaahDQEhDQEQaaahDQEgWBQShsIUtRQYOYOYOYOYOYOYOYOYOYOYOYOYOYOYOYOYOYOYOYOYOYOYOYOYOYO
YOYOYOYOYOYOYOYOYOYOYOYOYOYOYOYOYOhcaXBoBoBonkhDhDhDhDhDhDhDmthDhDhDhDhDhDhDhDhDhDhDhDgWBoBoBoBonkNkYOYOYOYOYOYOYOYOYOYOYOYOYOYOYOYOYOYOYOYOYOYOYOYOYO
YOYOYOYOYOYOYOYOYOYOYOYOYOYOYOYOYOhcVgBoBoBowuhDhDqmhDhDhDBFhDhDQEhDhDhDqmhDhDhDhDhDhDwuBoBoseTPnkNkNkNkYOYOYOYOYOYOYOYOYOYOYOYOYOYOYOYOYOYOYOYOYOYOYO
YOYOYOYOYOYOYOYOYOYOYOYOYOYOYOYOYOhcRCBoBoBonkhDhDhDhDhDhDhDhDhDhDhDhDhDhDhDhDmthDhDhDgWBoBoBoBonkNkYOYOYOYOYOYOYOYOYOYOYOYOYOYOYOYOYOYOYOYOYOYOYOYOYO
YOYOYOYOYOYOYOYOYOYOYOYOYOYOYOYOYOhcWeBoBoBonkhDhDQEhDhDmtabhDQEhDhDabhDhDhDhDhDabhDQEkVvfUkNBtJCFYOYOYOYOYOYOYOYOYOYOYOYOYOYOYOYOYOYOYOYOYOYOYOYOYOYO
YOYOYOYOYOYOYOYOYOYOYOYOYOYOYOYOYOhcWeIKXifFnkKEKVKEKVOuKVKEKVKEKVbsKVKEKVKEKVbsKVKEKVWtrYrYrYTXYOYOYOYOYOYOYOYOYOYOYOYOYOYOYOYOYOYOYOYOYOYOYOYOYOYOYO
YOYOYOYOYOYOYOYOYOYOYOYOYOYOYOYOYOKKrYrYrYrYQkYOYOYOYOYOYOYOYOYOYOYOYOYOYOYOYOYOYOYOYOYOYOYOYOYOYOYOYOYOYOYOYOYOYOYOYOYOYOYOYOYOYOYOYOYOYOYOYOYOYOYOYO
YOYOYOYOYOYOYOYOYOYOYOYOYOYOYOYOYOYOYOYOYOYOYOYOYOYOYOYOYOYOYOYOYOYOYOYOYOYOYOYOYOYOYOYOYOYOYOYOYOYOYOYOYOYOYOYOYOYOYOYOYOYOYOYOYOYOYOYOYOYOYOYOYOYOYO
YOYOYOYOYOYOYOYOYOYOYOYOYOYOYOYOYOYOYOYOYOYOYOYOYOYOYOYOYOYOYOYOYOYOYOYOYOYOYOYOYOYOYOYOYOYOYOYOYOYOYOYOYOYOYOYOYOYOYOYOYOYOYOYOYOYOYOYOYOYOYOYOYOYOYO
YOYOYOYOYOYOYOYOYOYOYOYOYOYOYOYOYOYOYOYOYOYOYOYOYOYOYOYOYOYOYOYOYOYOYOYOYOYOYOYOYOYOYOYOYOYOYOYOYOYOYOYOYOYOYOYOYOYOYOYOYOYOYOYOYOYOYOYOYOYOYOYOYOYOYO
YOYOYOYOYOYOYOYOYOYOYOYOYOYOYOYOYOYOYOYOYOYOYOYOYOYOYOYOYOYOYOYOYOYOYOYOYOYOYOYOYOYOYOYOYOYOYOYOYOYOYOYOYOYOYOYOYOYOYOYOYOYOYOYOYOYOYOYOYOYOYOYOYOYOYO
YOYOYOYOYOYOYOYOYOYOYOYOYOYOYOYOYOYOYOYOYOYOYOYOYOYOYOYOYOYOYOYOYOYOYOYOYOYOYOYOYOYOYOYOYOYOYOYOYOYOYOYOYOYOYOYOYOYOYOYOYOYOYOYOYOYOYOYOYOYOYOYOYOYOYO
YOYOYOYOYOYOYOYOYOYOYOYOYOYOYOYOYOYOYOYOYOYOYOYOYOYOYOYOYOYOYOYOYOYOYOYOYOYOYOYOYOYOYOYOYOYOYOYOYOYOYOYOYOYOYOYOYOYOYOYOYOYOYOYOYOYOYOYOYOYOYOYOYOYOYO
YOYOYOYOYOYOYOYOYOYOYOYOYOYOYOYOYOYOYOYOYOYOYOYOYOYOYOYOYOYOYOYOYOYOYOYOYOYOYOYOYOYOYOYOYOYOYOYOYOYOYOYOYOYOYOYOYOYOYOYOYOYOYOYOYOYOYOYOYOYOYOYOYOYOYO
YOYOYOYOYOYOYOYOYOYOYOYOYOYOYOYOYOYOYOYOYOYOYOYOYOYOYOYOYOYOYOYOYOYOYOYOYOYOYOYOYOYOYOYOYOYOYOYOYOYOYOYOYOYOYOYOYOYOYOYOYOYOYOYOYOYOYOYOYOYOYOYOYOYOYO
YOYOYOYOYOYOYOYOYOYOYOYOYOYOYOYOYOYOYOYOYOYOYOYOYOYOYOYOYOYOYOYOYOYOYOYOYOYOYOYOYOYOYOYOYOYOYOYOYOYOYOYOYOYOYOYOYOYOYOYOYOYOYOYOYOYOYOYOYOYOYOYOYOYOYO
YOYOYOYOYOYOYOYOYOYOYOYOYOYOYOYOYOYOYOYOYOYOYOYOYOYOYOYOYOYOYOYOYOYOYOYOYOYOYOYOYOYOYOYOYOYOYOYOYOYOYOYOYOYOYOYOYOYOYOYOYOYOYOYOYOYOYOYOYOYOYOYOYOYOYO
YOYOYOYOYOYOYOYOYOYOYOYOYOYOYOYOYOYOYOYOYOYOYOYOYOYOYOYOYOYOYOYOYOYOYOYOYOYOYOYOYOYOYOYOYOYOYOYOYOYOYOYOYOYOYOYOYOYOYOYOYOYOYOYOYOYOYOYOYOYOYOYOYOYOYO
YOYOYOYOYOYOYOYOYOYOYOYOYOYOYOYOYOYOYOYOYOYOYOYOYOYOYOYOYOYOYOYOYOYOYOYOYOYOYOYOYOYOYOYOYOYOYOYOYOYOYOYOYOYOYOYOYOYOYOYOYOYOYOYOYOYOYOYOYOYOYOYOYOYOYO
YOYOYOYOYOYOYOYOYOYOYOYOYOYOYOYOYOYOYOYOYOYOYOYOYOYOYOYOYOYOYOYOYOYOYOYOYOYOYOYOYOYOYOYOYOYOYOYOYOYOYOYOYOYOYOYOYOYOYOYOYOYOYOYOYOYOYOYOYOYOYOYOYOYOYO
YOYOYOYOYOYOYOYOYOYOYOYOYOYOYOYOYOYOYOYOYOYOYOYOYOYOYOYOYOYOYOYOYOYOYOYOYOYOYOYOYOYOYOYOYOYOYOYOYOYOYOYOYOYOYOYOYOYOYOYOYOYOYOYOYOYOYOYOYOYOYOYOYOYOYO
YOYOYOYOYOYOYOYOYOYOYOYOYOYOYOYOYOYOYOYOYOYOYOYOYOYOYOYOYOYOYOYOYOYOYOYOYOYOYOYOYOYOYOYOYOYOYOYOYOYOYOYOYOYOYOYOYOYOYOYOYOYOYOYOYOYOYOYOYOYOYOYOYOYOYO
YOYOYOYOYOYOYOYOYOYOYOYOYOYOYOYOYOYOYOYOYOYOYOYOYOYOYOYOYOYOYOYOYOYOYOYOYOYOYOYOYOYOYOYOYOYOYOYOYOYOYOYOYOYOYOYOYOYOYOYOYOYOYOYOYOYOYOYOYOYOYOYOYOYOYO
"}
