"aa" = (/obj/covers/repairedfloor/ship,/obj/structure/grapplehook/auto{dir = 1},/turf/floor/beach/water/deep/saltwater,/area/caribbean/sea/bottom)
"ab" = (/obj/covers/repairedfloor/ship,/obj/structure/grapplehook/auto,/turf/floor/beach/water/deep/saltwater,/area/caribbean/sea/bottom)
"bw" = (/obj/structure/window/barrier/ship/wood/port2,/obj/covers/repairedfloor/ship/south,/mob/living/simple_animal/hostile/human/voyage/spanish,/turf/floor/beach/water/deep/saltwater,/area/caribbean/sea/bottom)
"bR" = (/obj/covers/repairedfloor/ship,/mob/living/simple_animal/hostile/human/voyage/spanish,/turf/floor/beach/water/deep/saltwater,/area/caribbean/sea/bottom)
"ce" = (/obj/structure/barricade/ship/blue/b10,/obj/covers/repairedfloor/ship,/turf/floor/beach/water/deep/saltwater,/area/caribbean/sea/bottom/roofed)
"cl" = (/obj/structure/barricade/ship/wood/a4,/obj/covers/repairedfloor/ship,/obj/structure/barricade/ship/blue/b1,/turf/floor/beach/water/deep/saltwater,/area/caribbean/sea/bottom/roofed)
"dC" = (/obj/structure/barricade/ship/wood/a7,/obj/covers/repairedfloor/ship,/turf/floor/beach/water/deep/saltwater,/area/caribbean/sea/bottom/roofed)
"dO" = (/obj/covers/repairedfloor/ship,/obj/item/stack/money/goldvaluables,/obj/item/stack/money/goldvaluables,/obj/structure/closet/crate/chest,/turf/floor/beach/water/deep/saltwater,/area/caribbean/sea/bottom/roofed)
"eh" = (/obj/structure/window/barrier/ship/blue/bport0,/obj/covers/repairedfloor/ship,/turf/floor/beach/water/deep/saltwater,/area/caribbean/sea/bottom)
"er" = (/obj/covers/repairedfloor/ship,/mob/living/simple_animal/hostile/human/voyage/spanish/ranged,/turf/floor/beach/water/deep/saltwater,/area/caribbean/sea/bottom)
"eS" = (/obj/structure/barricade/ship/wood/a12,/obj/covers/repairedfloor/ship,/turf/floor/beach/water/deep/saltwater,/area/caribbean/sea/bottom/roofed)
"eU" = (/obj/covers/repairedfloor/ship,/obj/structure/cannon/modern/tank/voyage/autofire{dir = 1; icon_state = "cannon"},/turf/floor/beach/water/deep/saltwater,/area/caribbean/sea/bottom)
"fm" = (/obj/structure/barricade/ship/blue/b16,/obj/covers/repairedfloor/ship,/turf/floor/beach/water/deep/saltwater,/area/caribbean/sea/bottom/roofed)
"iB" = (/obj/map_metadata/voyage,/turf/floor/beach/water/deep/saltwater,/area/caribbean/sea/bottom)
"jC" = (/obj/structure/table/wood,/obj/covers/repairedfloor/ship,/obj/structure/potted_plant{dir = 5},/turf/floor/beach/water/deep/saltwater,/area/caribbean/sea/bottom/roofed)
"jD" = (/obj/structure/barricade/ship/blue/b19,/obj/covers/repairedfloor/ship,/turf/floor/beach/water/deep/saltwater,/area/caribbean/sea/bottom/roofed)
"kn" = (/obj/structure/window/barrier/ship/wood/port2,/obj/covers/repairedfloor/ship/south,/turf/floor/beach/water/deep/saltwater,/area/caribbean/sea/bottom)
"ln" = (/obj/covers/repairedfloor/ship,/obj/item/stack/money/goldvaluables,/obj/structure/closet/crate/chest,/turf/floor/beach/water/deep/saltwater,/area/caribbean/sea/bottom/roofed)
"pp" = (/obj/covers/repairedfloor/ship,/turf/floor/beach/water/deep/saltwater,/area/caribbean/sea/bottom)
"pJ" = (/obj/covers/repairedfloor/ship,/obj/structure/barricade/ship/blue/b2,/turf/floor/beach/water/deep/saltwater,/area/caribbean/sea/bottom/roofed)
"pW" = (/obj/covers/repairedfloor/ship,/obj/structure/bookcase,/obj/item/weapon/book,/obj/item/weapon/book,/obj/item/weapon/book,/turf/floor/beach/water/deep/saltwater,/area/caribbean/sea/bottom/roofed)
"qc" = (/obj/covers/repairedfloor/ship,/obj/structure/closet/crate/rations/ale,/turf/floor/beach/water/deep/saltwater,/area/caribbean/sea/bottom/roofed)
"ru" = (/obj/structure/barricade/ship/wood/a3,/obj/covers/repairedfloor/ship,/turf/floor/beach/water/deep/saltwater,/area/caribbean/sea/bottom/roofed)
"sh" = (/obj/covers/repairedfloor/ship,/obj/structure/table/fancy,/obj/item/weapon/reagent_containers/food/snacks/applepie,/turf/floor/beach/water/deep/saltwater,/area/caribbean/sea/bottom/roofed)
"sE" = (/obj/covers/repairedfloor/ship,/obj/item/stack/money/goldcoin,/obj/structure/closet/crate/chest,/turf/floor/beach/water/deep/saltwater,/area/caribbean/sea/bottom/roofed)
"tV" = (/obj/covers/repairedfloor/ship,/obj/structure/bed/chair/comfy/blue{dir = 8},/turf/floor/beach/water/deep/saltwater,/area/caribbean/sea/bottom/roofed)
"ub" = (/obj/structure/barricade/ship/wood/a5,/obj/covers/repairedfloor/ship,/turf/floor/beach/water/deep/saltwater,/area/caribbean/sea/bottom/roofed)
"vh" = (/obj/structure/barricade/ship/wood/a2,/obj/covers/repairedfloor/ship,/turf/floor/beach/water/deep/saltwater,/area/caribbean/sea/bottom/roofed)
"vA" = (/obj/structure/table/wood,/obj/covers/repairedfloor/ship,/obj/structure/voyage/tablemap{dir = 4; layer = 2.9},/obj/item/weapon/gun/projectile/flintlock/pistoletmodelean1733,/turf/floor/beach/water/deep/saltwater,/area/caribbean/sea/bottom/roofed)
"vI" = (/obj/covers/repairedfloor/ship,/obj/structure/oven,/turf/floor/beach/water/deep/saltwater,/area/caribbean/sea/bottom/roofed)
"wB" = (/obj/covers/repairedfloor/ship,/obj/structure/table/rack/coatrack,/turf/floor/beach/water/deep/saltwater,/area/caribbean/sea/bottom/roofed)
"wL" = (/obj/structure/window/barrier/ship/wood/port0,/obj/covers/repairedfloor/ship/south,/turf/floor/beach/water/deep/saltwater,/area/caribbean/sea/bottom)
"wP" = (/obj/structure/barricade/ship/blue/b18,/obj/covers/repairedfloor/ship,/turf/floor/beach/water/deep/saltwater,/area/caribbean/sea/bottom/roofed)
"xP" = (/obj/covers/repairedfloor/ship,/turf/floor/beach/water/deep/saltwater,/area/caribbean/sea/bottom/roofed)
"zb" = (/obj/structure/window/barrier/ship/blue/bport3,/obj/covers/repairedfloor/ship,/turf/floor/beach/water/deep/saltwater,/area/caribbean/sea/bottom)
"zN" = (/obj/covers/repairedfloor/ship,/obj/structure/bookcase,/obj/item/weapon/book,/obj/item/weapon/book,/obj/item/weapon/book,/obj/item/weapon/book,/obj/item/weapon/book,/turf/floor/beach/water/deep/saltwater,/area/caribbean/sea/bottom/roofed)
"Ar" = (/obj/structure/barricade/ship/wood/a9,/obj/covers/repairedfloor/ship,/turf/floor/beach/water/deep/saltwater,/area/caribbean/sea/bottom/roofed)
"Dg" = (/obj/covers/repairedfloor/ship,/obj/structure/bed/hammock,/turf/floor/beach/water/deep/saltwater,/area/caribbean/sea/bottom/roofed)
"EB" = (/obj/structure/barricade/ship/wood/a6,/obj/covers/repairedfloor/ship,/turf/floor/beach/water/deep/saltwater,/area/caribbean/sea/bottom/roofed)
"Hj" = (/obj/structure/window/barrier/ship/wood/port0,/obj/covers/repairedfloor/ship,/turf/floor/beach/water/deep/saltwater,/area/caribbean/sea/bottom)
"JX" = (/obj/structure/barricade/ship/wood/a7,/obj/covers/repairedfloor/ship,/obj/structure/sign/painting9,/turf/floor/beach/water/deep/saltwater,/area/caribbean/sea/bottom/roofed)
"Kf" = (/obj/covers/repairedfloor/ship,/obj/structure/wallclock,/turf/floor/beach/water/deep/saltwater,/area/caribbean/sea/bottom/roofed)
"Kq" = (/obj/covers/repairedfloor/ship,/obj/structure/bed/chair{dir = 4},/turf/floor/beach/water/deep/saltwater,/area/caribbean/sea/bottom/roofed)
"Mg" = (/obj/structure/simple_door/key_door/anyone/wood,/obj/covers/repairedfloor/ship,/turf/floor/beach/water/deep/saltwater,/area/caribbean/sea/bottom/roofed)
"NE" = (/obj/covers/repairedfloor/ship,/obj/structure/flag/spanish,/turf/floor/beach/water/deep/saltwater,/area/caribbean/sea/bottom)
"OO" = (/obj/structure/window/barrier/ship/blue/bport3,/obj/covers/repairedfloor/ship,/obj/structure/cannon/modern/tank/voyage/autofire,/turf/floor/beach/water/deep/saltwater,/area/caribbean/sea/bottom)
"Po" = (/obj/structure/barricade/ship/blue/b17,/obj/covers/repairedfloor/ship,/obj/structure/barricade/ship/blue/b15,/turf/floor/beach/water/deep/saltwater,/area/caribbean/sea/bottom/roofed)
"QP" = (/obj/structure/barricade/ship/mast,/obj/covers/repairedfloor/ship,/turf/floor/beach/water/deep/saltwater,/area/caribbean/sea/bottom)
"QU" = (/obj/structure/barricade/ship/blue/b8,/obj/covers/repairedfloor/ship,/obj/covers/repairedfloor/ship,/turf/floor/beach/water/deep/saltwater,/area/caribbean/sea/bottom/roofed)
"SP" = (/obj/structure/barricade/ship/blue/b9,/obj/covers/repairedfloor/ship,/turf/floor/beach/water/deep/saltwater,/area/caribbean/sea/bottom/roofed)
"TR" = (/obj/structure/barricade/ship/wood/a1,/obj/covers/repairedfloor/ship,/turf/floor/beach/water/deep/saltwater,/area/caribbean/sea/bottom/roofed)
"Wp" = (/obj/covers/repairedfloor/ship,/obj/structure/closet/crate/rations/fruits,/turf/floor/beach/water/deep/saltwater,/area/caribbean/sea/bottom/roofed)
"XY" = (/turf/wall/wood,/area/caribbean/sea/bottom/roofed)
"YO" = (/turf/floor/beach/water/deep/saltwater,/area/caribbean/sea/bottom)

(1,1,1) = {"
YOYOYOYOYOYOYOYOYOYOYOYOYOYOYOYOYOYOYOYOYOYOYOYOYOYOYOYOYOYOYOYOYOYOYOYOYOYOYOYOYOYOYOYOYOYOYOYOYOYOYOYOYOYOYOYOYOYOYOYOYOYOYOYOYOYOYOYOYOYOYOYOYOYOYO
YOYOYOYOYOYOYOYOYOYOYOYOYOYOYOYOYOYOYOYOYOYOYOYOYOYOYOYOYOYOYOYOYOYOYOYOYOYOYOYOYOYOYOYOYOYOYOYOYOYOYOYOYOYOYOYOYOYOYOYOYOYOYOYOYOYOYOYOYOYOYOYOYOYOYO
YOYOYOYOYOYOYOYOYOYOYOYOYOYOYOYOYOYOYOYOYOYOYOYOYOYOYOYOYOYOYOYOYOYOYOYOYOYOYOYOYOYOYOYOYOYOYOYOYOYOYOYOYOYOYOYOYOYOYOYOYOYOYOYOYOYOYOYOYOYOYOYOYOYOYO
YOYOYOYOYOYOYOYOYOYOYOYOYOYOYOYOYOYOYOYOYOYOYOYOYOYOYOYOYOYOYOYOYOYOYOYOYOYOYOYOYOYOYOYOYOYOYOYOYOYOYOYOYOYOYOYOYOYOYOYOYOYOYOYOYOYOYOYOYOYOYOYOYOYOYO
YOYOYOYOYOYOYOYOYOYOYOYOYOYOYOYOYOYOYOYOYOYOYOYOYOYOYOYOYOYOYOYOYOYOYOYOYOYOYOYOYOYOYOYOYOYOYOYOYOYOYOYOYOYOYOYOYOYOYOYOYOYOYOYOYOYOYOYOYOYOYOYOYOYOYO
YOYOYOYOYOYOYOYOYOYOYOYOYOYOYOYOYOYOYOYOYOYOYOYOYOYOYOYOYOYOYOYOYOYOYOYOYOYOYOYOYOYOYOYOYOYOYOYOYOYOYOYOYOYOYOYOYOYOYOYOYOYOYOYOYOYOYOYOYOYOYOYOYOYOYO
YOYOYOYOYOYOYOYOYOYOYOYOYOYOYOYOYOYOYOYOYOYOYOYOYOYOYOYOYOYOYOYOYOYOYOYOYOYOYOYOYOYOYOYOYOYOYOYOYOYOYOYOYOYOYOYOYOYOYOYOYOYOYOYOYOYOYOYOYOYOYOYOYOYOYO
YOYOYOYOYOYOYOYOYOYOYOYOYOYOYOYOYOYOYOYOYOYOYOYOYOYOYOYOYOYOYOYOYOYOYOYOYOYOYOYOYOYOYOYOYOYOYOYOYOYOYOYOYOYOYOYOYOYOYOYOYOYOYOYOYOYOYOYOYOYOYOYOYOYOYO
YOYOYOYOYOYOYOYOYOYOYOYOYOYOYOYOYOYOYOYOYOYOYOYOYOYOYOYOYOYOYOYOYOYOYOYOYOYOYOYOYOYOYOYOYOYOYOYOYOYOYOYOYOYOYOYOYOYOYOYOYOYOYOYOYOYOYOYOYOYOYOYOYOYOYO
YOYOYOYOYOYOYOYOYOYOYOYOYOYOYOYOYOYOYOYOYOYOYOYOYOYOYOYOYOYOYOYOYOYOYOYOYOYOYOYOYOYOYOYOYOYOYOYOYOYOYOYOYOYOYOYOYOYOYOYOYOYOYOYOYOYOYOYOYOYOYOYOYOYOYO
YOYOYOYOYOYOYOYOYOYOYOYOYOYOYOYOYOYOYOYOYOYOYOYOYOYOYOYOYOYOYOYOYOYOYOYOYOYOYOYOYOYOYOYOYOYOYOYOYOYOYOYOYOYOYOYOYOYOYOYOYOYOYOYOYOYOYOYOYOYOYOYOYOYOYO
YOYOYOYOYOYOYOYOYOYOYOYOYOYOYOYOYOYOYOYOYOYOYOYOYOYOYOYOYOYOYOYOYOYOYOYOYOYOYOYOYOYOYOYOYOYOYOYOYOYOYOYOYOYOYOYOYOYOYOYOYOYOYOYOYOYOYOYOYOYOYOYOYOYOYO
YOYOYOYOYOYOYOYOYOYOYOYOYOYOYOYOYOYOYOYOYOYOYOYOYOYOYOYOYOYOYOYOYOYOYOYOYOYOYOYOYOYOYOYOYOYOYOYOYOYOYOYOYOYOYOYOYOYOYOYOYOYOYOYOYOYOYOYOYOYOYOYOYOYOYO
YOYOYOYOYOYOYOYOYOYOYOYOYOYOYOYOYOYOYOYOYOYOYOYOYOYOYOYOYOYOYOYOYOYOYOYOYOYOYOYOYOYOYOYOYOYOYOYOYOYOYOYOYOYOYOYOYOYOYOYOYOYOYOYOYOYOYOYOYOYOYOYOYOYOYO
YOYOYOYOYOYOYOYOYOYOYOYOYOYOYOYOYOYOYOYOYOYOYOYOYOYOYOYOYOYOYOYOYOYOYOYOYOYOYOYOYOYOYOYOYOYOYOYOYOYOYOYOYOYOYOYOYOYOYOYOYOYOYOYOYOYOYOYOYOYOYOYOYOYOYO
YOYOYOYOYOYOYOYOYOYOYOYOYOYOYOYOYOYOYOYOYOYOYOYOYOYOYOYOYOYOYOYOYOYOYOYOYOYOYOYOYOYOYOYOYOYOYOYOYOYOYOYOYOYOYOYOYOYOYOYOYOYOYOYOYOYOYOYOYOYOYOYOYOYOYO
YOYOYOYOYOYOYOYOYOYOYOYOYOYOYOYOYOYOYOYOYOYOYOYOYOYOYOYOYOYOYOYOYOYOYOYOYOYOYOYOYOYOYOYOYOYOYOYOYOYOYOYOYOYOYOYOYOYOYOYOYOYOYOYOYOYOYOYOYOYOYOYOYOYOYO
YOYOYOYOYOYOYOYOYOYOYOYOYOYOYOYOYOYOYOYOYOYOYOYOYOYOYOYOYOYOYOYOYOYOYOYOYOYOYOYOYOYOYOYOYOYOYOYOYOYOYOYOYOYOYOYOYOYOYOYOYOYOYOYOYOYOYOYOYOYOYOYOYOYOYO
YOYOYOYOYOYOYOYOYOYOYOYOYOYOYOYOYOYOYOYOYOYOYOYOYOYOYOYOYOYOYOYOYOYOYOYOYOYOYOYOYOYOYOYOYOYOYOYOYOYOYOYOYOYOYOYOYOYOYOYOYOYOYOYOYOYOYOYOYOYOYOYOYOYOYO
YOYOYOYOYOYOYOYOYOYOYOYOYOYOYOYOYOYOYOYOYOYOYOYOYOYOYOYOYOYOYOYOYOYOYOYOYOYOYOYOYOYOYOYOYOYOYOYOYOYOYOYOYOYOYOYOYOYOYOYOYOYOYOYOYOYOYOYOYOYOYOYOYOYOYO
YOYOYOYOYOYOYOYOYOYOYOYOYOYOYOYOYOYOYOYOYOYOYOYOYOYOYOYOYOYOYOYOYOYOYOYOYOYOYOYOYOYOYOYOYOYOYOYOYOYOYOYOYOYOYOYOYOYOYOYOYOYOYOYOYOYOYOYOYOYOYOYOYOYOYO
YOYOYOYOYOYOYOYOYOYOYOYOYOYOYOYOYOYOYOYOYOYOYOYOYOYOYOYOYOYOYOYOYOYOYOYOYOYOYOYOYOYOYOYOYOYOYOYOYOYOYOYOYOYOYOYOYOYOYOYOYOYOYOYOYOYOYOYOYOYOYOYOYOYOYO
YOYOYOYOYOYOYOYOYOYOYOYOYOYOYOYOYOYOYOYOYOYOYOYOYOYOYOYOYOYOYOYOYOYOYOYOYOYOYOYOYOYOYOYOYOYOYOYOYOYOYOYOYOYOYOYOYOYOYOYOYOYOYOYOYOYOYOYOYOYOYOYOYOYOYO
YOYOYOYOYOYOYOYOYOYOYOYOYOYOYOYOYOYOYOYOYOYOYOYOYOYOYOYOYOYOYOYOYOYOYOYOYOYOYOYOYOYOYOYOYOYOYOYOYOYOYOYOYOYOYOYOYOYOYOYOYOYOYOYOYOYOYOYOYOYOYOYOYOYOYO
iBYOYOYOYOYOYOYOYOYOYOYOYOYOYOYOYOYOYOYOYOYOYOYOYOYOYOYOYOYOYOYOYOYOYOYOYOYOYOYOYOYOYOYOYOYOYOYOYOYOYOYOYOYOYOYOYOYOYOYOYOYOYOYOYOYOYOYOYOYOYOYOYOYOYO
"}

(1,1,2) = {"
YOYOYOYOYOYOYOYOYOYOYOYOYOYOYOYOYOcldCdCdCdCArYOYOYOYOYOYOYOYOYOYOYOYOYOYOYOYOYOYOYOYOYOYOYOYOYOYOYOYOYOYOYOYOYOYOYOYOYOYOYOYOYOYOYOYOYOYOYOYOYOYOYOYO
YOYOYOYOYOYOYOYOYOYOYOYOYOYOYOYOYOpJDgxPxPDgeSknHjbwHjknwLknHjknHjknHjknHjknHjknHjknHjrudCJXdCArYOYOYOYOYOYOYOYOYOYOYOYOYOYOYOYOYOYOYOYOYOYOYOYOYOYOYO
YOYOYOYOYOYOYOYOYOYOYOYOYOYOYOYOYOpJWpxPxPDgeSppppppppeUppppppaappeUaappbRppbReUaappbRvhKfzNpWubArYOYOYOYOYOYOYOYOYOYOYOYOYOYOYOYOYOYOYOYOYOYOYOYOYOYO
YOYOYOYOYOYOYOYOYOYOYOYOYOYOYOYOYOpJqcxPxPxPEBpppppppppppppperppppppppppppppppppppppppvhxPxPxPxPEBXYYOYOYOYOYOYOYOYOYOYOYOYOYOYOYOYOYOYOYOYOYOYOYOYOYO
YOYOYOYOYOYOYOYOYOYOYOYOYOYOYOYOYOpJshxPxPxPMgppppQPppppppNEppppbRppppppQPppppppppppppMgxPxPvAtVEBXYXYXYYOYOYOYOYOYOYOYOYOYOYOYOYOYOYOYOYOYOYOYOYOYOYO
YOYOYOYOYOYOYOYOYOYOYOYOYOYOYOYOYOpJvIxPxPxPEBppppppppppppppppppppppppppppppbRppppppppvhxPxPxPxPEBXYYOYOYOYOYOYOYOYOYOYOYOYOYOYOYOYOYOYOYOYOYOYOYOYOYO
YOYOYOYOYOYOYOYOYOYOYOYOYOYOYOYOYOpJlnxPxPxPEBppppbRpppperabppbRppppabppppppppppabppbRTRwBKqjCwPceYOYOYOYOYOYOYOYOYOYOYOYOYOYOYOYOYOYOYOYOYOYOYOYOYOYO
YOYOYOYOYOYOYOYOYOYOYOYOYOYOYOYOYOpJlndOsEDgEBzbehzbehOOehzbehzbehOOehzbehzbehOOehzbehfmSPSPSPjDYOYOYOYOYOYOYOYOYOYOYOYOYOYOYOYOYOYOYOYOYOYOYOYOYOYOYO
YOYOYOYOYOYOYOYOYOYOYOYOYOYOYOYOYOPoSPSPSPSPQUYOYOYOYOYOYOYOYOYOYOYOYOYOYOYOYOYOYOYOYOYOYOYOYOYOYOYOYOYOYOYOYOYOYOYOYOYOYOYOYOYOYOYOYOYOYOYOYOYOYOYOYO
YOYOYOYOYOYOYOYOYOYOYOYOYOYOYOYOYOYOYOYOYOYOYOYOYOYOYOYOYOYOYOYOYOYOYOYOYOYOYOYOYOYOYOYOYOYOYOYOYOYOYOYOYOYOYOYOYOYOYOYOYOYOYOYOYOYOYOYOYOYOYOYOYOYOYO
YOYOYOYOYOYOYOYOYOYOYOYOYOYOYOYOYOYOYOYOYOYOYOYOYOYOYOYOYOYOYOYOYOYOYOYOYOYOYOYOYOYOYOYOYOYOYOYOYOYOYOYOYOYOYOYOYOYOYOYOYOYOYOYOYOYOYOYOYOYOYOYOYOYOYO
YOYOYOYOYOYOYOYOYOYOYOYOYOYOYOYOYOYOYOYOYOYOYOYOYOYOYOYOYOYOYOYOYOYOYOYOYOYOYOYOYOYOYOYOYOYOYOYOYOYOYOYOYOYOYOYOYOYOYOYOYOYOYOYOYOYOYOYOYOYOYOYOYOYOYO
YOYOYOYOYOYOYOYOYOYOYOYOYOYOYOYOYOYOYOYOYOYOYOYOYOYOYOYOYOYOYOYOYOYOYOYOYOYOYOYOYOYOYOYOYOYOYOYOYOYOYOYOYOYOYOYOYOYOYOYOYOYOYOYOYOYOYOYOYOYOYOYOYOYOYO
YOYOYOYOYOYOYOYOYOYOYOYOYOYOYOYOYOYOYOYOYOYOYOYOYOYOYOYOYOYOYOYOYOYOYOYOYOYOYOYOYOYOYOYOYOYOYOYOYOYOYOYOYOYOYOYOYOYOYOYOYOYOYOYOYOYOYOYOYOYOYOYOYOYOYO
YOYOYOYOYOYOYOYOYOYOYOYOYOYOYOYOYOYOYOYOYOYOYOYOYOYOYOYOYOYOYOYOYOYOYOYOYOYOYOYOYOYOYOYOYOYOYOYOYOYOYOYOYOYOYOYOYOYOYOYOYOYOYOYOYOYOYOYOYOYOYOYOYOYOYO
YOYOYOYOYOYOYOYOYOYOYOYOYOYOYOYOYOYOYOYOYOYOYOYOYOYOYOYOYOYOYOYOYOYOYOYOYOYOYOYOYOYOYOYOYOYOYOYOYOYOYOYOYOYOYOYOYOYOYOYOYOYOYOYOYOYOYOYOYOYOYOYOYOYOYO
YOYOYOYOYOYOYOYOYOYOYOYOYOYOYOYOYOYOYOYOYOYOYOYOYOYOYOYOYOYOYOYOYOYOYOYOYOYOYOYOYOYOYOYOYOYOYOYOYOYOYOYOYOYOYOYOYOYOYOYOYOYOYOYOYOYOYOYOYOYOYOYOYOYOYO
YOYOYOYOYOYOYOYOYOYOYOYOYOYOYOYOYOYOYOYOYOYOYOYOYOYOYOYOYOYOYOYOYOYOYOYOYOYOYOYOYOYOYOYOYOYOYOYOYOYOYOYOYOYOYOYOYOYOYOYOYOYOYOYOYOYOYOYOYOYOYOYOYOYOYO
YOYOYOYOYOYOYOYOYOYOYOYOYOYOYOYOYOYOYOYOYOYOYOYOYOYOYOYOYOYOYOYOYOYOYOYOYOYOYOYOYOYOYOYOYOYOYOYOYOYOYOYOYOYOYOYOYOYOYOYOYOYOYOYOYOYOYOYOYOYOYOYOYOYOYO
YOYOYOYOYOYOYOYOYOYOYOYOYOYOYOYOYOYOYOYOYOYOYOYOYOYOYOYOYOYOYOYOYOYOYOYOYOYOYOYOYOYOYOYOYOYOYOYOYOYOYOYOYOYOYOYOYOYOYOYOYOYOYOYOYOYOYOYOYOYOYOYOYOYOYO
YOYOYOYOYOYOYOYOYOYOYOYOYOYOYOYOYOYOYOYOYOYOYOYOYOYOYOYOYOYOYOYOYOYOYOYOYOYOYOYOYOYOYOYOYOYOYOYOYOYOYOYOYOYOYOYOYOYOYOYOYOYOYOYOYOYOYOYOYOYOYOYOYOYOYO
YOYOYOYOYOYOYOYOYOYOYOYOYOYOYOYOYOYOYOYOYOYOYOYOYOYOYOYOYOYOYOYOYOYOYOYOYOYOYOYOYOYOYOYOYOYOYOYOYOYOYOYOYOYOYOYOYOYOYOYOYOYOYOYOYOYOYOYOYOYOYOYOYOYOYO
YOYOYOYOYOYOYOYOYOYOYOYOYOYOYOYOYOYOYOYOYOYOYOYOYOYOYOYOYOYOYOYOYOYOYOYOYOYOYOYOYOYOYOYOYOYOYOYOYOYOYOYOYOYOYOYOYOYOYOYOYOYOYOYOYOYOYOYOYOYOYOYOYOYOYO
YOYOYOYOYOYOYOYOYOYOYOYOYOYOYOYOYOYOYOYOYOYOYOYOYOYOYOYOYOYOYOYOYOYOYOYOYOYOYOYOYOYOYOYOYOYOYOYOYOYOYOYOYOYOYOYOYOYOYOYOYOYOYOYOYOYOYOYOYOYOYOYOYOYOYO
YOYOYOYOYOYOYOYOYOYOYOYOYOYOYOYOYOYOYOYOYOYOYOYOYOYOYOYOYOYOYOYOYOYOYOYOYOYOYOYOYOYOYOYOYOYOYOYOYOYOYOYOYOYOYOYOYOYOYOYOYOYOYOYOYOYOYOYOYOYOYOYOYOYOYO
"}
