"aa" = (/turf/floor/beach/water/deep/saltwater,/area/caribbean/sea/bottom)
"ab" = (/obj/structure/barricade/ship/north/corners{dir = 1},/turf/floor/beach/water/deep/saltwater,/area/caribbean/sea/bottom/roofed)
"ae" = (/obj/structure/barricade/ship{dir = 1},/turf/floor/beach/water/deep/saltwater,/area/caribbean/sea/bottom/roofed)
"af" = (/obj/structure/barricade/ship{dir = 8},/turf/floor/beach/water/deep/saltwater,/area/caribbean/sea/bottom/roofed)
"ag" = (/obj/structure/barricade/ship/aport0/north,/turf/floor/beach/water/deep/saltwater,/area/caribbean/sea/bottom/roofed)
"ah" = (/obj/structure/barricade/ship/north/corners,/turf/floor/beach/water/deep/saltwater,/area/caribbean/sea/bottom/roofed)
"ai" = (/obj/covers/repairedfloor/ship,/obj/covers/wood_wall,/turf/floor/beach/water/deep/saltwater,/area/caribbean/sea/bottom/roofed)
"aj" = (/obj/covers/repairedfloor/ship,/obj/structure/closet/crate/chest,/obj/item/stack/money/goldvaluables,/obj/item/stack/money/goldvaluables,/obj/item/flashlight/lantern/on/anchored,/turf/floor/beach/water/deep/saltwater,/area/caribbean/sea/bottom/roofed)
"ak" = (/obj/covers/repairedfloor/ship,/turf/floor/beach/water/deep/saltwater,/area/caribbean/sea/bottom/roofed)
"am" = (/obj/covers/repairedfloor/ship,/obj/structure/closet/crate/chest,/obj/item/stack/money/goldvaluables,/obj/item/stack/money/goldvaluables,/turf/floor/beach/water/deep/saltwater,/area/caribbean/sea/bottom/roofed)
"an" = (/obj/covers/repairedfloor/ship,/mob/living/simple_animal/hostile/human/voyage/spanish,/turf/floor/beach/water/deep/saltwater,/area/caribbean/sea/bottom/roofed)
"ao" = (/obj/covers/repairedfloor/ship,/obj/item/weapon/reagent_containers/glass/barrel/tea,/turf/floor/beach/water/deep/saltwater,/area/caribbean/sea/bottom/roofed)
"ap" = (/obj/covers/repairedfloor/ship,/obj/item/weapon/reagent_containers/glass/barrel/gunpowder,/turf/floor/beach/water/deep/saltwater,/area/caribbean/sea/bottom/roofed)
"aq" = (/obj/covers/repairedfloor/ship,/obj/item/flashlight/lantern/on/anchored,/turf/floor/beach/water/deep/saltwater,/area/caribbean/sea/bottom/roofed)
"as" = (/obj/covers/repairedfloor/ship,/obj/structure/cannon/modern/tank/voyage/autofire{dir = 1; icon_state = "cannon"},/turf/floor/beach/water/deep/saltwater,/area/caribbean/sea/bottom/roofed)
"at" = (/obj/covers/repairedfloor/ship,/obj/item/weapon/reagent_containers/glass/barrel/rum,/turf/floor/beach/water/deep/saltwater,/area/caribbean/sea/bottom/roofed)
"au" = (/obj/covers/repairedfloor/ship,/obj/structure/grapplehook/auto,/obj/structure/cannon/modern/tank/voyage/autofire{dir = 1; icon_state = "cannon"},/turf/floor/beach/water/deep/saltwater,/area/caribbean/sea/bottom/roofed)
"av" = (/obj/covers/repairedfloor/ship,/obj/structure/closet/crate/grenades,/turf/floor/beach/water/deep/saltwater,/area/caribbean/sea/bottom/roofed)
"aw" = (/obj/covers/repairedfloor/ship,/mob/living/simple_animal/hostile/human/voyage/spanish/ranged/sgt,/turf/floor/beach/water/deep/saltwater,/area/caribbean/sea/bottom/roofed)
"ax" = (/obj/covers/repairedfloor/ship,/obj/structure/closet/crate/rations/biscuits,/turf/floor/beach/water/deep/saltwater,/area/caribbean/sea/bottom/roofed)
"ay" = (/obj/covers/repairedfloor/ship,/obj/structure/closet/crate/cannonball,/turf/floor/beach/water/deep/saltwater,/area/caribbean/sea/bottom/roofed)
"az" = (/obj/structure/barricade/ship/north/corners{dir = 4},/turf/floor/beach/water/deep/saltwater,/area/caribbean/sea/bottom/roofed)
"aA" = (/obj/covers/repairedfloor/ship,/obj/structure/table/wood,/obj/item/weapon/paper_bundle,/turf/floor/beach/water/deep/saltwater,/area/caribbean/sea/bottom/roofed)
"aB" = (/obj/covers/repairedfloor/ship,/obj/structure/simple_door/key_door/anyone,/obj/covers/repairedfloor/ship,/turf/floor/beach/water/deep/saltwater,/area/caribbean/sea/bottom/roofed)
"aC" = (/obj/covers/repairedfloor/ship,/obj/structure/closet/crate/musketball,/turf/floor/beach/water/deep/saltwater,/area/caribbean/sea/bottom/roofed)
"aD" = (/obj/structure/barricade/ship{dir = 4},/turf/floor/beach/water/deep/saltwater,/area/caribbean/sea/bottom/roofed)
"aE" = (/obj/structure/barricade/ship/wall2{dir = 8},/turf/floor/beach/water/deep/saltwater,/area/caribbean/sea/bottom/roofed)
"aF" = (/obj/structure/barricade/ship/north/corners{dir = 4},/obj/item/flashlight/lantern/on/anchored,/turf/floor/beach/water/deep/saltwater,/area/caribbean/sea/bottom/roofed)
"aH" = (/obj/covers/repairedfloor/ship,/mob/living/simple_animal/hostile/human/voyage/spanish/ranged,/turf/floor/beach/water/deep/saltwater,/area/caribbean/sea/bottom/roofed)
"aJ" = (/obj/covers/repairedfloor/ship,/obj/structure/table/wood,/turf/floor/beach/water/deep/saltwater,/area/caribbean/sea/bottom/roofed)
"aN" = (/obj/covers/repairedfloor/ship,/obj/structure/bed/hammock,/turf/floor/beach/water/deep/saltwater,/area/caribbean/sea/bottom/roofed)
"aO" = (/obj/covers/repairedfloor/ship,/obj/covers/wood_wall,/obj/item/flashlight/lantern/on/anchored,/turf/floor/beach/water/deep/saltwater,/area/caribbean/sea/bottom/roofed)
"aP" = (/obj/structure/barricade/ship{dir = 4},/obj/item/flashlight/lantern/on/anchored,/turf/floor/beach/water/deep/saltwater,/area/caribbean/sea/bottom/roofed)
"aQ" = (/obj/covers/repairedfloor/ship,/obj/structure/table/wood,/obj/item/weapon/pen,/turf/floor/beach/water/deep/saltwater,/area/caribbean/sea/bottom/roofed)
"aR" = (/obj/covers/repairedfloor/ship,/obj/item/weapon/reagent_containers/food/drinks/bottle/rum/empty,/turf/floor/beach/water/deep/saltwater,/area/caribbean/sea/bottom/roofed)
"aS" = (/obj/structure/barricade/ship,/turf/floor/beach/water/deep/saltwater,/area/caribbean/sea/bottom/roofed)
"aT" = (/obj/covers/repairedfloor/ship,/obj/structure/table/wood,/obj/item/weapon/paper,/turf/floor/beach/water/deep/saltwater,/area/caribbean/sea/bottom/roofed)
"aU" = (/obj/structure/multiz/ladder/ww2/up,/obj/covers/repairedfloor/ship,/turf/floor/beach/water/deep/saltwater,/area/caribbean/sea/bottom/roofed)
"aV" = (/obj/covers/repairedfloor/ship,/obj/item/weapon/reagent_containers/food/drinks/bottle/rum,/turf/floor/beach/water/deep/saltwater,/area/caribbean/sea/bottom/roofed)
"aW" = (/obj/covers/repairedfloor/ship,/obj/structure/vending/muskets/spanish,/turf/floor/beach/water/deep/saltwater,/area/caribbean/sea/bottom/roofed)
"aX" = (/obj/covers/repairedfloor/ship,/obj/structure/closet/crate/rations/fruits,/turf/floor/beach/water/deep/saltwater,/area/caribbean/sea/bottom/roofed)
"aY" = (/obj/covers/repairedfloor/ship,/obj/structure/closet/crate/wood,/turf/floor/beach/water/deep/saltwater,/area/caribbean/sea/bottom/roofed)
"aZ" = (/obj/covers/repairedfloor/ship,/obj/structure/simple_door/key_door/anyone,/turf/floor/beach/water/deep/saltwater,/area/caribbean/sea/bottom/roofed)
"ba" = (/obj/map_metadata/voyage,/turf/floor/beach/water/deep/saltwater,/area/caribbean/sea/bottom)
"bb" = (/obj/effect/landmark{name = "Grappling Hook area - do not block"},/turf/floor/beach/water/deep/saltwater,/area/caribbean/sea/bottom)
"bc" = (/obj/structure/barricade/ship/north/corners{dir = 8},/turf/floor/beach/water/deep/saltwater,/area/caribbean/sea/bottom/roofed)
"bd" = (/obj/covers/repairedfloor/ship,/mob/living/simple_animal/hostile/human/voyage/spanish,/turf/floor/broken_floor,/area/caribbean/sea/bottom/roofed)
"be" = (/obj/structure/barricade/ship/blue/beast,/obj/covers/repairedfloor/ship,/obj/structure/barricade/ship{dir = 4},/obj/item/flashlight/lantern/on/anchored,/turf/floor/beach/water/deep/saltwater,/area/caribbean/sea/bottom/roofed)
"bf" = (/obj/structure/barricade/ship/north/corners{dir = 1},/obj/item/flashlight/lantern/on/anchored,/turf/floor/beach/water/deep/saltwater,/area/caribbean/sea/bottom/roofed)
"bg" = (/obj/covers/repairedfloor/ship,/obj/structure/closet/crate/chest,/obj/item/stack/money/real/fifty,/obj/item/stack/money/real/fifty,/obj/item/stack/money/real/fifty,/obj/item/flashlight/lantern/on/anchored,/turf/floor/beach/water/deep/saltwater,/area/caribbean/sea/bottom/roofed)
"bh" = (/obj/structure/barricade/ship/wood/a6,/obj/covers/repairedfloor/ship,/obj/item/flashlight/lantern/on/anchored,/turf/floor/broken_floor,/area/caribbean/sea/bottom/roofed)
"bi" = (/obj/covers/repairedfloor/ship,/obj/structure/closet/crate/chest,/obj/item/stack/money/real/fifty,/obj/item/stack/money/real/fifty,/obj/item/stack/money/real/fifty,/turf/floor/beach/water/deep/saltwater,/area/caribbean/sea/bottom/roofed)
"bk" = (/obj/covers/repairedfloor/ship,/obj/structure/closet/crate/chest,/obj/item/stack/money/gems,/obj/item/stack/money/gems,/turf/floor/beach/water/deep/saltwater,/area/caribbean/sea/bottom/roofed)
"bl" = (/obj/covers/repairedfloor/ship,/obj/structure/closet/crate/chest,/obj/item/stack/money/pearls,/obj/item/stack/money/pearls,/obj/item/stack/money/pearls,/obj/item/flashlight/lantern/on/anchored,/turf/floor/beach/water/deep/saltwater,/area/caribbean/sea/bottom/roofed)
"bm" = (/obj/structure/barricade/ship/aport0,/obj/structure/cannon/modern/tank/voyage/autofire,/turf/floor/beach/water/deep/saltwater,/area/caribbean/sea/bottom/roofed)
"bn" = (/obj/structure/barricade/ship/wood/a4,/obj/covers/repairedfloor/ship,/turf/floor/broken_floor,/area/caribbean/sea/bottom/roofed)
"bo" = (/obj/structure/barricade/ship/wood/a7,/obj/covers/repairedfloor/ship,/turf/floor/broken_floor,/area/caribbean/sea/bottom/roofed)
"bp" = (/obj/covers/repairedfloor/ship,/obj/item/flashlight/lantern/on/anchored,/obj/structure/barricade/ship/wood/a2,/turf/floor/broken_floor,/area/caribbean/sea/bottom/roofed)
"bq" = (/obj/structure/barricade/ship/wood/a7,/obj/covers/repairedfloor/ship,/obj/item/flashlight/lantern/on/anchored,/turf/floor/broken_floor,/area/caribbean/sea/bottom/roofed)
"br" = (/obj/covers/repairedfloor/ship,/turf/floor/broken_floor,/area/caribbean/sea/bottom/roofed)
"bs" = (/obj/structure/barricade/ship/wood/a7,/obj/covers/repairedfloor/ship,/obj/structure/sign/painting2,/turf/floor/broken_floor,/area/caribbean/sea/bottom/roofed)
"bu" = (/obj/covers/repairedfloor/ship,/turf/floor/broken_floor,/area/caribbean/sea/bottom)
"bv" = (/obj/covers/repairedfloor/ship,/obj/covers/wood/stairs{dir = 8},/turf/floor/broken_floor,/area/caribbean/sea/bottom)
"bw" = (/obj/structure/barricade/ship/wood/a7,/turf/floor/broken_floor,/area/caribbean/sea/bottom/roofed)
"bx" = (/obj/structure/barricade/ship/wood/a12,/obj/covers/repairedfloor/ship,/obj/structure/barricade/ship/wood/a9,/turf/floor/broken_floor,/area/caribbean/sea/bottom/roofed)
"by" = (/obj/structure/window/barrier/ship/blue/bport_north,/obj/covers/repairedfloor/ship,/turf/floor/broken_floor,/area/caribbean/sea/bottom)
"bz" = (/obj/covers/repairedfloor/ship,/obj/structure/window/barrier/ship/wood/portl2,/obj/structure/window/barrier/ship/blue/bport_north,/turf/floor/broken_floor,/area/caribbean/sea/bottom)
"bA" = (/obj/covers/repairedfloor/ship,/obj/structure/window/barrier/ship/blue/bport_north,/turf/floor/broken_floor,/area/caribbean/sea/bottom)
"bB" = (/obj/covers/repairedfloor/ship,/mob/living/simple_animal/hostile/human/voyage/spanish/ranged/sgt,/turf/floor/broken_floor,/area/caribbean/sea/bottom)
"bC" = (/obj/covers/repairedfloor/ship/south,/obj/structure/window/barrier/ship/blue/bport3{dir = 1},/turf/floor/broken_floor,/area/caribbean/sea/bottom)
"bD" = (/obj/covers/repairedfloor/ship,/obj/structure/window/barrier/ship/blue/bport_north,/obj/effect/landmark{name = "Grappling Hook area - do not block"},/turf/floor/broken_floor,/area/caribbean/sea/bottom)
"bE" = (/obj/structure/window/barrier/ship/blue/bport3{dir = 1},/obj/covers/repairedfloor/ship/south,/turf/floor/broken_floor,/area/caribbean/sea/bottom)
"bG" = (/obj/structure/window/barrier/ship/wood/portl2,/obj/covers/repairedfloor/ship,/turf/floor/broken_floor,/area/caribbean/sea/bottom)
"bH" = (/obj/structure/window/barrier/ship/blue/bport_10,/obj/covers/repairedfloor/ship,/turf/floor/broken_floor,/area/caribbean/sea/bottom)
"bJ" = (/obj/covers/repairedfloor/ship,/mob/living/simple_animal/hostile/human/voyage/spanish/ranged,/turf/floor/broken_floor,/area/caribbean/sea/bottom)
"bK" = (/obj/structure/barricade/ship/blue/b2{opacity = 0},/obj/structure/window/classic,/obj/covers/repairedfloor/ship,/turf/floor/broken_floor,/area/caribbean/sea/bottom/roofed)
"bL" = (/obj/covers/repairedfloor/ship,/obj/structure/bed/chair/wood/red{dir = 4},/mob/living/simple_animal/hostile/human/voyage/spanish/ranged/cpt,/turf/floor/broken_floor,/area/caribbean/sea/bottom/roofed)
"bM" = (/obj/covers/repairedfloor/ship,/obj/structure/table/wood,/obj/structure/voyage/tablemap{dir = 4; layer = 2.9},/turf/floor/broken_floor,/area/caribbean/sea/bottom/roofed)
"bN" = (/obj/covers/repairedfloor/ship,/obj/structure/window/barrier/ship/wood/portl2,/turf/floor/broken_floor,/area/caribbean/sea/bottom)
"bO" = (/obj/structure/barricade/ship/blue/beast,/obj/covers/repairedfloor/ship,/turf/floor/broken_floor,/area/caribbean/sea/bottom)
"bP" = (/obj/covers/repairedfloor/ship,/obj/structure/table/wood,/obj/item/weapon/gun/projectile/flintlock/pistoletmodelean1733,/turf/floor/broken_floor,/area/caribbean/sea/bottom/roofed)
"bQ" = (/obj/covers/repairedfloor/ship,/obj/structure/table/wood,/turf/floor/broken_floor,/area/caribbean/sea/bottom)
"bS" = (/obj/covers/repairedfloor/ship,/obj/structure/table/wood,/turf/floor/broken_floor,/area/caribbean/sea/bottom/roofed)
"bT" = (/obj/covers/repairedfloor/ship,/obj/structure/flag/spanish,/obj/structure/barricade/ship/wood/a4,/turf/floor/broken_floor,/area/caribbean/sea/bottom/roofed)
"bU" = (/obj/structure/barricade/ship/wood/a6,/obj/covers/repairedfloor/ship,/turf/floor/broken_floor,/area/caribbean/sea/bottom/roofed)
"bV" = (/obj/structure/table/wood,/obj/covers/repairedfloor/ship,/turf/floor/broken_floor,/area/caribbean/sea/bottom)
"bW" = (/obj/covers/repairedfloor/ship,/mob/living/simple_animal/hostile/human/voyage/spanish,/turf/floor/broken_floor,/area/caribbean/sea/bottom)
"bX" = (/obj/structure/voyage/grid{dir = 10},/turf/floor/broken_floor,/area/caribbean/sea/bottom)
"bY" = (/obj/structure/voyage/grid{dir = 6},/turf/floor/broken_floor,/area/caribbean/sea/bottom)
"bZ" = (/obj/structure/barricade/ship/wood/a10,/obj/covers/repairedfloor/ship,/turf/floor/broken_floor,/area/caribbean/sea/bottom/roofed)
"ca" = (/obj/covers/repairedfloor/ship,/obj/structure/closet/crate/musketball_pistol,/turf/floor/broken_floor,/area/caribbean/sea/bottom/roofed)
"cb" = (/obj/covers/repairedfloor/ship,/obj/structure/voyage/ropeladder/thin{dir = 1},/obj/structure/cannon/modern/tank/voyage/autofire{dir = 1; icon_state = "cannon"},/turf/floor/broken_floor,/area/caribbean/sea/bottom)
"cc" = (/obj/covers/repairedfloor/ship,/obj/structure/grapplehook/auto,/turf/floor/broken_floor,/area/caribbean/sea/bottom)
"cd" = (/obj/covers/repairedfloor/ship,/obj/structure/cannon/modern/tank/voyage/autofire{dir = 1; icon_state = "cannon"},/turf/floor/broken_floor,/area/caribbean/sea/bottom)
"ce" = (/obj/covers/repairedfloor/ship,/obj/structure/grapplehook/auto,/obj/structure/voyage/ropeladder/thin{dir = 1},/obj/structure/cannon/modern/tank/voyage/autofire{dir = 1; icon_state = "cannon"},/turf/floor/broken_floor,/area/caribbean/sea/bottom)
"cf" = (/obj/covers/repairedfloor/ship,/obj/structure/flag/spanish,/obj/structure/barricade/ship/blue/b17,/turf/floor/broken_floor,/area/caribbean/sea/bottom/roofed)
"cg" = (/obj/structure/barricade/ship/blue/b20{dir = 2},/obj/covers/repairedfloor/ship,/turf/floor/broken_floor,/area/caribbean/sea/bottom/roofed)
"ch" = (/obj/covers/repairedfloor/ship,/obj/structure/voyage/ropeladder/thin{dir = 1},/turf/floor/broken_floor,/area/caribbean/sea/bottom)
"ci" = (/obj/structure/window/barrier/ship/blue/bport5/corner,/obj/covers/repairedfloor/ship,/turf/floor/broken_floor,/area/caribbean/sea/bottom)
"cj" = (/obj/covers/repairedfloor/ship,/obj/structure/barricade/ship/wood/a2,/turf/floor/broken_floor,/area/caribbean/sea/bottom/roofed)
"ck" = (/obj/covers/repairedfloor/ship,/obj/structure/barricade/ship/blue/b17,/turf/floor/broken_floor,/area/caribbean/sea/bottom/roofed)
"cl" = (/obj/covers/repairedfloor/ship,/obj/structure/table/wood,/obj/item/weapon/reagent_containers/food/drinks/bottle/rum,/turf/floor/broken_floor,/area/caribbean/sea/bottom/roofed)
"cm" = (/obj/covers/repairedfloor/ship,/obj/structure/table/wood,/obj/structure/voyage/sextant,/turf/floor/broken_floor,/area/caribbean/sea/bottom/roofed)
"cn" = (/obj/covers/repairedfloor/ship,/obj/structure/table/wood,/obj/item/weapon/attachment/scope/adjustable/binoculars,/turf/floor/broken_floor,/area/caribbean/sea/bottom)
"co" = (/obj/covers/repairedfloor/ship,/mob/living/simple_animal/hostile/human/voyage/spanish/ranged/lt,/turf/floor/broken_floor,/area/caribbean/sea/bottom/roofed)
"cp" = (/obj/structure/simple_door/key_door/anyone/wood,/obj/covers/repairedfloor/ship,/turf/floor/broken_floor,/area/caribbean/sea/bottom/roofed)
"cq" = (/obj/structure/multiz/ladder/ww2{area_id = "b1"},/obj/covers/repairedfloor/ship,/turf/floor/broken_floor,/area/caribbean/sea/bottom)
"cr" = (/obj/structure/voyage/grid{dir = 9},/turf/floor/broken_floor,/area/caribbean/sea/bottom)
"cs" = (/obj/structure/voyage/grid{dir = 5},/turf/floor/broken_floor,/area/caribbean/sea/bottom)
"ct" = (/obj/covers/repairedfloor/ship,/obj/structure/barricade/ship/mast/large,/obj/item/flashlight/lantern/on/anchored,/turf/floor/broken_floor,/area/caribbean/sea/bottom)
"cu" = (/obj/structure/barricade/ship/blue/beast,/obj/covers/repairedfloor/ship,/obj/structure/flag/spanish,/turf/floor/broken_floor,/area/caribbean/sea/bottom)
"cw" = (/obj/covers/repairedfloor/ship,/obj/structure/sign/painting3,/obj/item/flashlight/lantern/on/anchored,/obj/structure/barricade/ship/wood/a2,/turf/floor/broken_floor,/area/caribbean/sea/bottom/roofed)
"cy" = (/obj/covers/repairedfloor/ship,/obj/structure/bed/padded,/obj/item/weapon/bedsheet/brown,/turf/floor/broken_floor,/area/caribbean/sea/bottom/roofed)
"cz" = (/obj/structure/window/barrier/ship/blue/bport_6/corner,/obj/covers/repairedfloor/ship,/turf/floor/broken_floor,/area/caribbean/sea/bottom)
"cA" = (/obj/structure/window/barrier/ship/blue/bport9,/obj/covers/repairedfloor/ship,/turf/floor/broken_floor,/area/caribbean/sea/bottom)
"hP" = (/obj/structure/barricade/ship/blue/b9,/obj/covers/repairedfloor/ship,/turf/floor/broken_floor,/area/caribbean/sea/bottom/roofed)
"lk" = (/obj/structure/voyage/grid{dir = 4},/turf/floor/broken_floor,/area/caribbean/sea/bottom)
"og" = (/obj/covers/repairedfloor/ship,/obj/structure/cannon/modern/tank/voyage/autofire,/obj/structure/window/barrier/ship/blue/bport3,/turf/floor/broken_floor,/area/caribbean/sea/bottom)
"oR" = (/obj/structure/window/barrier/ship/blue/bport0,/obj/covers/repairedfloor/ship,/turf/floor/broken_floor,/area/caribbean/sea/bottom)
"sH" = (/obj/covers/repairedfloor/ship,/obj/structure/window/barrier/ship/blue/bport3,/obj/structure/cannon/modern/tank/voyage/autofire,/turf/floor/broken_floor,/area/caribbean/sea/bottom)
"tW" = (/obj/covers/repairedfloor/ship,/obj/structure/closet/cabinet,/turf/floor/broken_floor,/area/caribbean/sea/bottom/roofed)
"uR" = (/obj/structure/ship_bow,/turf/floor/beach/water/deep/saltwater,/area/caribbean/sea/bottom)
"EU" = (/obj/structure/voyage/grid/middle,/turf/floor/broken_floor,/area/caribbean/sea/bottom)
"Ht" = (/obj/covers/repairedfloor/ship,/obj/structure/window/barrier/ship/wood/portl2,/obj/structure/window/barrier/ship/blue/bport0,/turf/floor/broken_floor,/area/caribbean/sea/bottom)
"Hx" = (/obj/structure/voyage/grid{dir = 8},/turf/floor/broken_floor,/area/caribbean/sea/bottom)
"Op" = (/obj/structure/barricade/ship/blue/b9,/obj/covers/repairedfloor/ship,/obj/item/flashlight/lantern/on/anchored,/turf/floor/broken_floor,/area/caribbean/sea/bottom/roofed)
"Pa" = (/obj/structure/barricade/ship/blue/b8,/turf/floor/broken_floor,/area/caribbean/sea/bottom/roofed)
"PZ" = (/obj/structure/window/barrier/ship/blue/bport3,/obj/covers/repairedfloor/ship,/obj/structure/cannon/modern/tank/voyage/autofire,/turf/floor/broken_floor,/area/caribbean/sea/bottom)
"QO" = (/obj/structure/window/barrier/ship/blue/bport3,/obj/covers/repairedfloor/ship,/obj/structure/voyage/ropeladder/thin,/obj/structure/cannon/modern/tank/voyage/autofire,/turf/floor/broken_floor,/area/caribbean/sea/bottom)
"RZ" = (/obj/covers/repairedfloor/ship,/obj/structure/window/barrier/ship/blue/bport0,/turf/floor/broken_floor,/area/caribbean/sea/bottom)
"Tm" = (/obj/structure/window/barrier/ship/blue/bport0,/obj/covers/repairedfloor/ship,/obj/structure/voyage/ropeladder/thin,/turf/floor/broken_floor,/area/caribbean/sea/bottom)
"Yw" = (/obj/structure/voyage/grid,/turf/floor/broken_floor,/area/caribbean/sea/bottom)
"YG" = (/obj/structure/voyage/grid{dir = 1},/turf/floor/broken_floor,/area/caribbean/sea/bottom)

(1,1,1) = {"
aaaaaaaaaaaaaaaaaaaaaaaaaaaaaaaaaaaaaaaaaaaaaaaaaaaaaaaaaaaaaaaaaaaaaaaaaaaaaaaaaaaaaaaaaaaaaaaaaaaaaaaaaaaaaaaaaaaaaaaaaaaaaaaaaaaaaaaaaaaaaaaaaaaaaa
aaaaaaaaaaaaaaaaaaaaaaaaaaaaaaaaaaaaaaaaaaaaaaaaaaaaaaaaaaaaaaaaaaaaaaaaaaaaaaaaaaaaaaaaaaaaaaaaaaaaaaaaaaaaaaaaaaaaaaaaaaaaaaaaaaaaaaaaaaaaaaaaaaaaaa
aaaaaaaaaaaaaaaaaaaaaaabaeaeaeaeaeaeaeaeaeaeaeaeagaeaeagaeaeagaeaeagaeaeagaeaeagaeaeagaeaeagaeaeaeaeahaaaaaaaaaaaaaaaaaaaaaaaaaaaaaaaaaaaaaaaaaaaaaaaa
aaaaaaaaaaaaaaaaaaaaaaafajamamamamamajaiaoaoakaqasakakasakakasakaqauakakasaqakasakakasakakasaqavaiapazahaaaaaaaaaaaaaaaaaaaaaaaaaaaaaaaaaaaaaaaaaaaaaa
aaaaaaaaaaaaaaaaaaaaaaafakakakakakakakaiakakakakakakanakakakakanakakakakakanakakanakakanakanakakaiapapaFahaaaaaaaaaaaaaaaaaaaaaaaaaaaaaaaaaaaaaaaaaaaa
aaaaaaaaaaaaaaaaaaaaaaafakakakakakakakaiakakakakakakakakakakakakakanakakakawakakaHakakakakakakakaiapapapazahaaaaaaaaaaaaaaaaaaaaaaaaaaaaaaaaaaaaaaaaaa
aaaaaaaaaaaaaaaaaaaaaaafaJaJaJakaHakakaiakakakakaNakaNakaNakaNakaNakaNakaNakaNakaNakaNakaNakanakaiakakakayaPahaaaaaaaaaaaaaaaaaaaaaaaaaaaaaaaaaaaaaaaa
aaaaaaaaaaaaaaaaaaaaaaafakakaQakakakakaOakakakakakakakakakakakakakakakaRakakakakakakakakakakakakaOakakakayaDaEahaaaaaaaaaaaaaaaaaaaaaaaaaaaaaaaaaaaaaa
aaaaaaaaaaaaaaaaaaaaaaafakawaTakakakakaBakakaUakaxaxaVakakaCaCaWaWaWaWaCaCakaHaxaxaXaXakaYaYakakaZakakakayaDaEaDaaaaaaaaaaaaaaaaaaaaaaaaaaaaaaaaaaaaaa
aaaaaaaaaaaaaaaaaaaaaaafakakaAakanakakaBakakaUakaxaxakanakaCaCaWaWaWaWaCaCakakaxaxaXaXakaYaYakakaZakakakayaDaEaDaaaaaaaaaaaaaaaaaaaaaaaaaaaaaaaaaaaaaa
aaaaaaaaaaaaaaaaaaaaaaafakakakakakakakaOakakakakakakakakakakakakakakakakakakakakakakakakakakakakaOakakakayaDaEbcaaaaaaaaaaaaaaaaaaaaaaaaaaaaaaaaaaaaaa
aaaaaaaaaaaaaaaaaaaaaaafakakakakakakakaiakakakakaNakaNakaNakaNakaNakaNakaNakaNakaNakaNakaNakakakaiakakakaybebcaaaaaaaaaaaaaaaaaaaaaaaaaaaaaaaaaaaaaaaa
aaaaaaaaaaaaaaaaaaaaaaafakakakanakakakaiakakanakakakakaHakakakakanakakakakakakakanakakakakakakakaiaYaYaYabbcaaaaaaaaaaaaaaaaaaaaaaaaaaaaaaaaaaaaaaaaaa
aaaaaaaaaaaaaaaaaaaaaaafakakakakakakakaiatatatakakakakakanakakakakakakanakakanakakakakakanakakakaiapapbfbcaaaaaaaaaaaaaaaaaaaaaaaaaaaaaaaaaaaaaaaaaaaa
aaaaaaaaaaaaaaaaaaaaaaafbgbibibibibkblaiatatataqakakakakakakakakaqakakakakaqakakakakakakakakaqavaiapabbcaaaaaaaaaaaaaaaaaaaaaaaaaaaaaaaaaaaaaaaaaaaaaa
aaaaaaaaaaaaaaaaaaaaaaazaSaSaSaSaSaSaSaSaSaSaSaSbmaSaSbmaSaSbmaSaSbmaSaSbmaSaSbmaSaSbmaSaSbmaSaSaSaSbcaaaaaaaaaaaaaaaaaaaaaaaaaaaaaaaaaaaaaaaaaaaaaaaa
aaaaaaaaaaaaaaaaaaaaaaaaaaaaaaaaaaaaaaaaaaaaaaaaaaaaaaaaaaaaaaaaaaaaaaaaaaaaaaaaaaaaaaaaaaaaaaaaaaaaaaaaaaaaaaaaaaaaaaaaaaaaaaaaaaaaaaaaaaaaaaaaaaaaaa
aaaaaaaaaaaaaaaaaaaaaaaaaaaaaaaaaaaaaaaaaaaaaaaaaaaaaaaaaaaaaaaaaaaaaaaaaaaaaaaaaaaaaaaaaaaaaaaaaaaaaaaaaaaaaaaaaaaaaaaaaaaaaaaaaaaaaaaaaaaaaaaaaaaaaa
aaaaaaaaaaaaaaaaaaaaaaaaaaaaaaaaaaaaaaaaaaaaaaaaaaaaaaaaaaaaaaaaaaaaaaaaaaaaaaaaaaaaaaaaaaaaaaaaaaaaaaaaaaaaaaaaaaaaaaaaaaaaaaaaaaaaaaaaaaaaaaaaaaaaaa
aaaaaaaaaaaaaaaaaaaaaaaaaaaaaaaaaaaaaaaaaaaaaaaaaaaaaaaaaaaaaaaaaaaaaaaaaaaaaaaaaaaaaaaaaaaaaaaaaaaaaaaaaaaaaaaaaaaaaaaaaaaaaaaaaaaaaaaaaaaaaaaaaaaaaa
aaaaaaaaaaaaaaaaaaaaaaaaaaaaaaaaaaaaaaaaaaaaaaaaaaaaaaaaaaaaaaaaaaaaaaaaaaaaaaaaaaaaaaaaaaaaaaaaaaaaaaaaaaaaaaaaaaaaaaaaaaaaaaaaaaaaaaaaaaaaaaaaaaaaaa
aaaaaaaaaaaaaaaaaaaaaaaaaaaaaaaaaaaaaaaaaaaaaaaaaaaaaaaaaaaaaaaaaaaaaaaaaaaaaaaaaaaaaaaaaaaaaaaaaaaaaaaaaaaaaaaaaaaaaaaaaaaaaaaaaaaaaaaaaaaaaaaaaaaaaa
aaaaaaaaaaaaaaaaaaaaaaaaaaaaaaaaaaaaaaaaaaaaaaaaaaaaaaaaaaaaaaaaaaaaaaaaaaaaaaaaaaaaaaaaaaaaaaaaaaaaaaaaaaaaaaaaaaaaaaaaaaaaaaaaaaaaaaaaaaaaaaaaaaaaaa
aaaaaaaaaaaaaaaaaaaaaaaaaaaaaaaaaaaaaaaaaaaaaaaaaaaaaaaaaaaaaaaaaaaaaaaaaaaaaaaaaaaaaaaaaaaaaaaaaaaaaaaaaaaaaaaaaaaaaaaaaaaaaaaaaaaaaaaaaaaaaaaaaaaaaa
baaaaaaaaaaaaaaaaaaaaaaaaaaaaaaaaaaaaaaaaaaaaaaaaaaaaaaaaaaaaaaaaaaaaaaaaaaaaaaaaaaaaaaaaaaaaaaaaaaaaaaaaaaaaaaaaaaaaaaaaaaaaaaaaaaaaaaaaaaaaaaaaaaaaa
"}
(1,1,2) = {"
aaaaaaaaaaaaaaaaaaaaaaaaaaaaaaaaaaaaaaaaaaaaaaaaaaaaaaaabbaaaaaaaaaaaabbaaaaaaaaaaaaaaaaaaaaaaaaaaaaaaaaaaaaaaaaaaaaaaaaaaaaaaaaaaaaaaaaaaaaaaaaaaaaaa
aaaaaaaaaaaaaaaaaaaaaaaaaaaaaaaaaaaaaaaaaaaaaaaaaaaaaaaabbaaaaaaaaaaaabbaaaaaaaaaaaaaaaaaaaaaaaaaaaaaaaaaaaaaaaaaaaaaaaaaaaaaaaaaaaaaaaaaaaaaaaaaaaaaa
aaaaaaaaaaaaaaaaaaaaaabnbobqbsbobwbqbxbybybzbAbAbCbAbAbCbDbAbCbAbAbCbAbDbEbAbAbEbAbAbEbAbAbEbAbAbAbAbHaaaaaaaaaaaaaaaaaaaaaaaaaaaaaaaaaaaaaaaaaaaaaaaa
aaaaaaaaaaaaaaaaaaaabTbZbrbrbrbrbrcabUbububGbubucbbucccdbJbucdbubuceccbucdbJbucdchbucdccbucdbubBbubucibHaaaaaaaaaaaaaaaaaaaaaaaaaaaaaaaaaaaaaaaaaaaaaa
aaaaaaaaaaaaaaaaaaaacjbrbrbrbrbdbrbrbhbububvbububububububububububububububububububububububububububububucibHaaaaaaaaaaaaaaaaaaaaaaaaaaaaaaaaaaaaaaaaaaaa
aaaaaaaaaaaaaaaaaaaabpbrbrbrbrbrbrbrbUbububvbububububububububububububububububububBbububububububububWbubucibHaaaaaaaaaaaaaaaaaaaaaaaaaaaaaaaaaaaaaaaaaa
aaaaaaaaaaaaaaaaaaaabKbrbrbSclbrbrbrbUbububNbububWbubububububububububububububububububububJbububububububububOaaaaaaaaaaaaaaaaaaaaaaaaaaaaaaaaaaaaaaaaaa
aaaaaaaaaaaaaaaaaaaabKbrbrbrcmbrbrbrbUbucnbNbububububJbubububububububWbubububububububububububWbububububububOaaaaaaaaaaaaaaaaaaaaaaaaaaaaaaaaaaaaaaaaaa
aaaaaaaaaaaaaaaaaaaabKbrbrbLbMbrcobrcpbubQbNcqbubububububucrYGcsbubububububububububububububububububububJbubOaaaaaaaaaaaaaaaaaaaaaaaaaaaaaaaaaaaaaaaaaa
aaaaaaaaaaaaaaaaaaaabKbrbrbrbPbrbrbrcpbubQbNcqbuctbubububuHxEUlkbuctbubWbubububuctbubWbubububububububububucuaaaaaaaaaaaaaaaaaaaaaaaaaaaaaaaaaaaaaaaaaa
aaaaaaaaaaaaaaaaaaaabKbrbrbSbSbrbrbrbUbubVbNbubububububububXYwbYbubububububJbubububububububububububububububOaaaaaaaaaaaaaaaaaaaaaaaaaaaaaaaaaaaaaaaaaa
aaaaaaaaaaaaaaaaaaaabKbrbrbrbrbrbrbrbhbububNbWbububububububububububububububububububububububububububububububOaaaaaaaaaaaaaaaaaaaaaaaaaaaaaaaaaaaaaaaaaa
aaaaaaaaaaaaaaaaaaaacwcybrbrbrbrbrbrbUbububvbububububububWbubububububububububububWbububububububWbubububuczcAuRaaaaaaaaaaaaaaaaaaaaaaaaaaaaaaaaaaaaaaaa
aaaaaaaaaaaaaaaaaaaacjtWbrbrbdbrbrbSbUbububvbububububububububububububububububububububububububububububuczcAaaaaaaaaaaaaaaaaaaaaaaaaaaaaaaaaaaaaaaaaaaaa
aaaaaaaaaaaaaaaaaaaacfcgbrbrbrbrbrbSbUbububGbBbububuccbubJbubububBbuccbububJbububububuccbububBbububuczcAaaaaaaaaaaaaaaaaaaaaaaaaaaaaaaaaaaaaaaaaaaaaaa
aaaaaaaaaaaaaaaaaaaaaackhPOphPhPhPOpPaRZRZHtoRoRQOoRoRPZoRoRPZoRoRQOoRoRPZoRoRsHTmoRsHoRoRogoRoRoRoRcAaaaaaaaaaaaaaaaaaaaaaaaaaaaaaaaaaaaaaaaaaaaaaaaa
aaaaaaaaaaaaaaaaaaaaaaaaaaaaaaaaaaaaaaaaaaaaaaaaaaaaaaaaaaaaaaaaaaaaaaaaaaaaaaaaaaaaaaaaaaaaaaaaaaaaaaaaaaaaaaaaaaaaaaaaaaaaaaaaaaaaaaaaaaaaaaaaaaaaaa
aaaaaaaaaaaaaaaaaaaaaaaaaaaaaaaaaaaaaaaaaaaaaaaaaaaaaaaaaaaaaaaaaaaaaaaaaaaaaaaaaaaaaaaaaaaaaaaaaaaaaaaaaaaaaaaaaaaaaaaaaaaaaaaaaaaaaaaaaaaaaaaaaaaaaa
aaaaaaaaaaaaaaaaaaaaaaaaaaaaaaaaaaaaaaaaaaaaaaaaaaaaaaaaaaaaaaaaaaaaaaaaaaaaaaaaaaaaaaaaaaaaaaaaaaaaaaaaaaaaaaaaaaaaaaaaaaaaaaaaaaaaaaaaaaaaaaaaaaaaaa
aaaaaaaaaaaaaaaaaaaaaaaaaaaaaaaaaaaaaaaaaaaaaaaaaaaaaaaaaaaaaaaaaaaaaaaaaaaaaaaaaaaaaaaaaaaaaaaaaaaaaaaaaaaaaaaaaaaaaaaaaaaaaaaaaaaaaaaaaaaaaaaaaaaaaa
aaaaaaaaaaaaaaaaaaaaaaaaaaaaaaaaaaaaaaaaaaaaaaaaaaaaaaaaaaaaaaaaaaaaaaaaaaaaaaaaaaaaaaaaaaaaaaaaaaaaaaaaaaaaaaaaaaaaaaaaaaaaaaaaaaaaaaaaaaaaaaaaaaaaaa
aaaaaaaaaaaaaaaaaaaaaaaaaaaaaaaaaaaaaaaaaaaaaaaaaaaaaaaaaaaaaaaaaaaaaaaaaaaaaaaaaaaaaaaaaaaaaaaaaaaaaaaaaaaaaaaaaaaaaaaaaaaaaaaaaaaaaaaaaaaaaaaaaaaaaa
aaaaaaaaaaaaaaaaaaaaaaaaaaaaaaaaaaaaaaaaaaaaaaaaaaaaaaaaaaaaaaaaaaaaaaaaaaaaaaaaaaaaaaaaaaaaaaaaaaaaaaaaaaaaaaaaaaaaaaaaaaaaaaaaaaaaaaaaaaaaaaaaaaaaaa
aaaaaaaaaaaaaaaaaaaaaaaaaaaaaaaaaaaaaaaaaaaaaaaaaaaaaaaaaaaaaaaaaaaaaaaaaaaaaaaaaaaaaaaaaaaaaaaaaaaaaaaaaaaaaaaaaaaaaaaaaaaaaaaaaaaaaaaaaaaaaaaaaaaaaa
aaaaaaaaaaaaaaaaaaaaaaaaaaaaaaaaaaaaaaaaaaaaaaaaaaaaaaaaaaaaaaaaaaaaaaaaaaaaaaaaaaaaaaaaaaaaaaaaaaaaaaaaaaaaaaaaaaaaaaaaaaaaaaaaaaaaaaaaaaaaaaaaaaaaaa
"}
