"aa" = (/turf/floor/beach/water/deep/saltwater,/area/caribbean/sea/bottom)
"ab" = (/obj/structure/barricade/ship/north/corners{dir = 9; icon_state = "boat1_up_corners"},/obj/item/flashlight/lantern/on/anchored,/turf/floor/beach/water/deep/saltwater,/area/caribbean/sea/bottom/roofed)
"ac" = (/obj/structure/barricade/ship/wall2{dir = 2; icon_state = "boat2"},/obj/item/flashlight/lantern/on/anchored,/turf/floor/beach/water/deep/saltwater,/area/caribbean/sea/bottom/roofed)
"ad" = (/obj/covers/repairedfloor/ship,/obj/structure/cannon/modern/tank/voyage/autofire{dir = 1; icon_state = "cannon"},/turf/floor/beach/water/deep/saltwater,/area/caribbean/sea/bottom/roofed)
"ae" = (/obj/structure/barricade/ship/north/corners{dir = 5; icon_state = "boat1_up_corners"},/turf/floor/beach/water/deep/saltwater,/area/caribbean/sea/bottom/roofed)
"af" = (/obj/structure/barricade/ship/north/corners,/turf/floor/beach/water/deep/saltwater,/area/caribbean/sea/bottom/roofed)
"ag" = (/obj/covers/repairedfloor/ship,/obj/structure/closet/crate/chest,/obj/item/stack/money/doubloon/ten,/obj/item/stack/money/doubloon/ten,/turf/floor/beach/water/deep/saltwater,/area/caribbean/sea/bottom/roofed)
"ah" = (/obj/structure/barricade/ship{dir = 2; icon_state = "boat1"},/turf/floor/beach/water/deep/saltwater,/area/caribbean/sea/bottom/roofed)
"ai" = (/obj/structure/barricade/ship,/turf/floor/beach/water/deep/saltwater,/area/caribbean/sea/bottom/roofed)
"aj" = (/obj/covers/repairedfloor/ship,/turf/floor/beach/water/deep/saltwater,/area/caribbean/sea/bottom/roofed)
"ak" = (/obj/covers/repairedfloor/ship,/mob/living/simple_animal/hostile/human/voyage/spanish/ranged,/turf/floor/beach/water/deep/saltwater,/area/caribbean/sea/bottom/roofed)
"al" = (/obj/covers/repairedfloor/ship,/obj/structure/simple_door/key_door/anyone/ship,/turf/floor/beach/water/deep/saltwater,/area/caribbean/sea/bottom/roofed)
"am" = (/obj/structure/barricade/ship/aport1/north,/turf/floor/beach/water/deep/saltwater,/area/caribbean/sea/bottom/roofed)
"an" = (/obj/structure/barricade/ship/north/corners{dir = 2; icon_state = "boat1_up_corners"},/turf/floor/beach/water/deep/saltwater,/area/caribbean/sea/bottom/roofed)
"ao" = (/obj/covers/repairedfloor/ship,/obj/structure/table/wood,/obj/item/stack/medical/advanced/bruise_pack,/obj/item/stack/medical/advanced/bruise_pack,/obj/item/stack/medical/advanced/bruise_pack,/turf/floor/beach/water/deep/saltwater,/area/caribbean/sea/bottom/roofed)
"ap" = (/obj/structure/barricade/ship/wall2{dir = 2; icon_state = "boat2"},/turf/floor/beach/water/deep/saltwater,/area/caribbean/sea/bottom/roofed)
"aq" = (/obj/structure/barricade/ship/north/corners{dir = 6; icon_state = "boat1_up_corners"},/turf/floor/beach/water/deep/saltwater,/area/caribbean/sea/bottom/roofed)
"ar" = (/obj/covers/repairedfloor/ship,/obj/structure/bed/hammock,/turf/floor/beach/water/deep/saltwater,/area/caribbean/sea/bottom/roofed)
"as" = (/obj/covers/repairedfloor/ship,/obj/structure/vending/craftable/rifles/wood/filled_musket_spanish,/turf/floor/beach/water/deep/saltwater,/area/caribbean/sea/bottom/roofed)
"at" = (/obj/covers/repairedfloor/ship,/obj/structure/table/wood,/obj/item/stack/medical/advanced/ointment,/obj/item/stack/medical/advanced/ointment,/obj/item/stack/medical/advanced/ointment,/turf/floor/beach/water/deep/saltwater,/area/caribbean/sea/bottom/roofed)
"au" = (/obj/structure/barricade/ship{dir = 8; icon_state = "boat1"},/turf/floor/beach/water/deep/saltwater,/area/caribbean/sea/bottom/roofed)
"av" = (/obj/structure/multiz/ladder/ww2/up,/obj/covers/repairedfloor/ship,/turf/floor/beach/water/deep/saltwater,/area/caribbean/sea/bottom/roofed)
"aw" = (/obj/covers/repairedfloor/ship,/mob/living/simple_animal/hostile/human/voyage/spanish,/turf/floor/beach/water/deep/saltwater,/area/caribbean/sea/bottom/roofed)
"ax" = (/obj/covers/repairedfloor/ship,/obj/structure/table/wood,/turf/floor/beach/water/deep/saltwater,/area/caribbean/sea/bottom/roofed)
"ay" = (/obj/covers/repairedfloor/ship,/obj/structure/table/wood/flipped{dir = 4},/mob/living/simple_animal/hostile/human/voyage/spanish/ranged,/turf/floor/beach/water/deep/saltwater,/area/caribbean/sea/bottom/roofed)
"az" = (/obj/covers/repairedfloor/ship,/obj/structure/voyage/ropeladder/thin{dir = 1; icon_state = "ropeladder_thin"},/turf/floor/beach/water/deep/saltwater,/area/caribbean/sea/bottom/roofed)
"aA" = (/obj/covers/repairedfloor/ship,/obj/structure/table/wood,/obj/item/stack/medical/advanced/bruise_pack,/obj/item/stack/medical/advanced/bruise_pack,/obj/item/stack/medical/advanced/bruise_pack,/obj/item/stack/medical/advanced/bruise_pack,/turf/floor/beach/water/deep/saltwater,/area/caribbean/sea/bottom/roofed)
"aB" = (/obj/structure/barricade/ship{dir = 4; icon_state = "boat1"},/turf/floor/beach/water/deep/saltwater,/area/caribbean/sea/bottom/roofed)
"aC" = (/obj/covers/repairedfloor/ship,/obj/structure/closet/crate/rations/beer,/turf/floor/beach/water/deep/saltwater,/area/caribbean/sea/bottom/roofed)
"aD" = (/obj/covers/repairedfloor/ship,/obj/structure/closet/crate/rations/ale,/turf/floor/beach/water/deep/saltwater,/area/caribbean/sea/bottom/roofed)
"aE" = (/obj/covers/repairedfloor/ship,/obj/structure/closet/crate/rations/biscuits,/turf/floor/beach/water/deep/saltwater,/area/caribbean/sea/bottom/roofed)
"aF" = (/obj/covers/repairedfloor/ship,/obj/structure/closet/crate/rations/fruits,/turf/floor/beach/water/deep/saltwater,/area/caribbean/sea/bottom/roofed)
"aG" = (/obj/covers/repairedfloor/ship,/obj/structure/closet/crate/rations/vegetables,/turf/floor/beach/water/deep/saltwater,/area/caribbean/sea/bottom/roofed)
"aH" = (/obj/covers/repairedfloor/ship,/obj/structure/closet/crate/musketball,/turf/floor/beach/water/deep/saltwater,/area/caribbean/sea/bottom/roofed)
"aI" = (/obj/covers/repairedfloor/ship,/obj/structure/closet/crate/musketball_pistol,/turf/floor/beach/water/deep/saltwater,/area/caribbean/sea/bottom/roofed)
"aJ" = (/obj/covers/repairedfloor/ship,/obj/structure/closet/crate/cannonball,/turf/floor/beach/water/deep/saltwater,/area/caribbean/sea/bottom/roofed)
"aK" = (/obj/covers/repairedfloor/ship,/obj/structure/closet/crate/cannonball/chainshot,/turf/floor/beach/water/deep/saltwater,/area/caribbean/sea/bottom/roofed)
"aL" = (/obj/covers/repairedfloor/ship,/obj/structure/closet/crate/cannonball/grapeshot,/turf/floor/beach/water/deep/saltwater,/area/caribbean/sea/bottom/roofed)
"aM" = (/obj/covers/repairedfloor/ship,/obj/structure/closet/crate/bayonets,/turf/floor/beach/water/deep/saltwater,/area/caribbean/sea/bottom/roofed)
"aN" = (/obj/covers/repairedfloor/ship,/obj/structure/closet/crate/webbings,/turf/floor/beach/water/deep/saltwater,/area/caribbean/sea/bottom/roofed)
"aO" = (/obj/covers/repairedfloor/ship,/obj/structure/simple_door/key_door/anyone/ship,/turf/floor/broken_floor,/area/caribbean/sea/bottom/roofed)
"aP" = (/obj/structure/barricade/ship/north/corners{dir = 8; icon_state = "boat1_up_corners"},/turf/floor/beach/water/deep/saltwater,/area/caribbean/sea/bottom/roofed)
"aQ" = (/obj/covers/repairedfloor/ship,/obj/structure/voyage/ropeladder{dir = 1; icon_state = "ropeladder"},/obj/structure/cannon/modern/tank/voyage/autofire{dir = 1; icon_state = "cannon"},/turf/floor/beach/water/deep/saltwater,/area/caribbean/sea/bottom/roofed)
"aR" = (/obj/covers/repairedfloor/ship,/obj/structure/bed/wood,/turf/floor/beach/water/deep/saltwater,/area/caribbean/sea/bottom/roofed)
"aS" = (/obj/covers/repairedfloor/ship,/obj/item/flashlight/lantern/on/anchored,/turf/floor/beach/water/deep/saltwater,/area/caribbean/sea/bottom/roofed)
"aT" = (/obj/structure/barricade/ship/north/corners{dir = 4; icon_state = "boat1_up_corners"},/turf/floor/beach/water/deep/saltwater,/area/caribbean/sea/bottom/roofed)
"aU" = (/obj/structure/ship_bow,/turf/floor/beach/water/deep/saltwater,/area/caribbean/sea/bottom)
"aV" = (/obj/structure/barricade/ship/north/corners{dir = 10; icon_state = "boat1_up_corners"},/obj/item/flashlight/lantern/on/anchored,/turf/floor/beach/water/deep/saltwater,/area/caribbean/sea/bottom/roofed)
"aW" = (/obj/map_metadata/voyage,/turf/floor/beach/water/deep/saltwater,/area/caribbean/sea/bottom)
"aX" = (/obj/effect/landmark{name = "Grappling Hook area - do not block"},/turf/floor/beach/water/deep/saltwater,/area/caribbean/sea/bottom)
"aY" = (/obj/covers/repairedfloor/ship,/obj/structure/barricade/ship/wood/a10,/obj/item/flashlight/lantern/on/anchored,/turf/floor/broken_floor,/area/caribbean/sea/bottom/roofed)
"aZ" = (/obj/covers/repairedfloor/ship,/obj/structure/closet/cabinet,/obj/item/weapon/gun/projectile/flintlock/pistoletmodelean1733,/turf/floor/broken_floor,/area/caribbean/sea/bottom/roofed)
"ba" = (/obj/covers/repairedfloor/ship,/obj/structure/barricade/ship/wood/a6,/obj/item/flashlight/lantern/on/anchored,/turf/floor/broken_floor,/area/caribbean/sea/bottom/roofed)
"bb" = (/obj/covers/repairedfloor/ship,/obj/structure/barricade/ship/wood/a12,/obj/item/flashlight/lantern/on/anchored,/turf/floor/broken_floor,/area/caribbean/sea/bottom/roofed)
"bc" = (/obj/covers/repairedfloor/ship,/obj/structure/grapplehook/auto{dir = 1},/turf/floor/broken_floor,/area/caribbean/sea/bottom)
"bd" = (/obj/covers/repairedfloor/ship,/obj/structure/cannon/modern/tank/voyage/autofire{dir = 1; icon_state = "cannon"},/turf/floor/broken_floor,/area/caribbean/sea/bottom)
"be" = (/obj/covers/repairedfloor/ship,/obj/structure/voyage/ropeladder/thin{dir = 1; icon_state = "ropeladder_thin"},/turf/floor/broken_floor,/area/caribbean/sea/bottom)
"bf" = (/obj/covers/repairedfloor/ship,/obj/structure/window/barrier/ship/blue/bport5/corner,/turf/floor/broken_floor,/area/caribbean/sea/bottom)
"bg" = (/obj/structure/barricade/ship/aport1,/obj/structure/cannon/modern/tank/voyage/autofire,/turf/floor/beach/water/deep/saltwater,/area/caribbean/sea/bottom/roofed)
"bh" = (/obj/covers/repairedfloor/ship,/obj/structure/barricade/ship/wood/a4,/turf/floor/broken_floor,/area/caribbean/sea/bottom/roofed)
"bi" = (/obj/covers/repairedfloor/ship,/obj/structure/barricade/ship/wood/a7,/turf/floor/broken_floor,/area/caribbean/sea/bottom/roofed)
"bk" = (/obj/covers/repairedfloor/ship,/obj/structure/table/modern/table,/turf/floor/broken_floor,/area/caribbean/sea/bottom/roofed)
"bl" = (/obj/covers/repairedfloor/ship,/turf/floor/broken_floor,/area/caribbean/sea/bottom/roofed)
"bn" = (/obj/covers/repairedfloor/ship,/obj/structure/barricade/ship/blue/b8,/turf/floor/broken_floor,/area/caribbean/sea/bottom/roofed)
"bo" = (/obj/covers/repairedfloor/ship,/turf/floor/broken_floor,/area/caribbean/sea/bottom)
"bp" = (/obj/covers/repairedfloor/ship,/mob/living/simple_animal/hostile/human/voyage/spanish,/turf/floor/broken_floor,/area/caribbean/sea/bottom)
"bq" = (/obj/structure/barricade/ship/wood/a8,/turf/floor/broken_floor,/area/caribbean/sea/bottom/roofed)
"br" = (/obj/covers/repairedfloor/ship,/obj/structure/barricade/ship/wood/a8,/turf/floor/broken_floor,/area/caribbean/sea/bottom/roofed)
"bs" = (/obj/covers/repairedfloor/ship,/obj/structure/window/barrier/ship/blue/bport_north,/turf/floor/broken_floor,/area/caribbean/sea/bottom)
"bt" = (/obj/covers/repairedfloor/ship,/obj/structure/barricade/ship/wood/a6,/turf/floor/broken_floor,/area/caribbean/sea/bottom/roofed)
"bu" = (/obj/structure/window/barrier/ship/blue/bport3{dir = 1; icon_state = "boat_b_port3"},/obj/covers/repairedfloor/ship/south,/turf/floor/broken_floor,/area/caribbean/sea/bottom)
"bv" = (/obj/covers/repairedfloor/ship,/obj/structure/bed/padded,/obj/item/weapon/bedsheet/brown,/turf/floor/broken_floor,/area/caribbean/sea/bottom/roofed)
"bw" = (/obj/covers/repairedfloor/ship,/obj/structure/barricade/ship/wood/a12,/turf/floor/broken_floor,/area/caribbean/sea/bottom/roofed)
"bx" = (/obj/covers/repairedfloor/ship,/obj/structure/window/barrier/ship/blue/bport_north,/mob/living/simple_animal/hostile/human/voyage/spanish/ranged,/turf/floor/broken_floor,/area/caribbean/sea/bottom)
"by" = (/obj/covers/repairedfloor/ship,/obj/structure/bed/chair/wood/red,/turf/floor/broken_floor,/area/caribbean/sea/bottom/roofed)
"bz" = (/obj/covers/repairedfloor/ship,/obj/structure/barricade/ship/wood/a2,/turf/floor/broken_floor,/area/caribbean/sea/bottom/roofed)
"bA" = (/obj/covers/repairedfloor/ship,/obj/structure/closet/cabinet,/obj/item/weapon/gun/projectile/flintlock/duellingpistol,/turf/floor/broken_floor,/area/caribbean/sea/bottom/roofed)
"bB" = (/obj/covers/repairedfloor/ship,/obj/structure/multiz/ladder/ww2,/turf/floor/broken_floor,/area/caribbean/sea/bottom)
"bC" = (/obj/covers/repairedfloor/ship,/obj/structure/barricade/ship/blue/beast,/turf/floor/broken_floor,/area/caribbean/sea/bottom)
"bD" = (/obj/covers/repairedfloor/ship,/obj/structure/table/modern/table,/obj/item/weapon/paper,/obj/item/weapon/pen,/turf/floor/broken_floor,/area/caribbean/sea/bottom/roofed)
"bE" = (/obj/covers/repairedfloor/ship,/obj/structure/window/barrier/ship/blue/bport_10,/turf/floor/broken_floor,/area/caribbean/sea/bottom)
"bF" = (/obj/covers/repairedfloor/ship,/obj/structure/bed/padded,/obj/item/weapon/bedsheet/red,/turf/floor/broken_floor,/area/caribbean/sea/bottom/roofed)
"bG" = (/obj/covers/repairedfloor/ship,/obj/structure/grapplehook/auto,/turf/floor/broken_floor,/area/caribbean/sea/bottom)
"bH" = (/obj/covers/repairedfloor/ship,/obj/structure/voyage/ropeladder{dir = 1; icon_state = "ropeladder"},/obj/structure/cannon/modern/tank/voyage/autofire{dir = 1; icon_state = "cannon"},/turf/floor/broken_floor,/area/caribbean/sea/bottom)
"bI" = (/obj/covers/repairedfloor/ship,/obj/structure/table/modern/table,/obj/structure/voyage/tablemap{dir = 8; icon_state = "table_map"},/turf/floor/broken_floor,/area/caribbean/sea/bottom/roofed)
"bK" = (/obj/covers/repairedfloor/ship,/obj/structure/bed/chair/wood/red{dir = 8; icon_state = "wooden_chair_red"},/turf/floor/broken_floor,/area/caribbean/sea/bottom/roofed)
"bL" = (/obj/covers/repairedfloor/ship,/mob/living/simple_animal/hostile/human/voyage/spanish/ranged/lt,/turf/floor/broken_floor,/area/caribbean/sea/bottom/roofed)
"bM" = (/obj/covers/repairedfloor/ship,/obj/structure/table/modern/table,/obj/structure/voyage/sextant,/turf/floor/broken_floor,/area/caribbean/sea/bottom/roofed)
"bN" = (/obj/covers/repairedfloor/ship,/obj/structure/vending/craftable/rifles/wood/filled_musket_spanish,/turf/floor/broken_floor,/area/caribbean/sea/bottom)
"bO" = (/obj/covers/repairedfloor/ship,/mob/living/simple_animal/hostile/human/voyage/spanish/ranged,/turf/floor/broken_floor,/area/caribbean/sea/bottom/roofed)
"bP" = (/obj/covers/repairedfloor/ship,/obj/structure/table/modern/table,/obj/item/weapon/paper_bin,/turf/floor/broken_floor,/area/caribbean/sea/bottom/roofed)
"bQ" = (/obj/covers/repairedfloor/ship,/obj/structure/closet/crate/musketball,/turf/floor/broken_floor,/area/caribbean/sea/bottom)
"bR" = (/obj/covers/repairedfloor/ship,/obj/structure/window/barrier/ship/blue/bport9,/turf/floor/broken_floor,/area/caribbean/sea/bottom)
"bS" = (/obj/covers/repairedfloor/ship,/mob/living/simple_animal/hostile/human/voyage/spanish/ranged/sgt,/turf/floor/broken_floor,/area/caribbean/sea/bottom)
"bT" = (/obj/covers/repairedfloor/ship,/obj/structure/bed/chair/wood/red{dir = 4; icon_state = "wooden_chair_red"},/mob/living/simple_animal/hostile/human/voyage/spanish/ranged/cpt,/turf/floor/broken_floor,/area/caribbean/sea/bottom/roofed)
"bU" = (/obj/covers/repairedfloor/ship,/obj/structure/barricade/ship/blue/b17,/turf/floor/broken_floor,/area/caribbean/sea/bottom/roofed)
"bV" = (/obj/structure/voyage/grid{dir = 9},/turf/floor/broken_floor,/area/caribbean/sea/bottom)
"bW" = (/obj/structure/voyage/grid{dir = 5},/turf/floor/broken_floor,/area/caribbean/sea/bottom)
"bX" = (/obj/covers/repairedfloor/ship,/obj/structure/barricade/ship/mast/large,/obj/item/flashlight/lantern/on/anchored,/turf/floor/broken_floor,/area/caribbean/sea/bottom)
"bZ" = (/obj/covers/repairedfloor/ship,/obj/structure/barricade/ship/blue/b9,/turf/floor/broken_floor,/area/caribbean/sea/bottom/roofed)
"ca" = (/obj/structure/voyage/grid{dir = 10},/turf/floor/broken_floor,/area/caribbean/sea/bottom)
"cb" = (/obj/structure/voyage/grid{dir = 6},/turf/floor/broken_floor,/area/caribbean/sea/bottom)
"cc" = (/obj/covers/repairedfloor/ship,/obj/structure/window/barrier/ship/blue/bport_6/corner,/turf/floor/broken_floor,/area/caribbean/sea/bottom)
"cd" = (/obj/covers/repairedfloor/ship,/obj/structure/barricade/ship/blue/b20{dir = 2; icon_state = "boat_b20"},/obj/item/flashlight/lantern/on/anchored,/turf/floor/broken_floor,/area/caribbean/sea/bottom/roofed)
"ce" = (/obj/covers/repairedfloor/ship,/obj/structure/window/barrier/ship/blue/bport0/south,/turf/floor/broken_floor,/area/caribbean/sea/bottom)
"cf" = (/obj/covers/repairedfloor/ship,/obj/structure/closet/crate/treasurechest,/obj/item/stack/money/escudo/ten,/obj/item/stack/money/escudo/ten,/obj/item/stack/money/escudo/ten,/obj/item/stack/money/escudo/ten,/obj/item/stack/money/escudo/ten,/turf/floor/broken_floor,/area/caribbean/sea/bottom/roofed)
"cg" = (/obj/covers/repairedfloor/ship,/obj/structure/closet/crate/musketball_pistol,/turf/floor/broken_floor,/area/caribbean/sea/bottom/roofed)
"ch" = (/obj/covers/repairedfloor/ship,/obj/structure/barricade/ship/blue/b9,/obj/structure/voyage/anchor,/turf/floor/broken_floor,/area/caribbean/sea/bottom/roofed)
"ci" = (/obj/structure/window/barrier/ship/blue/bport3,/obj/covers/repairedfloor/ship,/obj/structure/cannon/modern/tank/voyage/autofire,/turf/floor/broken_floor,/area/caribbean/sea/bottom)
"cj" = (/obj/covers/repairedfloor/ship,/obj/structure/window/barrier/ship/blue/bport0/south,/mob/living/simple_animal/hostile/human/voyage/spanish/ranged,/turf/floor/broken_floor,/area/caribbean/sea/bottom)
"mE" = (/obj/covers/repairedfloor/ship,/obj/structure/window/barrier/ship/blue/bport0/south,/obj/structure/voyage/ropeladder/thin,/turf/floor/broken_floor,/area/caribbean/sea/bottom)
"qL" = (/obj/structure/voyage/grid,/turf/floor/broken_floor,/area/caribbean/sea/bottom)
"rd" = (/obj/structure/voyage/grid/middle,/turf/floor/broken_floor,/area/caribbean/sea/bottom)
"vg" = (/obj/structure/voyage/grid{dir = 1},/turf/floor/broken_floor,/area/caribbean/sea/bottom)
"yG" = (/obj/structure/window/barrier/ship/blue/bport3,/obj/structure/voyage/ropeladder,/obj/covers/repairedfloor/ship,/obj/structure/cannon/modern/tank/voyage/autofire,/turf/floor/broken_floor,/area/caribbean/sea/bottom)
"Az" = (/obj/structure/voyage/grid{dir = 4},/turf/floor/broken_floor,/area/caribbean/sea/bottom)
"LI" = (/obj/structure/voyage/grid{dir = 8},/turf/floor/broken_floor,/area/caribbean/sea/bottom)

(1,1,1) = {"
aaaaaaaaaaaaaaaaaaaaaaaaaaaaaaaaaaaaaaaaaaaaaaaaaaaaaaaaaaaaaaaaaaaaaaaaaaaaaaaaaaaaaaaaaaaaaaaaaaaaaaaaaaaaaaaaaaaaaaaaaaaaaaaaaaaaaaaaaaaaaaaaaaaaaa
aaaaaaaaaaaaaaaaaaaaaaaaaaaaaaaaaaaaaaaaaaaaaaaaaaaaaaaaaaaaaaaaaaaaaaaaaaaaaaaaaaaaaaaaaaaaaaaaaaaaaaaaaaaaaaaaaaaaaaaaaaaaaaaaaaaaaaaaaaaaaaaaaaaaaa
aaaaaaaaaaaaaaaaaaaaaaaaaaaaaaaaaaaaaaaaaaaaaaaaaaaaaaaaaaaaaaaaaaaaaaaaaaaaaaaaaaaaaaaaaaaaaaaaaaaaaaaaaaaaaaaaaaaaaaaaaaaaaaaaaaaaaaaaaaaaaaaaaaaaaa
aaaaaaaaaaaaaaaaafaiaiaiaiaiaiaiaiaiaiaiamaiaiamaiaiamaiaiamaiaiamaiaiamaiaiamaiaiamaiaiamaiaiamaiaiamaiaiamaiaianaaaaaaaaaaaaaaaaaaaaaaaaaaaaaaaaaaaa
aaaaaaaaaaaaafaiabagagacasasasajakakacajadajajadajazadajajadajajadajajaQajajadajajadajajadajazadajajadajajadajajaeaianaaaaaaaaaaaaaaaaaaaaaaaaaaaaaaaa
aaaaaaaaaaafabagagajajapajajajajaxaxapajajajajajajajajajajajajajajajajajajajajajajajajajajajajawajajajajajajajajajajaeaianaaaaaaaaaaaaaaaaaaaaaaaaaaaa
aaaaaaaaafabagajajajajapajajajajajajapajajawajajajajajawajajajajajawajajajajawajajawajajajajajajajajajawajajajawajajaoataeaianaaaaaaaaaaaaaaaaaaaaaaaa
aaaaaaaaauagajajajajajapajajaxaxajajapavajajajajajajajajajajarajarajarajarajarajarajarajarajarajarajarajajajajajajajajaRajaRaeanaaaaaaaaaaaaaaaaaaaaaa
aaaaaaaaauagajajajakajapajajajayajajapavajajajajakajajaSajajajajajajajajajaSajajajajajajajaSajajajajajajaSajajajajajajajajajaAaBaaaaaaaaaaaaaaaaaaaaaa
aaaaaaaaauagajajajajajacajajajayajajacajajajajajakajajajajajajajaCaDajaEaFaGaGajaHaHaIajaJaJaKaLajaMaMaNajajajajajajajaRajaRaAaBaaaaaaaaaaaaaaaaaaaaaa
aaaaaaaaauagajakajajajalajajajayajajalajajajajajakajajajajajajajaCaDajaEaFaGaGajaHaHaIajaJaJaKaLajaMaMaNajajajajajajajajajajaAaBaaaaaaaaaaaaaaaaaaaaaa
aaaaaaaaauagajakajajajalajajajayajajalajajajajajakajajajajajajajaCaDajaEaFaGaGajaHaHaIajaJaJaKaLajaMaMaNajajajajajajajaRajaRataBaaaaaaaaaaaaaaaaaaaaaa
aaaaaaaaauagajajajajajacajajajayajajacajajajajajakajajaSajajajajajajajajajaSajajajajajajajaSajajajajajajaSajajajajajajajajajataBaaaaaaaaaaaaaaaaaaaaaa
aaaaaaaaauagajajajakajapajajajayajajapavajajajajajajajajajajarajarajarajarajarajarajarawarajarajarajarajajajajajajajajaRajaRataBaaaaaaaaaaaaaaaaaaaaaa
aaaaaaaaauagajajajajajapajajaxaxajajapavajawajajajawajajawajajajajajajajawajajajawajajajajajajajajajajajawajajajajajajajaxaxaqaPaUaaaaaaaaaaaaaaaaaaaa
aaaaaaaaaTaVagajajajajapajajajajajajapajajajajajajajajajajajajawajajajajajajajajajajajajajajajawajajajajajajajajajajaxaxaqahaPaaaaaaaaaaaaaaaaaaaaaaaa
aaaaaaaaaaaTaVagagajajapajajajajaxaxapajajajajajajajajajajajajajajajajajajajajajajajajajajajajajajajajajajajajajaxaxaqahaPaaaaaaaaaaaaaaaaaaaaaaaaaaaa
aaaaaaaaaaaaaTahaVagagacajajajajakakacajajajajajajajajajajajajajajajajajajajajajajajajajajajajajajajajajajajajajaqahaPaaaaaaaaaaaaaaaaaaaaaaaaaaaaaaaa
aaaaaaaaaaaaaaaaaTahahahahahahahahahahahbgahahbgahahbgahahbgahahbgahahbgahahbgahahbgahahbgahahbgahahbgahahbgahahaPaaaaaaaaaaaaaaaaaaaaaaaaaaaaaaaaaaaa
aaaaaaaaaaaaaaaaaaaaaaaaaaaaaaaaaaaaaaaaaaaaaaaaaaaaaaaaaaaaaaaaaaaaaaaaaaaaaaaaaaaaaaaaaaaaaaaaaaaaaaaaaaaaaaaaaaaaaaaaaaaaaaaaaaaaaaaaaaaaaaaaaaaaaa
aaaaaaaaaaaaaaaaaaaaaaaaaaaaaaaaaaaaaaaaaaaaaaaaaaaaaaaaaaaaaaaaaaaaaaaaaaaaaaaaaaaaaaaaaaaaaaaaaaaaaaaaaaaaaaaaaaaaaaaaaaaaaaaaaaaaaaaaaaaaaaaaaaaaaa
aaaaaaaaaaaaaaaaaaaaaaaaaaaaaaaaaaaaaaaaaaaaaaaaaaaaaaaaaaaaaaaaaaaaaaaaaaaaaaaaaaaaaaaaaaaaaaaaaaaaaaaaaaaaaaaaaaaaaaaaaaaaaaaaaaaaaaaaaaaaaaaaaaaaaa
aaaaaaaaaaaaaaaaaaaaaaaaaaaaaaaaaaaaaaaaaaaaaaaaaaaaaaaaaaaaaaaaaaaaaaaaaaaaaaaaaaaaaaaaaaaaaaaaaaaaaaaaaaaaaaaaaaaaaaaaaaaaaaaaaaaaaaaaaaaaaaaaaaaaaa
aaaaaaaaaaaaaaaaaaaaaaaaaaaaaaaaaaaaaaaaaaaaaaaaaaaaaaaaaaaaaaaaaaaaaaaaaaaaaaaaaaaaaaaaaaaaaaaaaaaaaaaaaaaaaaaaaaaaaaaaaaaaaaaaaaaaaaaaaaaaaaaaaaaaaa
aWaaaaaaaaaaaaaaaaaaaaaaaaaaaaaaaaaaaaaaaaaaaaaaaaaaaaaaaaaaaaaaaaaaaaaaaaaaaaaaaaaaaaaaaaaaaaaaaaaaaaaaaaaaaaaaaaaaaaaaaaaaaaaaaaaaaaaaaaaaaaaaaaaaaa
"}

(1,1,2) = {"
aaaaaaaaaaaaaaaaaaaaaaaaaaaaaaaaaaaaaaaaaaaaaaaaaaaaaaaaaXaaaaaaaaaaaaaXaaaaaaaaaaaaaaaaaaaaaaaaaaaaaaaaaaaaaaaaaaaaaaaaaaaaaaaaaaaaaaaaaaaaaaaaaaaaaa
aaaaaaaaaaaaaaaaaaaaaaaaaaaaaaaaaaaaaaaaaaaaaaaaaaaaaaaaaXaaaaaaaaaaaaaXaaaaaaaaaaaaaaaaaaaaaaaaaaaaaaaaaaaaaaaaaaaaaaaaaaaaaaaaaaaaaaaaaaaaaaaaaaaaaa
aaaaaaaaaaaaaaaaaaaaaaaaaaaaaaaaaaaaaaaaaaaaaaaaaaaaaaaaaXaaaaaaaaaaaaaXaaaaaaaaaaaaaaaaaaaaaaaaaaaaaaaaaaaaaaaaaaaaaaaaaaaaaaaaaaaaaaaaaaaaaaaaaaaaaa
aaaaaaaaaaaaaaaabhbibibqbibibibibibibrbsbubxbxbubsbxbubsbxbubsbxbubsbxbubsbxbubxbsbubxbsbubxbsbubxbsbubxbsbubxbsbEaaaaaaaaaaaaaaaaaaaaaaaaaaaaaaaaaaaa
aaaaaaaaaaaabhbiaYaZbFbabkbkblblblbvbbbobdbobobdbcbebdbobobdbobobdbGbobHbobobdbobcbdbobobdbobebdbobobdbobobdbobobfbsbEaaaaaaaaaaaaaaaaaaaaaaaaaaaaaaaa
aaaaaaaaaabhaYblblblblbtbkbKblblblbAbwbobobobobobobobobobobobobobobobobobobobobobobobobobobobobpbobobobobobobobobobobfbsbEaaaaaaaaaaaaaaaaaaaaaaaaaaaa
aaaaaaaabhaYblblblblblbtbkblblblblblbwbobobpbobobobobobpbobobobobobpbobobobobpbobobpbobobobobobobobobobpbobobobpbobobobobfbsbEaaaaaaaaaaaaaaaaaaaaaaaa
aaaaaaaabzblblblblblblbtblbOblblblbObwbBbobobobobobobobobobobobobobobobobobobobobobobobobobobobobobobobobobobobobobobobobobobfbEaaaaaaaaaaaaaaaaaaaaaa
aaaaaaaabzblbkbkblblblbtblblblblblblbwbBbobobobobobobobobobobobobobobobobobobobobobobobobobobobobobobobobobobobobobobobobobobobCaaaaaaaaaaaaaaaaaaaaaa
aaaaaaaabzblblbPblblblbablblblblblblbbbobobobobobobQbQbobobobobobobobobNbNbobobobobSbobobobobQbQbobobobobobobobobobobobobobobobCaaaaaaaaaaaaaaaaaaaaaa
aaaaaaaabzblbTbDblblblaOblblblblblblaObobobobobobSbobobobobVvgbWbobobobobobobobobobobobobobobobobobobobobobobobobobobobobobobobCaaaaaaaaaaaaaaaaaaaaaa
aaaaaaaabzblblbIblblblaOblblblblblblaObobobobobobobXboboboLIrdAzbobSbobXbobobobobobobobobobobXbobobobobobobobobobobobobobobobobCaaaaaaaaaaaaaaaaaaaaaa
aaaaaaaabzblbkbMblblblbablblblblblblbbbobobobobobobNbNbobocaqLcbbobobobQbQbobobobobobobobobobNbNbobobobobobobobobobobobobobobobCaaaaaaaaaaaaaaaaaaaaaa
aaaaaaaabzblblblblblblbtblblblblblblbwbBbobobobobobobobobobobobobobobobobobobobobobobobpbobobobobobobobobobobobobobobobobobobobCaaaaaaaaaaaaaaaaaaaaaa
aaaaaaaabzblblblblblblbtblblblblblblbwbBbobpbobobobpbobobpbobobobobobobobpbobobobpbobobobobobobobobobobobpboboboboboboboboboccbRaUaaaaaaaaaaaaaaaaaaaa
aaaaaaaabUcdblblblbLblbtbObLblblblbObwbobobobobobobobobobobobobpbobobobobobobobobobobobobobobobpbobobobobobobobobobobobocccebRaaaaaaaaaaaaaaaaaaaaaaaa
aaaaaaaaaabUcdblblblblbtbkbyblblblbAbwbobobobobobobobobobobobobobobobobobobobobobobobobobobobobobobobobobobobobobobocccebRaaaaaaaaaaaaaaaaaaaaaaaaaaaa
aaaaaaaaaaaabUbZcdcfcgbabkbkbkblblbvbbbobobobobobobobobobGbobobobobobobobobobobobobobGbobobobobobobobobGbobobobocccebRaaaaaaaaaaaaaaaaaaaaaaaaaaaaaaaa
aaaaaaaaaaaaaaaabUbZbZbZbZbZchbZbZbZbncecicjcecicjmEcicjcecicjcecicjceyGcjcecicjcecicjcecicjmEcicjcecicjcecicjcebRaaaaaaaaaaaaaaaaaaaaaaaaaaaaaaaaaaaa
aaaaaaaaaaaaaaaaaaaaaaaaaaaaaaaaaaaaaaaaaaaaaaaaaaaaaaaaaaaaaaaaaaaaaaaaaaaaaaaaaaaaaaaaaaaaaaaaaaaaaaaaaaaaaaaaaaaaaaaaaaaaaaaaaaaaaaaaaaaaaaaaaaaaaa
aaaaaaaaaaaaaaaaaaaaaaaaaaaaaaaaaaaaaaaaaaaaaaaaaaaaaaaaaaaaaaaaaaaaaaaaaaaaaaaaaaaaaaaaaaaaaaaaaaaaaaaaaaaaaaaaaaaaaaaaaaaaaaaaaaaaaaaaaaaaaaaaaaaaaa
aaaaaaaaaaaaaaaaaaaaaaaaaaaaaaaaaaaaaaaaaaaaaaaaaaaaaaaaaaaaaaaaaaaaaaaaaaaaaaaaaaaaaaaaaaaaaaaaaaaaaaaaaaaaaaaaaaaaaaaaaaaaaaaaaaaaaaaaaaaaaaaaaaaaaa
aaaaaaaaaaaaaaaaaaaaaaaaaaaaaaaaaaaaaaaaaaaaaaaaaaaaaaaaaaaaaaaaaaaaaaaaaaaaaaaaaaaaaaaaaaaaaaaaaaaaaaaaaaaaaaaaaaaaaaaaaaaaaaaaaaaaaaaaaaaaaaaaaaaaaa
aaaaaaaaaaaaaaaaaaaaaaaaaaaaaaaaaaaaaaaaaaaaaaaaaaaaaaaaaaaaaaaaaaaaaaaaaaaaaaaaaaaaaaaaaaaaaaaaaaaaaaaaaaaaaaaaaaaaaaaaaaaaaaaaaaaaaaaaaaaaaaaaaaaaaa
aaaaaaaaaaaaaaaaaaaaaaaaaaaaaaaaaaaaaaaaaaaaaaaaaaaaaaaaaaaaaaaaaaaaaaaaaaaaaaaaaaaaaaaaaaaaaaaaaaaaaaaaaaaaaaaaaaaaaaaaaaaaaaaaaaaaaaaaaaaaaaaaaaaaaa
"}
