"aa" = (/turf/floor/plating/grass/wild,/area/prishtina/farm1{base_turf = /turf/floor/dirt; name = "Streets - Northern"})
"ab" = (/obj/effect/landmark{name = "JoinLateHeer"},/turf/floor/plating/grass/wild,/area/prishtina/farm1{base_turf = /turf/floor/dirt; name = "Streets - Northern"})
"ac" = (/turf/floor/plating/cobblestone/vertical{tag = "icon-cobble_vertical"; icon_state = "cobble_vertical"},/area/prishtina/farm1{base_turf = /turf/floor/dirt; name = "Streets - Northern"})
"ad" = (/obj/effect/floor_decal/corner/grey/border,/turf/floor/plating/cobblestone/vertical{tag = "icon-cobble_vertical"; icon_state = "cobble_vertical"},/area/prishtina/farm1{base_turf = /turf/floor/dirt; name = "Streets - Northern"})
"ae" = (/obj/effect/floor_decal/corner/grey/border{dir = 4},/obj/structure/light/floor/streetlight,/turf/floor/plating/cobblestone/vertical{tag = "icon-cobble_vertical"; icon_state = "cobble_vertical"},/area/prishtina/farm1{base_turf = /turf/floor/dirt; name = "Streets - Northern"})
"af" = (/obj/effect/floor_decal/corner/grey/border,/turf/floor/plating/road,/area/prishtina/farm1{base_turf = /turf/floor/dirt; name = "Streets - Northern"})
"ag" = (/turf/floor/plating/road,/area/prishtina/farm1{base_turf = /turf/floor/dirt; name = "Streets - Northern"})
"ah" = (/obj/effect/landmark{name = "Observer-Start"},/turf/floor/plating/road,/area/prishtina/farm1{base_turf = /turf/floor/dirt; name = "Streets - Northern"})
"ai" = (/turf/wall/sandstone,/area/prishtina/houses/sov_six)
"aj" = (/obj/effect/floor_decal/spline/fancy/wood{tag = "icon-spline_fancy (NORTH)"; icon_state = "spline_fancy"; dir = 1},/obj/structure/curtain/open/bed,/obj/structure/window/classic,/turf/floor/wood,/area/prishtina/houses/sov_six)
"ak" = (/obj/structure/simple_door/key_door/anyone/wood,/obj/effect/floor_decal/spline/fancy/wood{tag = "icon-spline_fancy (NORTH)"; icon_state = "spline_fancy"; dir = 1},/turf/floor/wood,/area/prishtina/houses/sov_six)
"al" = (/obj/effect/floor_decal/corner/grey/border{dir = 4},/turf/floor/plating/cobblestone/vertical{tag = "icon-cobble_vertical"; icon_state = "cobble_vertical"},/area/prishtina/farm1{base_turf = /turf/floor/dirt; name = "Streets - Northern"})
"am" = (/obj/effect/floor_decal/corner/grey/bordercorner{dir = 8},/turf/floor/plating/road,/area/prishtina/farm1{base_turf = /turf/floor/dirt; name = "Streets - Northern"})
"an" = (/obj/effect/floor_decal/corner/grey/bordercorner,/turf/floor/plating/road,/area/prishtina/farm1{base_turf = /turf/floor/dirt; name = "Streets - Northern"})
"ao" = (/obj/structure/closet/cabinet,/obj/item/clothing/under/overalls,/obj/item/clothing/shoes/workboots,/turf/floor/wood,/area/prishtina/houses/sov_six)
"ap" = (/obj/structure/bed/padded,/obj/item/weapon/bedsheet/brown,/turf/floor/carpet,/area/prishtina/houses/sov_six)
"aq" = (/obj/structure/bed/chair/comfy/red,/turf/floor/wood,/area/prishtina/houses/sov_six)
"ar" = (/turf/floor/wood,/area/prishtina/houses/sov_six)
"as" = (/obj/structure/bookcase/manuals,/turf/floor/wood,/area/prishtina/houses/sov_six)
"at" = (/obj/structure/light/floor/streetlight,/turf/floor/plating/cobblestone/vertical{tag = "icon-cobble_vertical"; icon_state = "cobble_vertical"},/area/prishtina/farm1{base_turf = /turf/floor/dirt; name = "Streets - Northern"})
"au" = (/obj/effect/floor_decal/corner/grey/border{dir = 8},/turf/floor/plating/road,/area/prishtina/farm1{base_turf = /turf/floor/dirt; name = "Streets - Northern"})
"av" = (/obj/effect/floor_decal/corner/grey/border{dir = 4},/turf/floor/plating/road,/area/prishtina/farm1{base_turf = /turf/floor/dirt; name = "Streets - Northern"})
"aw" = (/obj/structure/light/small{dir = 8},/turf/floor/carpet,/area/prishtina/houses/sov_six)
"ax" = (/turf/floor/carpet,/area/prishtina/houses/sov_six)
"ay" = (/obj/effect/floor_decal/spline/fancy/wood{tag = "icon-spline_fancy (WEST)"; icon_state = "spline_fancy"; dir = 8},/obj/structure/simple_door/key_door/anyone/wood,/turf/floor/wood,/area/prishtina/houses/sov_six)
"az" = (/obj/structure/bed/chair/comfy/beige{tag = "icon-comfychair_preview (WEST)"; icon_state = "comfychair_preview"; dir = 8},/turf/floor/wood,/area/prishtina/houses/sov_six)
"aA" = (/turf/wall/sandstone,/area/prishtina/houses/sov_seven)
"aB" = (/obj/structure/simple_door/key_door/anyone/wood,/obj/effect/floor_decal/spline/fancy/wood{tag = "icon-spline_fancy (NORTH)"; icon_state = "spline_fancy"; dir = 1},/turf/floor/wood,/area/prishtina/houses/sov_seven)
"aC" = (/obj/effect/floor_decal/corner/grey/border{dir = 1},/obj/structure/curtain/open/bed,/obj/structure/window/classic,/turf/floor/wood,/area/prishtina/houses/sov_seven)
"aD" = (/turf/floor/plating/grass/wild,/area/prishtina/houses/sov_six)
"aE" = (/turf/wall/sandstone,/area/prishtina/houses/sov_ten)
"aF" = (/obj/effect/floor_decal/corner/grey/border{dir = 1},/turf/floor/plating/cobblestone/vertical/dark,/area/prishtina/farm1{base_turf = /turf/floor/dirt; name = "Streets - Northern"})
"aG" = (/turf/wall/brick,/area/prishtina/houses/sov_ten)
"aH" = (/turf/wall/brick,/area/prishtina/farm1{base_turf = /turf/floor/dirt; name = "Streets - Northern"})
"aI" = (/turf/floor/wood,/area/prishtina/houses/sov_seven)
"aJ" = (/turf/floor/dirt,/area/prishtina/farm1{base_turf = /turf/floor/dirt; name = "Streets - Northern"})
"aK" = (/turf/floor/plating/cobblestone/vertical/dark,/area/prishtina/farm1{base_turf = /turf/floor/dirt; name = "Streets - Northern"})
"aL" = (/turf/floor/wood,/area/prishtina/houses/sov_ten)
"aM" = (/obj/structure/table/wood,/turf/floor/wood,/area/prishtina/farm1{base_turf = /turf/floor/dirt; name = "Streets - Northern"})
"aN" = (/obj/effect/floor_decal/corner/grey/border{dir = 8},/turf/floor/plating/cobblestone/vertical{tag = "icon-cobble_vertical"; icon_state = "cobble_vertical"},/area/prishtina/farm1{base_turf = /turf/floor/dirt; name = "Streets - Northern"})
"aO" = (/obj/effect/floor_decal/spline/fancy/wood{tag = "icon-spline_fancy (NORTH)"; icon_state = "spline_fancy"; dir = 1},/obj/structure/simple_door/key_door/anyone/wood,/turf/floor/wood,/area/prishtina/houses/sov_six)
"aP" = (/obj/structure/light/small{dir = 4},/turf/floor/wood,/area/prishtina/houses/sov_six)
"aQ" = (/obj/structure/light/small{dir = 4},/turf/floor/wood,/area/prishtina/houses/sov_seven)
"aR" = (/obj/structure/oven,/turf/floor/wood,/area/prishtina/farm1{base_turf = /turf/floor/dirt; name = "Streets - Northern"})
"aS" = (/obj/structure/toilet{step_y = 0},/turf/floor/wood,/area/prishtina/houses/sov_six)
"aT" = (/obj/structure/sink{tag = "icon-sink (EAST)"; icon_state = "sink"; dir = 4; step_x = 0; step_y = 0; pixel_x = 14},/obj/structure/mirror{pixel_x = 26; pixel_y = 9; step_x = 0; step_y = 0},/obj/structure/light/small,/turf/floor/wood,/area/prishtina/houses/sov_six)
"aU" = (/obj/structure/bed/chair/wood/red{tag = "icon-wooden_chair_red (EAST)"; icon_state = "wooden_chair_red"; dir = 4},/turf/floor/wood,/area/prishtina/houses/sov_six)
"aV" = (/obj/structure/table/wood,/obj/item/weapon/reagent_containers/food/drinks/teapot,/turf/floor/wood,/area/prishtina/houses/sov_six)
"aW" = (/obj/structure/bed/chair/wood/red{tag = "icon-wooden_chair_red (WEST)"; icon_state = "wooden_chair_red"; dir = 8},/turf/floor/wood,/area/prishtina/houses/sov_six)
"aX" = (/obj/structure/table/iron,/obj/item/weapon/reagent_containers/food/snacks/meat,/obj/item/weapon/reagent_containers/food/snacks/meat,/obj/effect/floor_decal/spline/fancy/wood,/turf/floor/wood,/area/prishtina/houses/sov_seven)
"aY" = (/obj/structure/table/iron,/obj/item/weapon/reagent_containers/food/snacks/rawcutlet,/obj/item/weapon/reagent_containers/food/snacks/rawcutlet,/obj/effect/floor_decal/spline/fancy/wood,/turf/floor/wood,/area/prishtina/houses/sov_seven)
"aZ" = (/obj/structure/table/iron,/obj/item/weapon/reagent_containers/food/snacks/rawcutlet,/obj/effect/floor_decal/spline/fancy/wood,/turf/floor/wood,/area/prishtina/houses/sov_seven)
"ba" = (/obj/structure/table/iron,/obj/item/weapon/reagent_containers/food/snacks/sausage,/obj/item/weapon/reagent_containers/food/snacks/sausage,/obj/effect/floor_decal/spline/fancy/wood,/turf/floor/wood,/area/prishtina/houses/sov_seven)
"bb" = (/obj/effect/floor_decal/spline/fancy/wood,/obj/structure/curtain/open/bed,/obj/structure/window/classic,/turf/floor/wood,/area/prishtina/houses/sov_six)
"bc" = (/obj/structure/oven,/turf/floor/wood,/area/prishtina/houses/sov_seven)
"bd" = (/turf/floor/wood,/area/prishtina/farm1{base_turf = /turf/floor/dirt; name = "Streets - Northern"})
"be" = (/obj/effect/floor_decal/spline/fancy/wood{tag = "icon-spline_fancy (EAST)"; icon_state = "spline_fancy"; dir = 4},/obj/structure/simple_door/key_door/anyone/wood,/turf/floor/wood,/area/prishtina/houses/sov_ten)
"bf" = (/obj/structure/bed/chair/wood{dir = 1},/turf/floor/wood,/area/prishtina/houses/sov_ten)
"bg" = (/obj/effect/floor_decal/corner/grey/border{dir = 1},/turf/floor/plating/cobblestone/vertical{tag = "icon-cobble_vertical"; icon_state = "cobble_vertical"},/area/prishtina/farm1{base_turf = /turf/floor/dirt; name = "Streets - Northern"})
"bh" = (/obj/structure/simple_door/key_door/anyone/wood,/obj/effect/floor_decal/spline/fancy/wood{tag = "icon-spline_fancy (NORTH)"; icon_state = "spline_fancy"; dir = 1},/turf/floor/wood,/area/prishtina/farm1{base_turf = /turf/floor/dirt; name = "Streets - Northern"})
"bi" = (/obj/structure/light/small{dir = 1},/turf/floor/wood,/area/prishtina/houses/sov_seven)
"bj" = (/obj/item/stack/material/marble,/obj/item/weapon/reagent_containers/glass/rag,/obj/item/weapon/reagent_containers/food/drinks/bottle/water/filled,/obj/item/weapon/reagent_containers/food/drinks/bottle/water/filled,/obj/item/weapon/reagent_containers/food/drinks/bottle/water/filled,/obj/item/weapon/reagent_containers/food/drinks/drinkingglass,/obj/item/weapon/reagent_containers/food/drinks/drinkingglass,/obj/item/weapon/reagent_containers/food/drinks/drinkingglass,/obj/item/weapon/reagent_containers/food/drinks/drinkingglass,/turf/floor/wood,/area/prishtina/houses/sov_seven)
"bk" = (/obj/item/stack/material/marble,/obj/item/weapon/material/knife,/turf/floor/wood,/area/prishtina/houses/sov_seven)
"bl" = (/obj/structure/kitchenspike,/turf/floor/wood,/area/prishtina/houses/sov_seven)
"bm" = (/obj/structure/bed/chair/comfy/beige{tag = "icon-comfychair_preview (WEST)"; icon_state = "comfychair_preview"; dir = 8},/turf/floor/wood,/area/prishtina/farm1{base_turf = /turf/floor/dirt; name = "Streets - Northern"})
"bn" = (/turf/wall/sandstone,/area/prishtina/farm1{base_turf = /turf/floor/dirt; name = "Streets - Northern"})
"bo" = (/obj/effect/floor_decal/corner/grey/border,/obj/structure/simple_door/key_door/anyone/wood,/turf/floor/wood,/area/prishtina/houses/sov_seven)
"bp" = (/obj/structure/toilet{step_y = 0},/turf/floor/wood,/area/prishtina/farm1{base_turf = /turf/floor/dirt; name = "Streets - Northern"})
"bq" = (/obj/structure/simple_door/key_door/anyone/wood,/obj/effect/floor_decal/spline/fancy/wood{tag = "icon-spline_fancy (NORTH)"; icon_state = "spline_fancy"; dir = 1},/turf/floor/wood,/area/prishtina/houses/sov_ten)
"br" = (/obj/structure/sink{tag = "icon-sink (EAST)"; icon_state = "sink"; dir = 4; step_x = 0; step_y = 0; pixel_x = 14},/obj/structure/mirror{pixel_x = 26; pixel_y = 9; step_x = 0; step_y = 0},/obj/structure/light/small,/turf/floor/wood,/area/prishtina/farm1{base_turf = /turf/floor/dirt; name = "Streets - Northern"})
"bs" = (/obj/structure/table/wood,/turf/floor/wood,/area/prishtina/houses/sov_ten)
"bt" = (/obj/structure/bed/chair/wood/red{tag = "icon-wooden_chair_red (EAST)"; icon_state = "wooden_chair_red"; dir = 4},/turf/floor/wood,/area/prishtina/farm1{base_turf = /turf/floor/dirt; name = "Streets - Northern"})
"bu" = (/turf/wall/sandstone,/area/prishtina/houses/sov_eight)
"bv" = (/obj/structure/table/wood,/obj/item/weapon/reagent_containers/food/drinks/teapot,/turf/floor/wood,/area/prishtina/farm1{base_turf = /turf/floor/dirt; name = "Streets - Northern"})
"bw" = (/obj/structure/iv_drip,/turf/floor/tiled/white,/area/prishtina/houses/sov_eight)
"bx" = (/obj/structure/optable,/turf/floor/tiled/white,/area/prishtina/houses/sov_eight)
"by" = (/obj/structure/sink{step_y = 0; pixel_y = 27},/obj/item/roller,/turf/floor/tiled/white,/area/prishtina/houses/sov_eight)
"bz" = (/obj/structure/table/wood,/obj/item/weapon/reagent_containers/glass/rag,/obj/item/weapon/reagent_containers/syringe/morphine,/turf/floor/lino{tag = "icon-grimy"; icon_state = "grimy"},/area/prishtina/houses/sov_eight)
"bA" = (/obj/structure/table/wood,/obj/structure/bedsheetbin,/turf/floor/lino{tag = "icon-grimy"; icon_state = "grimy"},/area/prishtina/houses/sov_eight)
"bB" = (/obj/structure/table/wood,/obj/item/weapon/reagent_containers/blood/empty,/turf/floor/lino{tag = "icon-grimy"; icon_state = "grimy"},/area/prishtina/houses/sov_eight)
"bC" = (/obj/structure/bed/chair/wood/red{tag = "icon-wooden_chair_red (WEST)"; icon_state = "wooden_chair_red"; dir = 8},/turf/floor/wood,/area/prishtina/farm1{base_turf = /turf/floor/dirt; name = "Streets - Northern"})
"bD" = (/obj/structure/bed/padded,/obj/item/weapon/bedsheet/hos,/turf/floor/wood,/area/prishtina/houses/sov_ten)
"bE" = (/obj/structure/oven,/turf/floor/wood,/area/prishtina/houses/sov_ten)
"bF" = (/obj/structure/light/small,/turf/floor/wood,/area/prishtina/houses/sov_ten)
"bG" = (/obj/structure/light/small{dir = 8},/turf/floor/tiled/white,/area/prishtina/houses/sov_eight)
"bH" = (/turf/floor/tiled/white,/area/prishtina/houses/sov_eight)
"bI" = (/obj/effect/floor_decal/spline/fancy/wood{tag = "icon-spline_fancy (WEST)"; icon_state = "spline_fancy"; dir = 8},/obj/structure/simple_door/key_door/anyone/wood,/turf/floor/lino{tag = "icon-grimy"; icon_state = "grimy"},/area/prishtina/houses/sov_eight)
"bJ" = (/turf/floor/lino{tag = "icon-grimy"; icon_state = "grimy"},/area/prishtina/houses/sov_eight)
"bK" = (/obj/structure/bed,/obj/item/weapon/bedsheet,/turf/floor/lino{tag = "icon-grimy"; icon_state = "grimy"},/area/prishtina/houses/sov_eight)
"bL" = (/obj/structure/closet/cabinet,/turf/floor/wood,/area/prishtina/farm1{base_turf = /turf/floor/dirt; name = "Streets - Northern"})
"bM" = (/obj/effect/floor_decal/spline/fancy/wood{tag = "icon-spline_fancy (WEST)"; icon_state = "spline_fancy"; dir = 8},/obj/structure/simple_door/key_door/anyone/wood,/turf/floor/wood,/area/prishtina/houses/sov_ten)
"bN" = (/obj/structure/bed/padded,/obj/item/weapon/bedsheet/yellow,/turf/floor/wood,/area/prishtina/farm1{base_turf = /turf/floor/dirt; name = "Streets - Northern"})
"bO" = (/obj/effect/floor_decal/spline/fancy/wood,/obj/structure/curtain/open/bed,/obj/structure/window/classic,/turf/floor/wood,/area/prishtina/farm1{base_turf = /turf/floor/dirt; name = "Streets - Northern"})
"bP" = (/obj/structure/sink/puddle,/turf/floor/dirt,/area/prishtina/farm1{base_turf = /turf/floor/dirt; name = "Streets - Northern"})
"bQ" = (/obj/item/weapon/storage/firstaid/surgery,/obj/item/weapon/pill_pack/tramadol,/turf/floor/tiled/white,/area/prishtina/houses/sov_eight)
"bR" = (/obj/item/weapon/storage/firstaid/adv,/obj/item/weapon/storage/firstaid/surgery,/obj/item/weapon/storage/firstaid/toxin,/obj/item/weapon/storage/firstaid/o2,/obj/item/weapon/storage/firstaid/fire,/obj/item/weapon/storage/firstaid/injectorpack,/obj/item/clothing/suit/storage/toggle/labcoat,/turf/floor/tiled/white,/area/prishtina/houses/sov_eight)
"bS" = (/obj/structure/bed/chair/wood,/turf/floor/wood,/area/prishtina/houses/sov_ten)
"bT" = (/obj/structure/closet/cabinet,/turf/floor/wood,/area/prishtina/houses/sov_ten)
"bU" = (/obj/effect/floor_decal/spline/fancy/wood{tag = "icon-spline_fancy (NORTH)"; icon_state = "spline_fancy"; dir = 1},/obj/structure/simple_door/key_door/anyone/wood,/turf/floor/wood,/area/prishtina/houses/sov_eight)
"bV" = (/obj/structure/light/small{dir = 1},/turf/floor/plating/cobblestone/vertical/dark,/area/prishtina/farm1{base_turf = /turf/floor/dirt; name = "Streets - Northern"})
"bW" = (/obj/structure/bed/padded,/obj/item/weapon/bedsheet/hos,/turf/floor/carpet,/area/prishtina/houses/sov_ten)
"bX" = (/obj/structure/bed/chair/comfy/red,/turf/floor/wood,/area/prishtina/houses/sov_ten)
"bY" = (/obj/structure/bookcase/manuals,/turf/floor/wood,/area/prishtina/houses/sov_ten)
"bZ" = (/obj/structure/filingcabinet,/turf/floor/wood,/area/prishtina/houses/sov_ten)
"ca" = (/obj/structure/bed/chair/wood/red,/turf/floor/wood,/area/prishtina/houses/sov_eight)
"cb" = (/turf/floor/wood,/area/prishtina/houses/sov_eight)
"cc" = (/obj/structure/filingcabinet,/turf/floor/wood,/area/prishtina/houses/sov_eight)
"cd" = (/obj/structure/light/small{dir = 8},/turf/floor/lino{tag = "icon-grimy"; icon_state = "grimy"},/area/prishtina/houses/sov_eight)
"ce" = (/turf/floor/carpet,/area/prishtina/houses/sov_ten)
"cf" = (/obj/structure/sign/wide/carpet,/turf/floor/wood,/area/prishtina/houses/sov_ten)
"cg" = (/obj/structure/bed/chair/comfy/beige{tag = "icon-comfychair_preview (WEST)"; icon_state = "comfychair_preview"; dir = 8},/turf/floor/wood,/area/prishtina/houses/sov_ten)
"ch" = (/obj/effect/floor_decal/spline/fancy/wood{tag = "icon-spline_fancy (NORTHWEST)"; icon_state = "spline_fancy"; dir = 9},/turf/floor/carpet,/area/prishtina/houses/sov_ten)
"ci" = (/obj/structure/table/wood,/obj/effect/floor_decal/spline/fancy/wood{tag = "icon-spline_fancy (NORTH)"; icon_state = "spline_fancy"; dir = 1},/obj/item/weapon/paper_bin,/turf/floor/carpet,/area/prishtina/houses/sov_ten)
"cj" = (/obj/effect/floor_decal/spline/fancy/wood{tag = "icon-spline_fancy (NORTHEAST)"; icon_state = "spline_fancy"; dir = 5},/turf/floor/carpet,/area/prishtina/houses/sov_ten)
"ck" = (/obj/effect/floor_decal/spline/fancy/wood{tag = "icon-spline_fancy (EAST)"; icon_state = "spline_fancy"; dir = 4},/obj/structure/curtain/open/bed,/obj/structure/window/classic,/turf/floor/wood,/area/prishtina/houses/sov_ten)
"cl" = (/obj/structure/table/wood,/obj/item/weapon/paper_bin,/obj/structure/light/small{dir = 8},/turf/floor/wood,/area/prishtina/houses/sov_eight)
"cm" = (/obj/structure/simple_door/key_door/anyone/wood,/obj/effect/floor_decal/spline/fancy/wood{tag = "icon-spline_fancy (WEST)"; icon_state = "spline_fancy"; dir = 8},/turf/floor/lino{tag = "icon-grimy"; icon_state = "grimy"},/area/prishtina/houses/sov_eight)
"cn" = (/obj/structure/light/small{dir = 8},/turf/floor/carpet,/area/prishtina/houses/sov_ten)
"co" = (/obj/structure/light/small{dir = 4},/turf/floor/wood,/area/prishtina/houses/sov_ten)
"cp" = (/obj/structure/bed/chair/wood/red{tag = "icon-wooden_chair_red (EAST)"; icon_state = "wooden_chair_red"; dir = 4},/obj/effect/floor_decal/spline/fancy/wood{tag = "icon-spline_fancy (WEST)"; icon_state = "spline_fancy"; dir = 8},/turf/floor/carpet,/area/prishtina/houses/sov_ten)
"cq" = (/obj/structure/table/wood,/obj/item/weapon/stamp/internalaffairs,/turf/floor/carpet,/area/prishtina/houses/sov_ten)
"cr" = (/obj/effect/floor_decal/spline/fancy/wood{tag = "icon-spline_fancy (EAST)"; icon_state = "spline_fancy"; dir = 4},/obj/structure/bed/chair/wood/red{tag = "icon-wooden_chair_red (WEST)"; icon_state = "wooden_chair_red"; dir = 8},/turf/floor/carpet,/area/prishtina/houses/sov_ten)
"cs" = (/obj/structure/light/small{dir = 8},/turf/floor/plating/cobblestone/vertical{tag = "icon-cobble_vertical"; icon_state = "cobble_vertical"},/area/prishtina/farm1{base_turf = /turf/floor/dirt; name = "Streets - Northern"})
"ct" = (/obj/effect/floor_decal/spline/fancy/wood{tag = "icon-spline_fancy (NORTH)"; icon_state = "spline_fancy"; dir = 1},/obj/structure/simple_door/key_door/anyone/wood,/turf/floor/wood,/area/prishtina/houses/sov_ten)
"cu" = (/obj/structure/simple_door/key_door/anyone/wood,/turf/floor/wood,/area/prishtina/houses/sov_ten)
"cv" = (/obj/effect/floor_decal/spline/fancy/wood{tag = "icon-spline_fancy (SOUTHWEST)"; icon_state = "spline_fancy"; dir = 10},/turf/floor/carpet,/area/prishtina/houses/sov_ten)
"cw" = (/obj/structure/table/wood,/obj/effect/floor_decal/spline/fancy/wood,/obj/item/weapon/phone,/turf/floor/carpet,/area/prishtina/houses/sov_ten)
"cx" = (/obj/effect/floor_decal/spline/fancy/wood{tag = "icon-spline_fancy (SOUTHEAST)"; icon_state = "spline_fancy"; dir = 6},/turf/floor/carpet,/area/prishtina/houses/sov_ten)
"cy" = (/obj/effect/floor_decal/spline/fancy/wood,/obj/structure/simple_door/key_door/anyone/wood,/turf/floor/wood,/area/prishtina/houses/sov_eight)
"cz" = (/obj/structure/toilet{step_y = 0},/turf/floor/wood,/area/prishtina/houses/sov_ten)
"cA" = (/obj/structure/sink{tag = "icon-sink (EAST)"; icon_state = "sink"; dir = 4; step_x = 0; step_y = 0; pixel_x = 14},/obj/structure/mirror{pixel_x = 26; pixel_y = 9; step_x = 0; step_y = 0},/obj/structure/light/small,/turf/floor/wood,/area/prishtina/houses/sov_ten)
"cB" = (/obj/structure/bed/chair/wood/red{tag = "icon-wooden_chair_red (EAST)"; icon_state = "wooden_chair_red"; dir = 4},/turf/floor/wood,/area/prishtina/houses/sov_ten)
"cC" = (/obj/structure/table/wood,/obj/item/weapon/reagent_containers/food/drinks/teapot,/turf/floor/wood,/area/prishtina/houses/sov_ten)
"cD" = (/obj/structure/bed/chair/wood/red{tag = "icon-wooden_chair_red (WEST)"; icon_state = "wooden_chair_red"; dir = 8},/turf/floor/wood,/area/prishtina/houses/sov_ten)
"cE" = (/turf/wall/iron,/area/prishtina/houses/sov_eight)
"cF" = (/obj/effect/floor_decal/spline/fancy/wood,/obj/structure/curtain/open/bed,/obj/structure/window/classic,/turf/floor/wood,/area/prishtina/houses/sov_eight)
"cG" = (/obj/effect/floor_decal/corner/grey/border{dir = 4},/turf/floor/plating/cobblestone/vertical/dark,/area/prishtina/farm1{base_turf = /turf/floor/dirt; name = "Streets - Northern"})
"cH" = (/turf/wall/iron,/area/prishtina/houses/sov_ten)
"cI" = (/obj/effect/floor_decal/spline/fancy/wood,/obj/structure/curtain/open/bed,/obj/structure/window/classic,/turf/floor/wood,/area/prishtina/houses/sov_ten)
"cJ" = (/obj/effect/floor_decal/corner/grey/border,/obj/structure/light/small{dir = 1},/turf/floor/plating/cobblestone/vertical{tag = "icon-cobble_vertical"; icon_state = "cobble_vertical"},/area/prishtina/farm1{base_turf = /turf/floor/dirt; name = "Streets - Northern"})
"cK" = (/obj/effect/landmark{name = "JoinLateCivilian"},/turf/floor/plating/grass/wild,/area/prishtina/farm1{base_turf = /turf/floor/dirt; name = "Streets - Northern"})
"cL" = (/obj/effect/landmark{name = "JoinLateRA"},/turf/floor/plating/grass/wild,/area/prishtina/farm1{base_turf = /turf/floor/dirt; name = "Streets - Northern"})
"cM" = (/obj/map_metadata/streetfighter,/turf/floor/plating/grass/wild,/area/prishtina/farm1{base_turf = /turf/floor/dirt; name = "Streets - Northern"})
"cN" = (/obj/structure/sign/clock{step_y = 0},/turf/wall/iron,/area/prishtina/houses/sov_eight)
"cO" = (/obj/item/clothing/under/det,/obj/structure/closet/cabinet,/obj/item/ammo_magazine/c38,/obj/item/weapon/gun/projectile/revolver/detective,/obj/item/weapon/legcuffs,/obj/item/weapon/reagent_containers/food/drinks/flask/detflask,/obj/item/weapon/storage/fancy/candle_box,/obj/item/clothing/mask/smokable/pipe,/turf/floor/carpet,/area/prishtina/houses/sov_ten)
"cP" = (/obj/structure/sign/greencross{step_y = 0},/turf/wall/iron,/area/prishtina/houses/sov_eight)
"cQ" = (/obj/effect/floor_decal/corner/grey/border,/turf/floor/plating/cobblestone/vertical/dark,/area/prishtina/farm1{base_turf = /turf/floor/dirt; name = "Streets - Northern"})

(1,1,1) = {"
aaaaaaaaaaaaaaaaaaaaaaaaaaaaaaaaaaaaaaaaaaaaaaaaaaaaaaaaaaaaaaaaaaaaaaaaaaaaaaaaaaaaaaaaaaaaaaaaaaaa
aaaaaaaaaaaaaaaaaaaaaaaaaaaaaaaaaaaaaaaaaaaaaaaaaaaaaaaaaaaaaaaaaaaaaaaaaaaaaaaaaaaaaaaaaaaaaaaaaaaa
aaaaaaaaaaaaababaaabaaaaaaaaaaaaaaaaaaaaaaaaaaaaaaaaaaaaaaaaaaaaaaaaaaaaaaaaaaaaaaaaaaaaaaaaaaaaaaaa
aaaaaaaaaaaaaaaaaaaaaaaaaaaaaaaaaaaaaaaaaaaaaaaaaaaaaaaaaaaaaaaaaaaaaaaaaaaaaaaaaaaaaaaaaaaaaaaaaaaa
aaaaaaaaaaaaaaaaaaaaaaaaaaaaaaaaaaaaaaaaaaaaaaaaaaaaaaaaaaaaaaaaaaaaaaaaaaaaaaaaaaaaaaaaaaaaaaaaaaaa
aaaaaaaaaaaaaaaaaaaaaaaaaaaaaaaaaaaaaaaaaaaaaaaaaaaaaaaaaaaaaaaaaaaaaaaaaaaaaaaaaaaaaaaaaaaaaaaaaaaa
aaaaaaaaaaaaaaaaaaaaaaaaaaaaaaaaaaaaaaaaaaaaaaaaaaaaaaaaaaaaaaaaaaaaaaaaaaaaaaaaaaaaaaaaaaaaaaaaaaaa
acacacacacadacacaeafafafafafafafagagagagagagagagagagagagagagagagagagagagagagagagagagagagagagagahagag
aDaDaDaDaDaDaDaiacacacacadacacalafafafafafafafafafafafafafafafafafafafafafafafafafafafafafafamagagan
aDaDaDaDaDaDaDaDaDaDaDaDaDaDaiacacacacadacacacadacacacacacatacacacacacacacacacacacacacacacacauagagav
aiaiajaiaiakaiaiaiajaiaiakaiaiaiajaiaiakaiaAaAaBaAaCaAaCaAaAaFaFaGaGaGaGaGaGaGaHaHaHaHaHaHacauagagav
aiaoapaiaqarasaiaoapaiaqarasaiaoapaiaqarasaAaIaIaIaIaIaIaIaAaKaKaGaLaLaLaLbsbsaMaRaHbdbdaHacauagagav
aiawaxayararazaiawaxayararazaiawaxayararazaAaIaIaIaIaIaIaQaAaKaKaGaLaLaLaLbfbfbdbdbhbdbdaHacauagagav
aiaxaxaiarararaiaxaxaiarararaiaxaxaiarararaAaAaAaXaXaYaZbaaAaKaKaGaLaLaLaLaLaLbdbmaHbdbdaHacauagagav
aiaiaOaiararaPaiaiaOaiararaPaiaiaOaiararaPaAbcaAaIaIaIaIaIaAaKaKaGaGaGaGaGaGaGaHaHaHbdbdaHacauagagav
bnbpbrbnbtbvbCaiaSaTaiaUaVaWaiaSaTaiaUaVaWaAaIbiaIbjbkblaIaAaKaKaGaLaLaLbDaGbEbLbNaHbdbdaHacauagagav
bnbnbnbnbnbObnbnbnbnbnbnbObnaiaiaiaiaibbaiaAaAaAaAaAaAaAboaAaKaKaGbSaLaLbTaGbSbSaLaGaLaLaGacauagagav
acaaaJaJaaaaaaaaaaaaaaaaaaaaaaaaaaaaaaaKaKaKaKaKaKaKaKaKaFbVaKaKaGbscDaLaLaGbsbsaLaGaLaLaGacauagagav
acaaaaaJaJaJaaaaaaaaaaaaaaaaaaaaaaaaaaaKaKaKaKaKaKaKaKaKaKaKaKaKaGbsaLaLbEaGaLaLaLaGaLaLaGacauagagav
acaaaaaaaaaaaaaaaaaaaaaaaaaJaaaaaaaaaaaKaKcEcEcEcEcEcEcEcEcEaKaKaGaGbqaGaGaGaGbqaGaGaLaLaGacauagagav
acaaaaaaaaaaaJaJaaaaaaaaaaaJaJaJaaaaaaaKaKcEbwbxbybubzbAbBcEaKaKaGaLaLaLaLaLaLaLaLaLaLaLaGacauagagav
acaaaaaaaJaJaaaJaJaJaaaaaaaaaaaaaaaaaaaKaKcEbGbHbHbIbJbJbKcEaKcGaLaLaLaLaLaLaLaLaLaLaLaLaGacauagagav
acaaaaaaaJaaaJaaaabPaJaJaaaaaaaaaaaaaaaKaKcEbQbHbRcEbJbJbKcEaKaKcHcHcHcHcHcHcHcHcHcHcHcHcHacauagagav
acaaaaaaaaaaaJaJaaaJaaaJaJaJaaaaaaaaaaaKaKcEcNbUcEcEbJbJbKcEaKaKcHcObWcHbXbXbYcHaLbZaLaLcHacauagagav
acaaaaaaaaaaaaaaaaaaaaaaaaaJaJaJaaaaaaaKaKcEcacbcccEcdbJbKcEaKaKcHcecebMcfaLcgcHchcicjaLckacauagagav
acaaaaaaaaaaaaaaaaaaaJaJaaaaaaaJaJaaaaaKaKcEclcbcbcmbJbJbKcEaKaKcHcncecHaLaLcocHcpcqcraLcHcsauagagav
acaaaaaaaaaaaaaaaaaaaaaJaaaaaaaaaaaJaJaKaKcEcbcbcbcEbJbJbKcEaKaKcHaEctcHaLaLaLcucvcwcxaLbeaNauagagav
acaaaaaaaaaaaaaaaaaaaaaaaJaaaaaaaaaaaJaKaKcEcEcycEcEbJbJbKcEaKaKcHczcAcHcBcCcDcHaLbFaLaLcHacauagagav
acaaaaaJaJaJaaaaaaaaaJaJaaaaaaaaaaaaaaaKaKcEacbgaccPcFcEcFcEcQcQcHcHcHcHcHcIaEcHcHcHcHcHcHacauagagav
adadadadadadadadadadadadadadadadadadadadadcJadadadadadadadcJadadadadadadadadadadadadadadadadauagagav
agagagagagagagagagagagagagagagagagagagagagagagagagagagagagagagagagagagagagagagagagagagagagagagagagag
aaaaaaaaaaaaaaaaaaaaaaaaaaaaaaaaaaaaaaaaaaaaaaaaaaaaaaaaaaaaaaaaaaaaaaaaaaaaaaaaaaaaaaaaaaaaaaaaaaaa
aaaaaaaaaaaaaaaaaaaaaaaaaaaaaaaaaaaaaaaaaaaaaaaaaaaaaaaaaaaaaaaaaaaaaaaaaaaaaaaaaaaaaaaaaaaaaaaaaaaa
aaaaaaaaaaaaaaaaaaaaaaaaaaaaaaaaaaaaaaaaaaaaaaaaaaaaaaaacKaaaaaacKaacKaaaaaaaaaaaaaaaaaaaaaaaaaaaaaa
aaaaaaaaaaaaaaaaaaaaaaaaaaaaaaaaaaaaaaaaaaaaaaaaaaaaaaaaaaaaaaaaaaaaaaaaaaaaaaaaaaaaaaaaaaaaaaaaaaaa
aaaaaaaaaaaaaaaaaaaaaaaaaaaaaaaaaaaaaaaaaaaaaaaaaaaaaaaaaaaaaaaaaaaaaaaaaaaaaaaaaaaaaaaaaaaaaaaaaaaa
aaaaaaaaaaaaaaaaaaaaaaaaaaaaaaaaaaaaaaaaaaaaaaaaaaaaaaaaaaaaaaaaaaaaaaaaaaaaaaaaaaaaaaaaaaaaaaaaaaaa
aaaaaaaaaaaaaaaaaaaaaaaaaaaaaaaaaaaaaaaaaaaaaaaaaaaaaaaaaaaaaaaaaaaaaaaaaaaaaaaaaaaaaaaaaaaaaaaaaaaa
aaaaaaaaaaaaaaaaaaaaaaaaaaaaaaaaaaaaaaaaaaaaaaaaaaaaaaaaaaaaaaaaaaaaaaaaaaaaaaaaaaaaaaaaaaaaaaaaaaaa
aaaaaaaaaaaaaaaaaaaaaaaaaaaaaaaaaaaaaaaaaaaaaaaaaaaaaaaaaaaaaaaaaaaaaaaaaaaaaaaaaaaaaaaaaaaaaaaaaaaa
aaaaaaaaaaaaaaaaaaaaaaaaaaaaaaaaaaaaaaaaaaaaaaaaaaaaaaaaaaaaaaaaaaaaaaaaaaaaaaaaaaaaaaaaaaaaaaaaaaaa
aaaaaaaaaaaaaaaaaaaaaaaaaaaaaaaaaaaaaaaaaaaaaaaaaaaaaaaaaaaaaaaaaaaaaaaaaaaaaaaaaaaaaaaaaaaaaaaaaaaa
aaaaaaaaaaaaaaaaaaaaaaaaaaaaaaaaaaaaaaaaaaaaaaaaaaaaaaaaaaaaaaaaaaaaaaaaaaaaaaaaaaaaaaaaaaaaaaaaaaaa
aaaaaaaaaaaaaaaaaaaaaaaaaaaaaaaaaaaaaaaaaaaaaaaaaaaaaaaaaaaaaaaaaaaaaaaaaaaaaaaaaaaaaaaaaaaaaaaaaaaa
aaaaaaaaaaaaaaaaaaaaaaaaaaaaaaaaaaaaaaaaaaaaaaaaaaaaaaaaaaaaaaaaaaaaaaaaaaaaaaaaaaaaaaaaaaaaaaaaaaaa
aaaaaaaaaaaaaaaaaaaaaaaaaaaaaaaaaaaaaaaaaaaaaaaaaaaaaaaaaaaaaaaaaaaaaaaaaaaaaaaaaaaaaaaaaaaaaaaaaaaa
aaaaaaaaaaaaaaaaaaaaaaaaaaaaaaaaaaaaaaaaaaaaaaaaaaaaaaaaaaaaaaaaaaaaaaaaaaaaaaaaaaaaaaaaaaaaaaaaaaaa
aaaaaaaaaaaaaaaaaaaaaaaaaaaaaaaaaaaaaaaaaaaaaaaaaaaaaaaaaaaaaaaaaaaaaaaaaaaaaaaaaaaaaaaaaaaaaaaaaaaa
aaaaaaaaaaaaaaaaaaaaaaaaaaaaaaaaaaaaaaaaaaaaaaaaaaaaaaaaaaaaaaaaaaaaaacLaaaaaacLaacLcLaaaaaaaaaaaaaa
cMaaaaaaaaaaaaaaaaaaaaaaaaaaaaaaaaaaaaaaaaaaaaaaaaaaaaaaaaaaaaaaaaaaaaaaaaaaaaaaaaaaaaaaaaaaaaaaaaaa
"}
