"aa" = (/turf/floor/beach/water/deep/saltwater,/area/caribbean/sea/bottom)
"ab" = (/obj/map_metadata/voyage,/turf/floor/beach/water/deep/saltwater,/area/caribbean/sea/bottom)
"ac" = (/obj/effect/landmark{name = "Grappling Hook area - do not block"},/turf/floor/beach/water/deep/saltwater,/area/caribbean/sea/bottom)
"ad" = (/obj/structure/barricade/ship/wood/a4,/turf/floor/beach/water/deep/saltwater,/area/caribbean/sea/bottom/roofed)
"ae" = (/obj/structure/barricade/ship/wood/a7,/turf/floor/beach/water/deep/saltwater,/area/caribbean/sea/bottom/roofed)
"af" = (/obj/structure/barricade/ship/wood/a9,/turf/floor/beach/water/deep/saltwater,/area/caribbean/sea/bottom/roofed)
"ag" = (/obj/structure/barricade/ship/wood/a7,/obj/item/flashlight/lantern/on/anchored,/turf/floor/beach/water/deep/saltwater,/area/caribbean/sea/bottom/roofed)
"ah" = (/obj/structure/barricade/ship/wood/a10,/obj/item/flashlight/lantern/on/anchored,/turf/floor/beach/water/deep/saltwater,/area/caribbean/sea/bottom/roofed)
"ai" = (/obj/covers/wood_ship,/obj/structure/closet/crate/chest,/obj/item/stack/money/real/fifty,/turf/floor/beach/water/deep/saltwater,/area/caribbean/sea/bottom/roofed)
"aj" = (/obj/structure/barricade/ship/wood/a12,/turf/floor/beach/water/deep/saltwater,/area/caribbean/sea/bottom/roofed)
"ak" = (/obj/covers/wood_ship,/obj/structure/closet/crate/musketball_pistol,/turf/floor/beach/water/deep/saltwater,/area/caribbean/sea/bottom/roofed)
"al" = (/obj/covers/wood_ship,/turf/floor/beach/water/deep/saltwater,/area/caribbean/sea/bottom/roofed)
"am" = (/obj/covers/wood_ship,/obj/structure/barricade/ship/blue/bport_north,/obj/effect/landmark{name = "Grappling Hook area - do not block"},/turf/floor/broken_floor,/area/caribbean/sea/bottom)
"an" = (/obj/covers/wood_ship,/obj/item/weapon/reagent_containers/glass/barrel/tea,/turf/floor/beach/water/deep/saltwater,/area/caribbean/sea/bottom/roofed)
"ao" = (/obj/structure/barricade/ship/wood/a5,/obj/item/flashlight/lantern/on/anchored,/turf/floor/beach/water/deep/saltwater,/area/caribbean/sea/bottom/roofed)
"ap" = (/obj/structure/barricade/ship/wood/a2,/turf/floor/beach/water/deep/saltwater,/area/caribbean/sea/bottom/roofed)
"aq" = (/obj/covers/wood_ship,/obj/structure/closet/crate/chest,/obj/item/stack/money/goldvaluables,/turf/floor/beach/water/deep/saltwater,/area/caribbean/sea/bottom/roofed)
"ar" = (/obj/structure/barricade/ship/wood/a12,/obj/item/flashlight/lantern/on/anchored,/turf/floor/beach/water/deep/saltwater,/area/caribbean/sea/bottom/roofed)
"as" = (/obj/covers/wood_ship,/mob/living/simple_animal/hostile/human/voyage/spanish,/turf/floor/beach/water/deep/saltwater,/area/caribbean/sea/bottom/roofed)
"at" = (/obj/covers/wood_ship,/obj/item/weapon/reagent_containers/glass/barrel/rum,/turf/floor/beach/water/deep/saltwater,/area/caribbean/sea/bottom/roofed)
"au" = (/obj/structure/barricade/ship/wood/a5,/turf/floor/beach/water/deep/saltwater,/area/caribbean/sea/bottom/roofed)
"av" = (/obj/covers/wood_ship,/obj/structure/simple_door/key_door/anyone,/turf/floor/beach/water/deep/saltwater,/area/caribbean/sea/bottom/roofed)
"ay" = (/obj/covers/wood_ship,/obj/structure/closet/crate/cannonball,/turf/floor/beach/water/deep/saltwater,/area/caribbean/sea/bottom/roofed)
"aA" = (/obj/covers/wood_ship,/obj/structure/closet/crate/rations/biscuits,/turf/floor/beach/water/deep/saltwater,/area/caribbean/sea/bottom/roofed)
"aB" = (/obj/covers/wood_ship,/obj/structure/closet/crate/rations/fruits,/turf/floor/beach/water/deep/saltwater,/area/caribbean/sea/bottom/roofed)
"aC" = (/obj/covers/wood_ship,/obj/structure/closet/crate/wood,/turf/floor/beach/water/deep/saltwater,/area/caribbean/sea/bottom/roofed)
"aD" = (/obj/covers/wood_ship,/obj/structure/multiz/ladder/ww2/up,/turf/floor/beach/water/deep/saltwater,/area/caribbean/sea/bottom/roofed)
"aE" = (/obj/covers/wood_ship,/mob/living/simple_animal/hostile/human/voyage/spanish/ranged,/turf/floor/beach/water/deep/saltwater,/area/caribbean/sea/bottom/roofed)
"aF" = (/obj/covers/wood_ship,/obj/structure/barricade/ship/blue/bport_6/corner,/obj/structure/barricade/ship/blue/b20{dir = 1},/turf/floor/beach/water/deep/saltwater,/area/caribbean/sea/bottom/roofed)
"aG" = (/obj/structure/barricade/ship/blue/b8,/turf/floor/beach/water/deep/saltwater,/area/caribbean/sea/bottom/roofed)
"aH" = (/obj/structure/barricade/ship/blue/b17,/turf/floor/beach/water/deep/saltwater,/area/caribbean/sea/bottom/roofed)
"aI" = (/obj/structure/barricade/ship/blue/b20,/obj/item/flashlight/lantern/on/anchored,/turf/floor/beach/water/deep/saltwater,/area/caribbean/sea/bottom/roofed)
"aJ" = (/obj/covers/wood_ship,/obj/structure/closet/crate/musketball,/turf/floor/beach/water/deep/saltwater,/area/caribbean/sea/bottom/roofed)
"aK" = (/obj/covers/wood_ship,/obj/structure/vending/muskets/spanish,/turf/floor/beach/water/deep/saltwater,/area/caribbean/sea/bottom/roofed)
"aL" = (/obj/covers/wood_ship,/obj/item/weapon/material/sword/cutlass,/obj/item/weapon/material/sword/cutlass,/obj/item/weapon/material/sword/cutlass,/obj/item/weapon/material/sword/cutlass,/obj/item/weapon/material/sword/cutlass,/turf/floor/beach/water/deep/saltwater,/area/caribbean/sea/bottom/roofed)
"aM" = (/obj/covers/wood_ship,/obj/item/weapon/reagent_containers/glass/barrel/gunpowder,/turf/floor/beach/water/deep/saltwater,/area/caribbean/sea/bottom/roofed)
"aN" = (/obj/structure/barricade/ship/blue/b20{dir = 1},/obj/item/flashlight/lantern/on/anchored,/turf/floor/beach/water/deep/saltwater,/area/caribbean/sea/bottom/roofed)
"aO" = (/obj/structure/barricade/ship/blue/b9,/turf/floor/beach/water/deep/saltwater,/area/caribbean/sea/bottom/roofed)
"aP" = (/obj/structure/barricade/ship/blue/b9,/obj/item/flashlight/lantern/on/anchored,/turf/floor/beach/water/deep/saltwater,/area/caribbean/sea/bottom/roofed)
"aQ" = (/obj/structure/barricade/ship/wood/a4,/obj/structure/flag/spanish,/turf/floor/broken_floor,/area/caribbean/sea/bottom/roofed)
"aR" = (/obj/structure/barricade/ship/wood/a7,/turf/floor/broken_floor,/area/caribbean/sea/bottom/roofed)
"aS" = (/obj/structure/barricade/ship/wood/a9,/turf/floor/broken_floor,/area/caribbean/sea/bottom/roofed)
"aT" = (/obj/covers/wood_ship,/obj/structure/barricade/ship/blue/bport_north,/turf/floor/broken_floor,/area/caribbean/sea/bottom)
"aU" = (/obj/structure/barricade/ship/blue/bport3{icon_state = "boat_b_port3"; dir = 1},/obj/covers/repairedfloor/ship/south,/turf/floor/broken_floor,/area/caribbean/sea/bottom)
"aV" = (/obj/structure/barricade/ship/blue/bport_north,/obj/covers/wood_ship,/turf/floor/broken_floor,/area/caribbean/sea/bottom)
"aW" = (/obj/covers/wood_ship,/obj/structure/barricade/ship/blue/bport_10,/turf/floor/broken_floor,/area/caribbean/sea/bottom)
"aX" = (/obj/structure/barricade/ship/wood/a4,/turf/floor/broken_floor,/area/caribbean/sea/bottom/roofed)
"aY" = (/obj/structure/barricade/ship/wood/a10,/obj/item/flashlight/lantern/on/anchored,/turf/floor/broken_floor,/area/caribbean/sea/bottom/roofed)
"aZ" = (/obj/covers/wood_ship,/obj/structure/table/wood,/turf/floor/broken_floor,/area/caribbean/sea/bottom/roofed)
"ba" = (/obj/covers/wood_ship,/turf/floor/broken_floor,/area/caribbean/sea/bottom/roofed)
"bb" = (/obj/structure/barricade/ship/wood/a12,/turf/floor/broken_floor,/area/caribbean/sea/bottom/roofed)
"bc" = (/obj/covers/wood_ship,/turf/floor/broken_floor,/area/caribbean/sea/bottom)
"bd" = (/obj/covers/wood_ship,/obj/structure/voyage/ropeladder/thin{dir = 1},/turf/floor/broken_floor,/area/caribbean/sea/bottom)
"be" = (/obj/covers/wood_ship,/obj/structure/cannon/modern/tank/voyage/autofire{icon_state = "cannon"; dir = 1},/turf/floor/broken_floor,/area/caribbean/sea/bottom)
"bf" = (/obj/covers/wood_ship,/obj/structure/barricade/ship/blue/bport5/corner,/turf/floor/broken_floor,/area/caribbean/sea/bottom)
"bg" = (/obj/structure/barricade/ship/wood/a2,/turf/floor/broken_floor,/area/caribbean/sea/bottom/roofed)
"bh" = (/obj/covers/wood_ship,/obj/structure/table/wood,/obj/item/weapon/paper,/obj/item/weapon/paper,/turf/floor/broken_floor,/area/caribbean/sea/bottom/roofed)
"bi" = (/obj/structure/barricade/ship/wood/a12,/obj/item/flashlight/lantern/on/anchored,/turf/floor/broken_floor,/area/caribbean/sea/bottom/roofed)
"bj" = (/obj/covers/wood_ship,/obj/structure/voyage/shipbell,/turf/floor/broken_floor,/area/caribbean/sea/bottom)
"bk" = (/obj/covers/wood_ship,/mob/living/simple_animal/hostile/human/voyage/spanish,/turf/floor/broken_floor,/area/caribbean/sea/bottom)
"bl" = (/obj/covers/wood_ship,/obj/structure/bed/chair/wood/red{dir = 4},/mob/living/simple_animal/hostile/human/voyage/spanish/ranged/sgt,/turf/floor/broken_floor,/area/caribbean/sea/bottom/roofed)
"bm" = (/obj/covers/wood_ship,/obj/structure/table/wood,/obj/item/weapon/pen,/obj/item/weapon/paper,/turf/floor/broken_floor,/area/caribbean/sea/bottom/roofed)
"bn" = (/obj/covers/wood_ship,/obj/structure/simple_door/key_door/anyone,/turf/floor/broken_floor,/area/caribbean/sea/bottom/roofed)
"bo" = (/obj/covers/wood_ship,/obj/structure/voyage/grid/partial{dir = 6},/turf/floor/broken_floor,/area/caribbean/sea/bottom)
"bp" = (/obj/covers/wood_ship,/mob/living/simple_animal/hostile/human/voyage/spanish/ranged,/turf/floor/broken_floor,/area/caribbean/sea/bottom)
"bq" = (/obj/covers/wood_ship,/obj/structure/voyage/grid/partial{dir = 10},/turf/floor/broken_floor,/area/caribbean/sea/bottom)
"br" = (/obj/covers/wood_ship,/obj/structure/barricade/ship/mast/large,/obj/item/flashlight/lantern/on/anchored,/turf/floor/broken_floor,/area/caribbean/sea/bottom)
"bs" = (/obj/covers/wood_ship,/obj/structure/barricade/ship/blue/bport_6/corner,/turf/floor/broken_floor,/area/caribbean/sea/bottom)
"bt" = (/obj/covers/wood_ship,/obj/structure/barricade/ship/blue/bport0/south,/turf/floor/broken_floor,/area/caribbean/sea/bottom)
"bu" = (/obj/covers/wood_ship,/obj/structure/barricade/ship/blue/bport9,/turf/floor/broken_floor,/area/caribbean/sea/bottom)
"bv" = (/obj/covers/wood_ship,/obj/structure/multiz/ladder/ww2,/turf/floor/broken_floor,/area/caribbean/sea/bottom)
"bw" = (/obj/covers/wood_ship,/obj/structure/voyage/grid/partial{dir = 5},/turf/floor/broken_floor,/area/caribbean/sea/bottom)
"bx" = (/obj/covers/wood_ship,/obj/structure/voyage/grid/partial{dir = 9},/turf/floor/broken_floor,/area/caribbean/sea/bottom)
"by" = (/obj/structure/barricade/ship/blue/b17,/turf/floor/broken_floor,/area/caribbean/sea/bottom/roofed)
"bz" = (/obj/structure/barricade/ship/blue/b20,/obj/item/flashlight/lantern/on/anchored,/turf/floor/broken_floor,/area/caribbean/sea/bottom/roofed)
"bA" = (/obj/covers/wood_ship,/obj/structure/bed/padded,/obj/item/weapon/bedsheet/brown,/turf/floor/broken_floor,/area/caribbean/sea/bottom/roofed)
"bB" = (/obj/covers/wood_ship,/obj/structure/closet/cabinet,/obj/item/weapon/gun/projectile/flintlock/duellingpistol,/obj/item/ammo_casing/musketball_pistol,/turf/floor/broken_floor,/area/caribbean/sea/bottom/roofed)
"bC" = (/obj/structure/barricade/ship/blue/b17,/obj/structure/flag/spanish,/turf/floor/broken_floor,/area/caribbean/sea/bottom/roofed)
"bD" = (/obj/structure/barricade/ship/blue/b9,/turf/floor/broken_floor,/area/caribbean/sea/bottom/roofed)
"bE" = (/obj/structure/barricade/ship/blue/b8,/turf/floor/broken_floor,/area/caribbean/sea/bottom/roofed)
"bF" = (/obj/structure/barricade/ship/blue/bport0/south,/obj/covers/wood_ship,/turf/floor/broken_floor,/area/caribbean/sea/bottom)
"bG" = (/obj/covers/wood_ship,/obj/structure/barricade/ship/blue/bport0/south,/obj/structure/voyage/ropeladder/thin,/turf/floor/broken_floor,/area/caribbean/sea/bottom)
"bH" = (/obj/covers/wood_ship,/obj/structure/barricade/ship/blue/bport3,/obj/structure/cannon/modern/tank/voyage/autofire,/turf/floor/broken_floor,/area/caribbean/sea/bottom)

(1,1,1) = {"
aaaaaaaaaaaaaaaaaaaaaaaaaaaaaaaaaaaaaaaaaaaaaaaaaaaaaaaaaaaaaaaaaaaaaaaaaaaaaaaaaaaaaaaaaaaaaaaaaaaaaaaaaaaaaaaaaaaaaaaaaaaaaaaaaaaaaaaaaaaaaaaaaaaaaa
aaaaaaaaaaaaaaaaaaaaaaaaaaaaaaaaaaaaaaaaaaaaaaaaaaaaaaaaaaaaaaaaaaaaaaaaaaaaaaaaaaaaaaaaaaaaaaaaaaaaaaaaaaaaaaaaaaaaaaaaaaaaaaaaaaaaaaaaaaaaaaaaaaaaaa
aaaaaaaaaaaaaaaaaaaaaaaaaaaaaaaaaaaaaaaaaaaaaaaaaaaaaaaaaaaaaaaaaaaaaaaaaaaaaaaaaaaaaaaaaaaaaaaaaaaaaaaaaaaaaaaaaaaaaaaaaaaaaaaaaaaaaaaaaaaaaaaaaaaaaa
aaaaaaaaaaaaaaaaaaaaaaaaaaaaaaaaaaaaaaaaaaaaaaaaaaaaaaaaaaaaaaaaaaaaaaaaaaaaaaaaaaaaaaaaaaaaaaaaaaaaaaaaaaaaaaaaaaaaaaaaaaaaaaaaaaaaaaaaaaaaaaaaaaaaaa
aaaaaaaaaaaaaaaaaaaaaaaaaaaaaaadaeaeaeafaeaeaeaeaeaeaeaeagaeaeaeaeaeaeagaeaeaeaeaeaeaeaeafaaaaaaaaaaaaaaaaaaaaaaaaaaaaaaaaaaaaaaaaaaaaaaaaaaaaaaaaaaaa
aaaaaaaaaaaaaaaaaaaaaaaaaaaaadahaiaiaEajakalalalalalalalalalalalalalalalalalalalalanananaoafaaaaaaaaaaaaaaaaaaaaaaaaaaaaaaaaaaaaaaaaaaaaaaaaaaaaaaaaaa
aaaaaaaaaaaaaaaaaaaaaaaaaaaaapalalalalaralalalalalalalalalalalasalalalalalalalalalalalalalauafaaaaaaaaaaaaaaaaaaaaaaaaaaaaaaaaaaaaaaaaaaaaaaaaaaaaaaaa
aaaaaaaaaaaaaaaaaaaaaaaaaaaaapaqalalalavalalasalalalayayalalaAaBaAalalalaCaCaCaCalasalalalatajaaaaaaaaaaaaaaaaaaaaaaaaaaaaaaaaaaaaaaaaaaaaaaaaaaaaaaaa
aaaaaaaaaaaaaaaaaaaaaaaaaaaaapaqalalalavalalalalalalayayalalaAaBaAalalalaCaCaCaCalalalalalatajaaaaaaaaaaaaaaaaaaaaaaaaaaaaaaaaaaaaaaaaaaaaaaaaaaaaaaaa
aaaaaaaaaaaaaaaaaaaaaaaaaaaaapalalalalaraDalalalalalalalalalalalaEalalalalalalalalalalalalaFaGaaaaaaaaaaaaaaaaaaaaaaaaaaaaaaaaaaaaaaaaaaaaaaaaaaaaaaaa
aaaaaaaaaaaaaaaaaaaaaaaaaaaaaHaIaiaiaEajalalalalalaJaKalaLaLaLalalalalalalalalalalalaMaMaNaGaaaaaaaaaaaaaaaaaaaaaaaaaaaaaaaaaaaaaaaaaaaaaaaaaaaaaaaaaa
aaaaaaaaaaaaaaaaaaaaaaaaaaaaaaaHaOaOaOaOaOaOaOaOaOaOaOaOaPaOaOaOaOaOaOaPaOaOaOaOaOaOaOaOaGaaaaaaaaaaaaaaaaaaaaaaaaaaaaaaaaaaaaaaaaaaaaaaaaaaaaaaaaaaaa
aaaaaaaaaaaaaaaaaaaaaaaaaaaaaaaaaaaaaaaaaaaaaaaaaaaaaaaaaaaaaaaaaaaaaaaaaaaaaaaaaaaaaaaaaaaaaaaaaaaaaaaaaaaaaaaaaaaaaaaaaaaaaaaaaaaaaaaaaaaaaaaaaaaaaa
aaaaaaaaaaaaaaaaaaaaaaaaaaaaaaaaaaaaaaaaaaaaaaaaaaaaaaaaaaaaaaaaaaaaaaaaaaaaaaaaaaaaaaaaaaaaaaaaaaaaaaaaaaaaaaaaaaaaaaaaaaaaaaaaaaaaaaaaaaaaaaaaaaaaaa
aaaaaaaaaaaaaaaaaaaaaaaaaaaaaaaaaaaaaaaaaaaaaaaaaaaaaaaaaaaaaaaaaaaaaaaaaaaaaaaaaaaaaaaaaaaaaaaaaaaaaaaaaaaaaaaaaaaaaaaaaaaaaaaaaaaaaaaaaaaaaaaaaaaaaa
aaaaaaaaaaaaaaaaaaaaaaaaaaaaaaaaaaaaaaaaaaaaaaaaaaaaaaaaaaaaaaaaaaaaaaaaaaaaaaaaaaaaaaaaaaaaaaaaaaaaaaaaaaaaaaaaaaaaaaaaaaaaaaaaaaaaaaaaaaaaaaaaaaaaaa
aaaaaaaaaaaaaaaaaaaaaaaaaaaaaaaaaaaaaaaaaaaaaaaaaaaaaaaaaaaaaaaaaaaaaaaaaaaaaaaaaaaaaaaaaaaaaaaaaaaaaaaaaaaaaaaaaaaaaaaaaaaaaaaaaaaaaaaaaaaaaaaaaaaaaa
aaaaaaaaaaaaaaaaaaaaaaaaaaaaaaaaaaaaaaaaaaaaaaaaaaaaaaaaaaaaaaaaaaaaaaaaaaaaaaaaaaaaaaaaaaaaaaaaaaaaaaaaaaaaaaaaaaaaaaaaaaaaaaaaaaaaaaaaaaaaaaaaaaaaaa
aaaaaaaaaaaaaaaaaaaaaaaaaaaaaaaaaaaaaaaaaaaaaaaaaaaaaaaaaaaaaaaaaaaaaaaaaaaaaaaaaaaaaaaaaaaaaaaaaaaaaaaaaaaaaaaaaaaaaaaaaaaaaaaaaaaaaaaaaaaaaaaaaaaaaa
aaaaaaaaaaaaaaaaaaaaaaaaaaaaaaaaaaaaaaaaaaaaaaaaaaaaaaaaaaaaaaaaaaaaaaaaaaaaaaaaaaaaaaaaaaaaaaaaaaaaaaaaaaaaaaaaaaaaaaaaaaaaaaaaaaaaaaaaaaaaaaaaaaaaaa
aaaaaaaaaaaaaaaaaaaaaaaaaaaaaaaaaaaaaaaaaaaaaaaaaaaaaaaaaaaaaaaaaaaaaaaaaaaaaaaaaaaaaaaaaaaaaaaaaaaaaaaaaaaaaaaaaaaaaaaaaaaaaaaaaaaaaaaaaaaaaaaaaaaaaa
aaaaaaaaaaaaaaaaaaaaaaaaaaaaaaaaaaaaaaaaaaaaaaaaaaaaaaaaaaaaaaaaaaaaaaaaaaaaaaaaaaaaaaaaaaaaaaaaaaaaaaaaaaaaaaaaaaaaaaaaaaaaaaaaaaaaaaaaaaaaaaaaaaaaaa
aaaaaaaaaaaaaaaaaaaaaaaaaaaaaaaaaaaaaaaaaaaaaaaaaaaaaaaaaaaaaaaaaaaaaaaaaaaaaaaaaaaaaaaaaaaaaaaaaaaaaaaaaaaaaaaaaaaaaaaaaaaaaaaaaaaaaaaaaaaaaaaaaaaaaa
aaaaaaaaaaaaaaaaaaaaaaaaaaaaaaaaaaaaaaaaaaaaaaaaaaaaaaaaaaaaaaaaaaaaaaaaaaaaaaaaaaaaaaaaaaaaaaaaaaaaaaaaaaaaaaaaaaaaaaaaaaaaaaaaaaaaaaaaaaaaaaaaaaaaaa
abaaaaaaaaaaaaaaaaaaaaaaaaaaaaaaaaaaaaaaaaaaaaaaaaaaaaaaaaaaaaaaaaaaaaaaaaaaaaaaaaaaaaaaaaaaaaaaaaaaaaaaaaaaaaaaaaaaaaaaaaaaaaaaaaaaaaaaaaaaaaaaaaaaaa
"}

(1,1,2) = {"
aaaaaaaaaaaaaaaaaaaaaaaaaaaaaaaaaaaaaaaaaaaaaaaaaaaaaaaaacaaaaaaaaaaaaacaaaaaaaaaaaaaaaaaaaaaaaaaaaaaaaaaaaaaaaaaaaaaaaaaaaaaaaaaaaaaaaaaaaaaaaaaaaaaa
aaaaaaaaaaaaaaaaaaaaaaaaaaaaaaaaaaaaaaaaaaaaaaaaaaaaaaaaacaaaaaaaaaaaaacaaaaaaaaaaaaaaaaaaaaaaaaaaaaaaaaaaaaaaaaaaaaaaaaaaaaaaaaaaaaaaaaaaaaaaaaaaaaaa
aaaaaaaaaaaaaaaaaaaaaaaaaaaaaaaaaaaaaaaaaaaaaaaaaaaaaaaaacaaaaaaaaaaaaacaaaaaaaaaaaaaaaaaaaaaaaaaaaaaaaaaaaaaaaaaaaaaaaaaaaaaaaaaaaaaaaaaaaaaaaaaaaaaa
aaaaaaaaaaaaaaaaaaaaaaaaaaaaaaaaaaaaaaaaaaaaaaaaaaaaaaaaacaaaaaaaaaaaaacaaaaaaaaaaaaaaaaaaaaaaaaaaaaaaaaaaaaaaaaaaaaaaaaaaaaaaaaaaaaaaaaaaaaaaaaaaaaaa
aaaaaaaaaaaaaaaaaaaaaaaaaaaaaaaQaRaRaRaSaTaTaTaTaTaTaTaUamaTaTaTaTaTaUamaTaVaTaTaTaTaTaTaWaaaaaaaaaaaaaaaaaaaaaaaaaaaaaaaaaaaaaaaaaaaaaaaaaaaaaaaaaaaa
aaaaaaaaaaaaaaaaaaaaaaaaaaaaaXaYaZbababbbcbcbcbcbcbdbcbebcbcbcbcbcbcbebcbdbcbcbcbcbcbcbcbfaWaaaaaaaaaaaaaaaaaaaaaaaaaaaaaaaaaaaaaaaaaaaaaaaaaaaaaaaaaa
aaaaaaaaaaaaaaaaaaaaaaaaaaaabgbabhbababibjbcbkbcbcbcbcbcbcbcbcbcbcbcbcbcbcbcbcbcbcbcbcbcbcbfaWaaaaaaaaaaaaaaaaaaaaaaaaaaaaaaaaaaaaaaaaaaaaaaaaaaaaaaaa
aaaaaaaaaaaaaaaaaaaaaaaaaaaabgblbmbababnbcbcbcbcbcbcbcbcbcbobpbqbcbcbcbcbcbcbcbcbkbcbcbcbcbcbfaTaWaaaaaaaaaaaaaaaaaaaaaaaaaaaaaaaaaaaaaaaaaaaaaaaaaaaa
aaaaaaaaaaaaaaaaaaaaaaaaaaaabgbaaZbababnbcbcbcbcbcbrbcbcbcbcbcbcbcbcbcbcbrbcbcbcbcbcbcbcbcbcbsbtbuaaaaaaaaaaaaaaaaaaaaaaaaaaaaaaaaaaaaaaaaaaaaaaaaaaaa
aaaaaaaaaaaaaaaaaaaaaaaaaaaabgbababababibvbcbcbcbcbcbcbcbcbwbcbxbkbcbcbcbcbcbcbcbcbcbcbcbcbsbuaaaaaaaaaaaaaaaaaaaaaaaaaaaaaaaaaaaaaaaaaaaaaaaaaaaaaaaa
aaaaaaaaaaaaaaaaaaaaaaaaaaaabybzbabAbBbbbcbcbcbcbcbcbcbcbcbcbcbcbcbcbcbcbcbcbcbcbcbcbcbcbsbuaaaaaaaaaaaaaaaaaaaaaaaaaaaaaaaaaaaaaaaaaaaaaaaaaaaaaaaaaa
aaaaaaaaaaaaaaaaaaaaaaaaaaaaaabCbDbDbDbEbtbFbtbtbtbGbtbHbtbtbtbtbtbtbHbtbGbFbtbtbtbtbtbtbuaaaaaaaaaaaaaaaaaaaaaaaaaaaaaaaaaaaaaaaaaaaaaaaaaaaaaaaaaaaa
aaaaaaaaaaaaaaaaaaaaaaaaaaaaaaaaaaaaaaaaaaaaaaaaaaaaaaaaaaaaaaaaaaaaaaaaaaaaaaaaaaaaaaaaaaaaaaaaaaaaaaaaaaaaaaaaaaaaaaaaaaaaaaaaaaaaaaaaaaaaaaaaaaaaaa
aaaaaaaaaaaaaaaaaaaaaaaaaaaaaaaaaaaaaaaaaaaaaaaaaaaaaaaaaaaaaaaaaaaaaaaaaaaaaaaaaaaaaaaaaaaaaaaaaaaaaaaaaaaaaaaaaaaaaaaaaaaaaaaaaaaaaaaaaaaaaaaaaaaaaa
aaaaaaaaaaaaaaaaaaaaaaaaaaaaaaaaaaaaaaaaaaaaaaaaaaaaaaaaaaaaaaaaaaaaaaaaaaaaaaaaaaaaaaaaaaaaaaaaaaaaaaaaaaaaaaaaaaaaaaaaaaaaaaaaaaaaaaaaaaaaaaaaaaaaaa
aaaaaaaaaaaaaaaaaaaaaaaaaaaaaaaaaaaaaaaaaaaaaaaaaaaaaaaaaaaaaaaaaaaaaaaaaaaaaaaaaaaaaaaaaaaaaaaaaaaaaaaaaaaaaaaaaaaaaaaaaaaaaaaaaaaaaaaaaaaaaaaaaaaaaa
aaaaaaaaaaaaaaaaaaaaaaaaaaaaaaaaaaaaaaaaaaaaaaaaaaaaaaaaaaaaaaaaaaaaaaaaaaaaaaaaaaaaaaaaaaaaaaaaaaaaaaaaaaaaaaaaaaaaaaaaaaaaaaaaaaaaaaaaaaaaaaaaaaaaaa
aaaaaaaaaaaaaaaaaaaaaaaaaaaaaaaaaaaaaaaaaaaaaaaaaaaaaaaaaaaaaaaaaaaaaaaaaaaaaaaaaaaaaaaaaaaaaaaaaaaaaaaaaaaaaaaaaaaaaaaaaaaaaaaaaaaaaaaaaaaaaaaaaaaaaa
aaaaaaaaaaaaaaaaaaaaaaaaaaaaaaaaaaaaaaaaaaaaaaaaaaaaaaaaaaaaaaaaaaaaaaaaaaaaaaaaaaaaaaaaaaaaaaaaaaaaaaaaaaaaaaaaaaaaaaaaaaaaaaaaaaaaaaaaaaaaaaaaaaaaaa
aaaaaaaaaaaaaaaaaaaaaaaaaaaaaaaaaaaaaaaaaaaaaaaaaaaaaaaaaaaaaaaaaaaaaaaaaaaaaaaaaaaaaaaaaaaaaaaaaaaaaaaaaaaaaaaaaaaaaaaaaaaaaaaaaaaaaaaaaaaaaaaaaaaaaa
aaaaaaaaaaaaaaaaaaaaaaaaaaaaaaaaaaaaaaaaaaaaaaaaaaaaaaaaaaaaaaaaaaaaaaaaaaaaaaaaaaaaaaaaaaaaaaaaaaaaaaaaaaaaaaaaaaaaaaaaaaaaaaaaaaaaaaaaaaaaaaaaaaaaaa
aaaaaaaaaaaaaaaaaaaaaaaaaaaaaaaaaaaaaaaaaaaaaaaaaaaaaaaaaaaaaaaaaaaaaaaaaaaaaaaaaaaaaaaaaaaaaaaaaaaaaaaaaaaaaaaaaaaaaaaaaaaaaaaaaaaaaaaaaaaaaaaaaaaaaa
aaaaaaaaaaaaaaaaaaaaaaaaaaaaaaaaaaaaaaaaaaaaaaaaaaaaaaaaaaaaaaaaaaaaaaaaaaaaaaaaaaaaaaaaaaaaaaaaaaaaaaaaaaaaaaaaaaaaaaaaaaaaaaaaaaaaaaaaaaaaaaaaaaaaaa
aaaaaaaaaaaaaaaaaaaaaaaaaaaaaaaaaaaaaaaaaaaaaaaaaaaaaaaaaaaaaaaaaaaaaaaaaaaaaaaaaaaaaaaaaaaaaaaaaaaaaaaaaaaaaaaaaaaaaaaaaaaaaaaaaaaaaaaaaaaaaaaaaaaaaa
aaaaaaaaaaaaaaaaaaaaaaaaaaaaaaaaaaaaaaaaaaaaaaaaaaaaaaaaaaaaaaaaaaaaaaaaaaaaaaaaaaaaaaaaaaaaaaaaaaaaaaaaaaaaaaaaaaaaaaaaaaaaaaaaaaaaaaaaaaaaaaaaaaaaaa
"}
