"b" = (/obj/structure/wild/tree/live_tree,/turf/floor/grass,/area/caribbean/sea/middle)
"d" = (/turf/floor/beach/water/deep/saltwater,/area/caribbean/sea/middle)
"n" = (/turf/floor/beach/water/shallowsaltwater,/area/caribbean/sea/middle)
"o" = (/turf/floor/beach/sand,/area/caribbean/sea/middle)
"w" = (/obj/structure/wild/tallgrass2,/turf/floor/beach/sand,/area/caribbean/sea/middle)
"B" = (/turf/wall/rockwall,/area/caribbean/sea/middle)
"F" = (/obj/structure/wild/bush,/turf/floor/grass,/area/caribbean/sea/middle)
"J" = (/obj/structure/wild/smallbush,/turf/floor/grass,/area/caribbean/sea/middle)
"O" = (/obj/structure/wild/flowers,/turf/floor/grass,/area/caribbean/sea/middle)
"Q" = (/obj/structure/wild/jungle/acacia,/turf/floor/grass,/area/caribbean/sea/middle)
"R" = (/obj/structure/wild/rock,/turf/floor/grass,/area/caribbean/sea/middle)
"S" = (/turf/floor/grass,/area/caribbean/sea/middle)
"T" = (/obj/structure/wild/palm,/turf/floor/beach/sand,/area/caribbean/sea/middle)
"Z" = (/obj/structure/wild/tallgrass2,/turf/floor/grass,/area/caribbean/sea/middle)

(1,1,1) = {"
BBBBBBBBBBBBBBBBBBBBBBBBBBBBBBBBBBBBBBBBBBBBBBBBBBBBBBBBBBBBBBBBBBBBBBBBBBBBBBBBBBBBBBBBBBBBBBBBBBBB
BBBBBBBBBBBBBBBBBBBBBBBBBBBBBBBBBBBBBBBBBBBBBBBBBBBBBBBBBBBBBBBBBBBBBBBBBBBBBBBBBBBBBBBBBBBBBBBBBBBB
BBBBBBBBBBBBBBBBBBBBBBBBBBBBBBBBBBBBBBBBBBBBBBBBBBBBBBBBBBBBBBBBBBBBBBBBBBBBBBBBBBBBBBBBBBBBBBBBBBBB
BBBBBBBBBBBBBBBBBBBBBBBBBBBBBBBBBBBBBBBBBBBBBBBBBBBBBBBBBBBBBBBBBBBBBBBBBBBBBBBBBBBBBBBBBBBBBBBBBBBB
BBBBBBBBBBBBBBBBBBBBBBBBBBBBBBBBBBBBBBBBBBBBBBBBBBBBBBBBBBBBBBBBBBBBBBBBBBBBBBBBBBBBBBBBBBBBBBBBBBBB
BBBBBBBBBBBBBBBBBBBBBBBBBBBBBBBBBBBBBBBBBBBBBBBBBBBBBBBBBBBBBBBBBBBBBBBBBBBBBBBBBBBBBBBBBBBBBBBBBBBB
BBBBBBBBBBBBBBBBBBBBBBBBBBBBBBBBBBBBBBBBBBBBBBBBBBBBBBBBBBBBBBBBBBBBBBBBBBBBBBBBBBBBBBBBBBBBBBBBBBBB
BBBBBBBBBBBBBBBBBBBBBBBBBBBBBBBBBBBBBBBBBBBBBBBBBBBBBBBBBBBBBBBBBBBBBBBBBBBBBBBBBBBBBBBBBBBBBBBBBBBB
BBBBBBBBBBBBBBBBBBBBBBBBBBBBBBBBBBBBBBBBBBBBBBBBBBBBBBBBBBBBBBBBBBBBBBBBBBBBBBBBBBBBBBBBBBBBBBBBBBBB
BBBBBBBBBBBBBBBBBBBBBBBBBBBBBBBBBBBBBBBBBBBBBBBBBBBBBBBBBBBBBBBBBBBBBBBBBBBBBBBBBBBBBBBBBBBBBBBBBBBB
BBBBBBBBBBBBBBBBBBBBBBBBBBBBBBBBBBBBBBBBBBBBBBBBBBBBBBBBBBBBBBBBBBBBBBBBBBBBBBBBBBBBBBBBBBBBBBBBBBBB
BBBBBBBBBBBBBBBBBBBBBBBBBBBBBBBBBBBBBBBBBBBBBBBBBBBBBBBBBBBBBBBBBBBBBBBBBBBBBBBBBBBBBBBBBBBBBBBBBBBB
BBBBBBBBBBBBBBBBBBBBBBBBBBBBBBBBBBBBBBBBBBBBBBBBBBBBBBBBBBBBBBBBBBBBBBBBBBBBBBBBBBBBBBBBBBBBBBBBBBBB
BBBBBBBBBBBBBBBBBBBBBBBBBBBBBBBBBBBBBBBBBBBBBBBBBBBBBBBBBBBBBBBBBBBBBBBBBBBBBBBBBBBBBBBBBBBBBBBBBBBB
BBBBBBBBBBBBBBBBBBBBBBBBBBBBBBBBBBBBBBBBBBBBBBBBBBBBBBBBBBBBBBBBBBBBBBBBBBBBBBBBBBBBBBBBBBBBBBBBBBBB
BBBBBBBBBBBBBBBBBBBBBBBBBBBBBBBBBBBBBBBBBBBBBBBBBBBBBBBBBBBBBBBBBBBBBBBBBBBBBBBBBBBBBBBBBBBBBBBBBBBB
BBBBBBBBBBBBBBBBBBBBBBBBBBBBBBBBBBBBBBBBBBBBBBBBBBBBBBBBBBBBBBBBBBBBBBBBBBBBBBBBBBBBBBBBBBBBBBBBBBBB
BBBBBBBBBBBBBBBBBBBBBBBBBBBBBBBBBBBBBBBBBBBBBBBBBBBBBBBBBBBBBBBBBBBBBBBBBBBBBBBBBBBBBBBBBBBBBBBBBBBB
BBBBBBBBBBBBBBBBBBBBBBBBBBBBBBBBBBBBBBBBBBBBBBBBBBBBBBBBBBBBBBBBBBBBBBBBBBBBBBBBBBBBBBBBBBBBBBBBBBBB
BBBBBBBBBBBBBBBBBBBBBBBBBBBBBBBBBBBBBBBBBBBBBBBBBBBBBBBBBBBBBBBBBBBBBBBBBBBBBBBBBBBBBBBBBBBBBBBBBBBB
BBBBBBBBBBBBBBBBBBBBBBBBBBBBBBBBBBBBBBBBBBBBBBBBBBBBBBBBBBBBBBBBBBBBBBBBBBBBBBBBBBBBBBBBBBBBBBBBBBBB
BBBBBBBBBBBBBBBBBBBBBBBBBBBBBBBBBBBBBBBBBBBBBBBBBBBBBBBBBBBBBBBBBBBBBBBBBBBBBBBBBBBBBBBBBBBBBBBBBBBB
BBBBBBBBBBBBBBBBBBBBBBBBBBBBBBBBBBBBBBBBBBBBBBBBBBBBBBBBBBBBBBBBBBBBBBBBBBBBBBBBBBBBBBBBBBBBBBBBBBBB
BBBBBBBBBBBBBBBBBBBBBBBBBBBBBBBBBBBBBBBBBBBBBBBBBBBBBBBBBBBBBBBBBBBBBBBBBBBBBBBBBBBBBBBBBBBBBBBBBBBB
BBBBBBBBBBBBBBBBBBBBBBBBBBBBBBBBBBBBBBBBBBBBBBBBBBBBBBBBBBBBBBBBBBBBBBBBBBBBBBBBBBBBBBBBBBBBBBBBBBBB
BBBBBBBBBBBBBBBBBBBBBBBBBBBBBBBBBBBBBBBBBBBBBBBBBBBBBBBBBBBBBBBBBBBBBBBBBBBBBBBBBBBBBBBBBBBBBBBBBBBB
BBBBBBBBBBBBBBBBBBBBBBBBBBBBBBBBBBBBBBBBBBBBBBBBBBBBBBBBBBBBBBBBBBBBBBBBBBBBBBBBBBBBBBBBBBBBBBBBBBBB
BBBBBBBBBBBBBBBBBBBBBBBBBBBBBBBBBBBBBBBBBBBBBBBBBBBBBBBBBBBBBBBBBBBBBBBBBBBBBBBBBBBBBBBBBBBBBBBBBBBB
BBBBBBBBBBBBBBBBBBBBBBBBBBBBBBBBBBBBBBBBBBBBBBBBBBBBBBBBBBBBBBBBBBBBBBBBBBBBBBBBBBBBBBBBBBBBBBBBBBBB
BBBBBBBBBBBBBBBBBBBBBBBBBBBBBBBBBBBBBBBBBBBBBBBBBBBBBBBBBBBBBBBBBBBBBBBBBBBBBBBBBBBBBBBBBBBBBBBBBBBB
BBBBBBBBBBBBBBBBBBBBBBBBBBBBBBBBBBBBBBBBBBBBBBBBBBBBBBBBBBBBBBBBBBBBBBBBBBBBBBBBBBBBBBBBBBBBBBBBBBBB
BBBBBBBBBBBBBBBBBBBBBBBBBBBBBBBBBBBBBBBBBBBBBBBBBBBBBBBBBBBBBBBBBBBBBBBBBBBBBBBBBBBBBBBBBBBBBBBBBBBB
"}
(1,1,2) = {"
dddddddddddddddddddddddddddddddddddddddddddddddddddddddddddddddddddddddddddddddddddddddddddddddddddd
dddddddddddddddddddnnnnnnnnnnnnnnnnnddddddddddddnnnnnnnnnnnnnnnnnnnnnnnnnnnndddddddddddddddddddddddd
dddddddddddddddddnnoooooooooooooooonnnnndddddnnnnoooooooooooooooooooooooooonnddddddddddddddddddddddd
ddddddddddddddddnooooSSSSSSSSSSSSSSooonnnnnnnnooooSSSFSSSooooooooooooooooooonndddddddddddddddddddddd
dddddddddddddddnooooSSSZSSSSRSZJSSFSSSooooooowoSSJSSZSJRbSSooooooooToooooToonndddddddddddddddddddddd
dddddddddddddddnoSSSSSOSFSQSSSSSSbSSQSSRSSSSJSFSRbOSSSSSFSJSooTooooooooooooonndddddddddddddddddddddd
ddddddddddddddnooSSSJRSSSSSSFSQSSSSSSSSSSSSSSSSSSSSSSQSSSSSSooooooooooooooonnddddddddddddddddddddddd
ddddddddddddddnoSSbSSSSSSSSSSSSSSSSSSSFSQSSSSbSSSSSSSSSSSQSZoooooooooToooonndddddddddddddddddddddddd
ddddddddddddddnoSSZSSSSQSSJSSSRSFSSSSSJSSSSSSSSSSSSSSSJSSSSSoooooTooooooonnddddddddddddddddddddddddd
ddddddddddddddnoSSSSQSSSSSSSQSSSJSQSbOSSSSFSRJQSbFSQSRSFOSSooToooooooonnnndddddddddddddddddddddddddd
ddddddddddddddooSSRSSSSZSSFSSSJSSSSSSSSSZSSSSSSSSSSSSSZoooooooooooonnndddddddddddddddddddddddddddddd
dddddddddddddnoSSSSFSbSSSSJRSSoooooooooooooooooooooooooonnnnnnnnnnnddddddddddddddddddddddddddddddddd
dddddddddddddnoSSQSSSSSSSSSSSooonnnnnnnnnnnnnnnnnnnnnnnnnddddddddddddddddddddddddddddddddddddddddddd
dddddddddddddooSSJSSSSOSSQSSooonnnnnnnnddddddddddddddddddddddddddddddddddddddddddddddddddddddddddddd
ddddddddddddnooSSSZRQSJSSFSSooonnnnnnddddddddddddddddddddddddddddddddddddddddddddddddddddddddddddddd
ddddddddddddnooSSbSSSSSSSSSSooonnnnndddddddddddddddddddddddddddddddddddddddddddddddddddddddddddddddd
ddddddddddddnooSSSSSSSSSSSZSooonnnnndddddddddddddddddddddddddddddddddddddddddddddddddddddddddddddddd
ddddddddddddnooSQFSZSSQSbSSSoooonnnnnddddddddddddddddddddddddddddddddddddddddddddddddddddddddddddddd
ddddddddddddnooSSSSSSSSRSSSSSooonnnnnnnddddddddddddddddddddddddddddddddddddddddddddddddddddddddddddd
ddddddddddddnooSSSSSSSJFSQSSSSooonnnnnnnnnnnnnnnnnnnnnnnnnnnnnnndddddddddddddddddddddddddddddddddddd
ddddddddddddnooSSSQSSSSSSSFSSSoooooooooooooooooooooooooooooooooonnnddddddddddddddddddddddddddddddddd
ddddddddddddnooSSOSSSSSSZSRSSSSSSSSSSSSSSSSSSSSSSSSSSSSSSoooooooooonnndddddddddddddddddddddddddddddd
ddddddddddddnooSSJRSSQSSSSSSQSSFSSSFSSSSSSSSSSSSOSSSSFSSSSSooToooooooonnnndddddddddddddddddddddddddd
dddddddddddddnoSSSSbSSSSSSSOSSSSSZSSSSQSSSOQSRSSSJSQSSSSQSSSooooooooooooonnddddddddddddddddddddddddd
dddddddddddddnoSSSZSSFSSSSSSbSSSSSSORSSJSSSSSSQSSSSSSSSSSSOSoooooooooooooonndddddddddddddddddddddddd
dddddddddddddnooSSSSSSSSSSSSSSSSQSSSSSSSSSSSbSSSSFSSZSSSSSSSooooooTooooTooonnddddddddddddddddddddddd
ddddddddddddddnooSSSSJSQSbZSSJSSSSSSSSSSSSSSSSSJSSSSRSQSSSSSoooooooooooooooonndddddddddddddddddddddd
ddddddddddddddnnooooSSSSRSSSFSSSSRSSbSQRSFSSSSSSSSQSFSSOSSSoooTooooooooooooonndddddddddddddddddddddd
dddddddddddddddnnooooSSSSSoooooooowSSSSSSSSQSSSOSSSSSSSSSooooooooooooToooooonndddddddddddddddddddddd
ddddddddddddddddnnnooooooooonnnnnnooooooooooooooooooooooooooooooooooooooooonnddddddddddddddddddddddd
dddddddddddddddddddnnnnnnnnnnddddnnnnnnnnnnnnnnnnnnnnnnnnnnnnnnnnnnnnnnnnnnndddddddddddddddddddddddd
dddddddddddddddddddddddddddddddddddddddddddddddddddddddddddddddddddddddddddddddddddddddddddddddddddd
"}
