"bT" = (/obj/covers/repairedfloor/ship,/obj/structure/closet/crate/rations/ale,/turf/floor/beach/water/deep/saltwater,/area/caribbean/pirates/ship/office)
"cq" = (/obj/structure/barricade/ship/blue/b17,/obj/covers/repairedfloor/ship,/obj/structure/barricade/ship/blue/b15,/turf/floor/beach/water/deep/saltwater,/area/caribbean/pirates/ship/office)
"eG" = (/obj/covers/repairedfloor/ship,/obj/structure/cannon{dir = 1},/turf/floor/beach/water/deep/saltwater,/area/caribbean/pirates/ship/main_deck)
"fo" = (/obj/structure/barricade/ship/wood/a9,/obj/covers/repairedfloor/ship,/turf/floor/beach/water/deep/saltwater,/area/caribbean/pirates/ship/office)
"gJ" = (/obj/structure/barricade/ship/wood/a5,/obj/covers/repairedfloor/ship,/turf/floor/beach/water/deep/saltwater,/area/caribbean/pirates/ship/office)
"iB" = (/obj/map_metadata/voyage,/turf/floor/beach/water/deep/saltwater,/area/caribbean/sea/top)
"jh" = (/obj/structure/table/wood,/obj/covers/repairedfloor/ship,/obj/structure/voyage/tablemap{dir = 4; layer = 2.9},/obj/item/weapon/gun/projectile/flintlock/pistoletmodelean1733,/turf/floor/beach/water/deep/saltwater,/area/caribbean/pirates/ship/office)
"jK" = (/obj/structure/barricade/ship/wood/a7,/obj/covers/repairedfloor/ship,/turf/floor/beach/water/deep/saltwater,/area/caribbean/pirates/ship/office)
"kK" = (/obj/structure/barricade/ship/wood/a4,/obj/covers/repairedfloor/ship,/obj/structure/barricade/ship/blue/b1,/turf/floor/beach/water/deep/saltwater,/area/caribbean/pirates/ship/office)
"ry" = (/obj/covers/repairedfloor/ship,/obj/structure/closet/crate/rations/fruits,/turf/floor/beach/water/deep/saltwater,/area/caribbean/pirates/ship/office)
"rT" = (/obj/structure/window/barrier/ship/wood/port0,/obj/covers/repairedfloor/ship,/turf/floor/beach/water/deep/saltwater,/area/caribbean/pirates/ship/main_deck)
"sg" = (/obj/covers/repairedfloor/ship,/obj/item/stack/money/goldcoin,/obj/structure/closet/crate/chest,/turf/floor/beach/water/deep/saltwater,/area/caribbean/pirates/ship/office)
"sO" = (/obj/covers/repairedfloor/ship,/obj/structure/bed/chair{dir = 4},/turf/floor/beach/water/deep/saltwater,/area/caribbean/pirates/ship/office)
"tL" = (/obj/structure/barricade/ship/wood/a2,/obj/covers/repairedfloor/ship,/turf/floor/beach/water/deep/saltwater,/area/caribbean/pirates/ship/office)
"tW" = (/obj/covers/repairedfloor/ship,/obj/structure/bookcase,/obj/item/weapon/book,/obj/item/weapon/book,/obj/item/weapon/book,/obj/item/weapon/book,/obj/item/weapon/book,/turf/floor/beach/water/deep/saltwater,/area/caribbean/pirates/ship/office)
"ua" = (/obj/structure/window/barrier/ship/blue/bport3,/obj/covers/repairedfloor/ship,/turf/floor/beach/water/deep/saltwater,/area/caribbean/pirates/ship/main_deck)
"um" = (/obj/covers/repairedfloor/ship,/obj/structure/bookcase,/obj/item/weapon/book,/obj/item/weapon/book,/obj/item/weapon/book,/turf/floor/beach/water/deep/saltwater,/area/caribbean/pirates/ship/office)
"uU" = (/obj/covers/repairedfloor/ship,/obj/structure/bed/hammock,/turf/floor/beach/water/deep/saltwater,/area/caribbean/pirates/ship/office)
"xK" = (/obj/structure/window/barrier/ship/wood/port0,/obj/covers/repairedfloor/ship/south,/turf/floor/beach/water/deep/saltwater,/area/caribbean/pirates/ship/main_deck)
"xN" = (/obj/covers/repairedfloor/ship,/obj/structure/wallclock,/turf/floor/beach/water/deep/saltwater,/area/caribbean/pirates/ship/office)
"yr" = (/obj/structure/window/barrier/ship/wood/port2,/obj/covers/repairedfloor/ship/south,/mob/living/simple_animal/hostile/human/voyage/pirate,/turf/floor/beach/water/deep/saltwater,/area/caribbean/pirates/ship/main_deck)
"yZ" = (/obj/covers/repairedfloor/ship,/mob/living/simple_animal/hostile/human/voyage/pirate,/turf/floor/beach/water/deep/saltwater,/area/caribbean/pirates/ship/main_deck)
"Ae" = (/obj/covers/repairedfloor/ship,/obj/structure/table/fancy,/obj/item/weapon/reagent_containers/food/snacks/applepie,/turf/floor/beach/water/deep/saltwater,/area/caribbean/pirates/ship/office)
"BN" = (/obj/covers/repairedfloor/ship,/turf/floor/beach/water/deep/saltwater,/area/caribbean/pirates/ship/office)
"CS" = (/obj/structure/window/barrier/ship/wood/port2,/obj/covers/repairedfloor/ship/south,/turf/floor/beach/water/deep/saltwater,/area/caribbean/pirates/ship/main_deck)
"EL" = (/obj/structure/table/wood,/obj/covers/repairedfloor/ship,/obj/structure/potted_plant{dir = 5},/turf/floor/beach/water/deep/saltwater,/area/caribbean/pirates/ship/office)
"Ft" = (/obj/structure/window/barrier/ship/blue/bport3,/obj/structure/cannon/modern/tank/voyage/autofire,/obj/covers/repairedfloor/ship,/turf/floor/beach/water/deep/saltwater,/area/caribbean/pirates/ship/main_deck)
"FU" = (/obj/structure/barricade/ship/wood/a12,/obj/covers/repairedfloor/ship,/turf/floor/beach/water/deep/saltwater,/area/caribbean/pirates/ship/office)
"GR" = (/obj/covers/repairedfloor/ship,/obj/structure/barricade/ship/blue/b2,/turf/floor/beach/water/deep/saltwater,/area/caribbean/pirates/ship/office)
"GS" = (/obj/covers/repairedfloor/ship,/turf/floor/beach/water/deep/saltwater,/area/caribbean/pirates/ship/main_deck)
"Hf" = (/obj/structure/barricade/ship/wood/a7,/obj/covers/repairedfloor/ship,/obj/structure/sign/painting9,/turf/floor/beach/water/deep/saltwater,/area/caribbean/pirates/ship/office)
"HK" = (/obj/structure/barricade/ship/mast,/obj/covers/repairedfloor/ship,/turf/floor/beach/water/deep/saltwater,/area/caribbean/pirates/ship/main_deck)
"IG" = (/obj/covers/repairedfloor/ship,/obj/item/stack/money/goldvaluables,/obj/item/stack/money/goldvaluables,/obj/structure/closet/crate/chest,/turf/floor/beach/water/deep/saltwater,/area/caribbean/pirates/ship/office)
"Jf" = (/obj/structure/barricade/ship/wood/a3,/obj/covers/repairedfloor/ship,/turf/floor/beach/water/deep/saltwater,/area/caribbean/pirates/ship/office)
"Jj" = (/obj/structure/window/barrier/ship/blue/bport0,/obj/covers/repairedfloor/ship,/turf/floor/beach/water/deep/saltwater,/area/caribbean/pirates/ship/main_deck)
"Ju" = (/obj/structure/flag/pirates,/obj/covers/repairedfloor/ship,/turf/floor/beach/water/deep/saltwater,/area/caribbean/pirates/ship/main_deck)
"JO" = (/obj/covers/repairedfloor/ship,/obj/structure/grapplehook/auto{owner = "PIRATES"},/turf/floor/beach/water/deep/saltwater,/area/caribbean/pirates/ship/main_deck)
"Lq" = (/obj/structure/barricade/ship/wood/a1,/obj/covers/repairedfloor/ship,/turf/floor/beach/water/deep/saltwater,/area/caribbean/pirates/ship/office)
"LP" = (/obj/structure/barricade/ship/blue/b16,/obj/covers/repairedfloor/ship,/turf/floor/beach/water/deep/saltwater,/area/caribbean/pirates/ship/office)
"Mh" = (/obj/structure/barricade/ship/wood/a6,/obj/covers/repairedfloor/ship,/turf/floor/beach/water/deep/saltwater,/area/caribbean/pirates/ship/office)
"Mu" = (/obj/covers/repairedfloor/ship,/obj/structure/oven,/turf/floor/beach/water/deep/saltwater,/area/caribbean/pirates/ship/office)
"Nw" = (/turf/wall/wood,/area/caribbean/pirates/ship/office)
"PC" = (/turf/floor/beach/water/deep/saltwater,/area/caribbean/sea/top)
"Qg" = (/obj/structure/barricade/ship/blue/b10,/obj/covers/repairedfloor/ship,/turf/floor/beach/water/deep/saltwater,/area/caribbean/pirates/ship/office)
"Qn" = (/obj/covers/repairedfloor/ship,/mob/living/simple_animal/hostile/human/voyage/pirate/ranged,/turf/floor/beach/water/deep/saltwater,/area/caribbean/pirates/ship/main_deck)
"RW" = (/obj/structure/barricade/ship/blue/b19,/obj/covers/repairedfloor/ship,/turf/floor/beach/water/deep/saltwater,/area/caribbean/pirates/ship/office)
"So" = (/obj/structure/barricade/ship/blue/b8,/obj/covers/repairedfloor/ship,/obj/covers/repairedfloor/ship,/turf/floor/beach/water/deep/saltwater,/area/caribbean/pirates/ship/office)
"SS" = (/obj/covers/repairedfloor/ship,/obj/structure/table/rack/coatrack,/turf/floor/beach/water/deep/saltwater,/area/caribbean/pirates/ship/office)
"TQ" = (/obj/structure/barricade/ship/blue/b9,/obj/covers/repairedfloor/ship,/turf/floor/beach/water/deep/saltwater,/area/caribbean/pirates/ship/office)
"Uz" = (/obj/covers/repairedfloor/ship,/obj/item/stack/money/goldvaluables,/obj/structure/closet/crate/chest,/turf/floor/beach/water/deep/saltwater,/area/caribbean/pirates/ship/office)
"Xz" = (/obj/covers/repairedfloor/ship,/obj/structure/bed/chair/comfy/blue{dir = 8},/turf/floor/beach/water/deep/saltwater,/area/caribbean/pirates/ship/office)
"Ym" = (/obj/structure/simple_door/key_door/anyone/wood,/obj/covers/repairedfloor/ship,/turf/floor/beach/water/deep/saltwater,/area/caribbean/pirates/ship/office)
"YO" = (/obj/structure/barricade/ship/blue/b18,/obj/covers/repairedfloor/ship,/turf/floor/beach/water/deep/saltwater,/area/caribbean/pirates/ship/office)

(1,1,1) = {"
PCPCPCPCPCPCPCPCPCPCPCPCPCPCPCPCPCPCPCPCPCPCPCPCPCPCPCPCPCPCPCPCPCPCPCPCPCPCPCPCPCPCPCPCPCPCPCPCPCPCPCPCPCPCPCPCPCPCPCPCPCPCPCPCPCPCPCPCPCPCPCPCPCPCPC
PCPCPCPCPCPCPCPCPCPCPCPCPCPCPCPCPCPCPCPCPCPCPCPCPCPCPCPCPCPCPCPCPCPCPCPCPCPCPCPCPCPCPCPCPCPCPCPCPCPCPCPCPCPCPCPCPCPCPCPCPCPCPCPCPCPCPCPCPCPCPCPCPCPCPC
PCPCPCPCPCPCPCPCPCPCPCPCPCPCPCPCPCPCPCPCPCPCPCPCPCPCPCPCPCPCPCPCPCPCPCPCPCPCPCPCPCPCPCPCPCPCPCPCPCPCPCPCPCPCPCPCPCPCPCPCPCPCPCPCPCPCPCPCPCPCPCPCPCPCPC
PCPCPCPCPCPCPCPCPCPCPCPCPCPCPCPCPCPCPCPCPCPCPCPCPCPCPCPCPCPCPCPCPCPCPCPCPCPCPCPCPCPCPCPCPCPCPCPCPCPCPCPCPCPCPCPCPCPCPCPCPCPCPCPCPCPCPCPCPCPCPCPCPCPCPC
PCPCPCPCPCPCPCPCPCPCPCPCPCPCPCPCPCPCPCPCPCPCPCPCPCPCPCPCPCPCPCPCPCPCPCPCPCPCPCPCPCPCPCPCPCPCPCPCPCPCPCPCPCPCPCPCPCPCPCPCPCPCPCPCPCPCPCPCPCPCPCPCPCPCPC
PCPCPCPCPCPCPCPCPCPCPCPCPCPCPCPCPCPCPCPCPCPCPCPCPCPCPCPCPCPCPCPCPCPCPCPCPCPCPCPCPCPCPCPCPCPCPCPCPCPCPCPCPCPCPCPCPCPCPCPCPCPCPCPCPCPCPCPCPCPCPCPCPCPCPC
PCPCPCPCPCPCPCPCPCPCPCPCPCPCPCPCPCPCPCPCPCPCPCPCPCPCPCPCPCPCPCPCPCPCPCPCPCPCPCPCPCPCPCPCPCPCPCPCPCPCPCPCPCPCPCPCPCPCPCPCPCPCPCPCPCPCPCPCPCPCPCPCPCPCPC
PCPCPCPCPCPCPCPCPCPCPCPCPCPCPCPCPCPCPCPCPCPCPCPCPCPCPCPCPCPCPCPCPCPCPCPCPCPCPCPCPCPCPCPCPCPCPCPCPCPCPCPCPCPCPCPCPCPCPCPCPCPCPCPCPCPCPCPCPCPCPCPCPCPCPC
PCPCPCPCPCPCPCPCPCPCPCPCPCPCPCPCPCPCPCPCPCPCPCPCPCPCPCPCPCPCPCPCPCPCPCPCPCPCPCPCPCPCPCPCPCPCPCPCPCPCPCPCPCPCPCPCPCPCPCPCPCPCPCPCPCPCPCPCPCPCPCPCPCPCPC
PCPCPCPCPCPCPCPCPCPCPCPCPCPCPCPCPCPCPCPCPCPCPCPCPCPCPCPCPCPCPCPCPCPCPCPCPCPCPCPCPCPCPCPCPCPCPCPCPCPCPCPCPCPCPCPCPCPCPCPCPCPCPCPCPCPCPCPCPCPCPCPCPCPCPC
PCPCPCPCPCPCPCPCPCPCPCPCPCPCPCPCPCPCPCPCPCPCPCPCPCPCPCPCPCPCPCPCPCPCPCPCPCPCPCPCPCPCPCPCPCPCPCPCPCPCPCPCPCPCPCPCPCPCPCPCPCPCPCPCPCPCPCPCPCPCPCPCPCPCPC
PCPCPCPCPCPCPCPCPCPCPCPCPCPCPCPCPCPCPCPCPCPCPCPCPCPCPCPCPCPCPCPCPCPCPCPCPCPCPCPCPCPCPCPCPCPCPCPCPCPCPCPCPCPCPCPCPCPCPCPCPCPCPCPCPCPCPCPCPCPCPCPCPCPCPC
PCPCPCPCPCPCPCPCPCPCPCPCPCPCPCPCPCPCPCPCPCPCPCPCPCPCPCPCPCPCPCPCPCPCPCPCPCPCPCPCPCPCPCPCPCPCPCPCPCPCPCPCPCPCPCPCPCPCPCPCPCPCPCPCPCPCPCPCPCPCPCPCPCPCPC
PCPCPCPCPCPCPCPCPCPCPCPCPCPCPCPCPCPCPCPCPCPCPCPCPCPCPCPCPCPCPCPCPCPCPCPCPCPCPCPCPCPCPCPCPCPCPCPCPCPCPCPCPCPCPCPCPCPCPCPCPCPCPCPCPCPCPCPCPCPCPCPCPCPCPC
PCPCPCPCPCPCPCPCPCPCPCPCPCPCPCPCPCPCPCPCPCPCPCPCPCPCPCPCPCPCPCPCPCPCPCPCPCPCPCPCPCPCPCPCPCPCPCPCPCPCPCPCPCPCPCPCPCPCPCPCPCPCPCPCPCPCPCPCPCPCPCPCPCPCPC
PCPCPCPCPCPCPCPCPCPCPCPCPCPCPCPCPCPCPCPCPCPCPCPCPCPCPCPCPCPCPCPCPCPCPCPCPCPCPCPCPCPCPCPCPCPCPCPCPCPCPCPCPCPCPCPCPCPCPCPCPCPCPCPCPCPCPCPCPCPCPCPCPCPCPC
PCPCPCPCPCPCPCPCPCPCPCPCPCPCPCPCPCPCPCPCPCPCPCPCPCPCPCPCPCPCPCPCPCPCPCPCPCPCPCPCPCPCPCPCPCPCPCPCPCPCPCPCPCPCPCPCPCPCPCPCPCPCPCPCPCPCPCPCPCPCPCPCPCPCPC
PCPCPCPCPCPCPCPCPCPCPCPCPCPCPCPCPCPCPCPCPCPCPCPCPCPCPCPCPCPCPCPCPCPCPCPCPCPCPCPCPCPCPCPCPCPCPCPCPCPCPCPCPCPCPCPCPCPCPCPCPCPCPCPCPCPCPCPCPCPCPCPCPCPCPC
PCPCPCPCPCPCPCPCPCPCPCPCPCPCPCPCPCPCPCPCPCPCPCPCPCPCPCPCPCPCPCPCPCPCPCPCPCPCPCPCPCPCPCPCPCPCPCPCPCPCPCPCPCPCPCPCPCPCPCPCPCPCPCPCPCPCPCPCPCPCPCPCPCPCPC
PCPCPCPCPCPCPCPCPCPCPCPCPCPCPCPCPCPCPCPCPCPCPCPCPCPCPCPCPCPCPCPCPCPCPCPCPCPCPCPCPCPCPCPCPCPCPCPCPCPCPCPCPCPCPCPCPCPCPCPCPCPCPCPCPCPCPCPCPCPCPCPCPCPCPC
PCPCPCPCPCPCPCPCPCPCPCPCPCPCPCPCPCPCPCPCPCPCPCPCPCPCPCPCPCPCPCPCPCPCPCPCPCPCPCPCPCPCPCPCPCPCPCPCPCPCPCPCPCPCPCPCPCPCPCPCPCPCPCPCPCPCPCPCPCPCPCPCPCPCPC
PCPCPCPCPCPCPCPCPCPCPCPCPCPCPCPCPCPCPCPCPCPCPCPCPCPCPCPCPCPCPCPCPCPCPCPCPCPCPCPCPCPCPCPCPCPCPCPCPCPCPCPCPCPCPCPCPCPCPCPCPCPCPCPCPCPCPCPCPCPCPCPCPCPCPC
PCPCPCPCPCPCPCPCPCPCPCPCPCPCPCPCPCPCPCPCPCPCPCPCPCPCPCPCPCPCPCPCPCPCPCPCPCPCPCPCPCPCPCPCPCPCPCPCPCPCPCPCPCPCPCPCPCPCPCPCPCPCPCPCPCPCPCPCPCPCPCPCPCPCPC
PCPCPCPCPCPCPCPCPCPCPCPCPCPCPCPCPCPCPCPCPCPCPCPCPCPCPCPCPCPCPCPCPCPCPCPCPCPCPCPCPCPCPCPCPCPCPCPCPCPCPCPCPCPCPCPCPCPCPCPCPCPCPCPCPCPCPCPCPCPCPCPCPCPCPC
iBPCPCPCPCPCPCPCPCPCPCPCPCPCPCPCPCPCPCPCPCPCPCPCPCPCPCPCPCPCPCPCPCPCPCPCPCPCPCPCPCPCPCPCPCPCPCPCPCPCPCPCPCPCPCPCPCPCPCPCPCPCPCPCPCPCPCPCPCPCPCPCPCPCPC
"}
(1,1,2) = {"
PCPCPCPCPCPCPCPCPCPCPCPCPCPCPCPCPCPCPCPCPCPCPCPCPCPCPCPCPCPCPCPCPCPCPCPCPCPCPCPCPCPCPCPCPCPCPCPCPCPCPCPCPCPCPCPCPCPCPCPCPCPCPCPCPCPCPCPCPCPCPCPCPCPCPC
PCPCPCPCPCPCPCPCPCPCPCPCPCPCPCPCPCPCPCPCPCPCPCPCPCPCPCPCPCPCPCPCPCPCPCPCPCPCPCPCPCPCPCPCPCPCPCPCPCPCPCPCPCPCPCPCPCPCPCPCPCPCPCPCPCPCPCPCPCPCPCPCPCPCPC
PCPCPCPCPCPCPCPCPCPCPCPCPCPCPCPCPCPCPCPCPCPCPCPCPCPCPCPCPCPCPCPCPCPCPCPCPCPCPCPCPCPCPCPCPCPCPCPCPCPCPCPCPCPCPCPCPCPCPCPCPCPCPCPCPCPCPCPCPCPCPCPCPCPCPC
PCPCPCPCPCPCPCPCPCPCPCPCPCPCPCPCPCPCPCPCPCPCPCPCPCPCPCPCPCPCPCPCPCPCPCPCPCPCPCPCPCPCPCPCPCPCPCPCPCPCPCPCPCPCPCPCPCPCPCPCPCPCPCPCPCPCPCPCPCPCPCPCPCPCPC
PCPCPCPCPCPCPCPCPCPCPCPCPCPCPCPCPCPCPCPCPCPCPCPCPCPCPCPCPCPCPCPCPCPCPCPCPCPCPCPCPCPCPCPCPCPCPCPCPCPCPCPCPCPCPCPCPCPCPCPCPCPCPCPCPCPCPCPCPCPCPCPCPCPCPC
PCPCPCPCPCPCPCPCPCPCPCPCPCPCPCPCPCPCPCPCPCPCPCPCPCPCPCPCPCPCPCPCPCPCPCPCPCPCPCPCPCPCPCPCPCPCPCPCPCPCPCPCPCPCPCPCPCPCPCPCPCPCPCPCPCPCPCPCPCPCPCPCPCPCPC
PCPCPCPCPCPCPCPCPCPCPCPCPCPCPCPCPCPCPCPCPCPCPCPCPCPCPCPCPCPCPCPCPCPCPCPCPCPCPCPCPCPCPCPCPCPCPCPCPCPCPCPCPCPCPCPCPCPCPCPCPCPCPCPCPCPCPCPCPCPCPCPCPCPCPC
PCPCPCPCPCPCPCPCPCPCPCPCPCPCPCPCPCPCPCPCPCPCPCPCPCPCPCPCPCPCPCPCPCPCPCPCPCPCPCPCPCPCPCPCPCPCPCPCPCPCPCPCPCPCPCPCPCPCPCPCPCPCPCPCPCPCPCPCPCPCPCPCPCPCPC
PCPCPCPCPCPCPCPCPCPCPCPCPCPCPCPCPCPCPCPCPCPCPCPCPCPCPCPCPCPCPCPCPCPCPCPCPCPCPCPCPCPCPCPCPCPCPCPCPCPCPCPCPCPCPCPCPCPCPCPCPCPCPCPCPCPCPCPCPCPCPCPCPCPCPC
PCPCPCPCPCPCPCPCPCPCPCPCPCPCPCPCPCPCPCPCPCPCPCPCPCPCPCPCPCPCPCPCPCPCPCPCPCPCPCPCPCPCPCPCPCPCPCPCPCPCPCPCPCPCPCPCPCPCPCPCPCPCPCPCPCPCPCPCPCPCPCPCPCPCPC
PCPCPCPCPCPCPCPCPCPCPCPCPCPCPCPCPCPCPCPCPCPCPCPCPCPCPCPCPCPCPCPCPCPCPCPCPCPCPCPCPCPCPCPCPCPCPCPCPCPCPCPCPCPCPCPCPCPCPCPCPCPCPCPCPCPCPCPCPCPCPCPCPCPCPC
PCPCPCPCPCPCPCPCPCPCPCPCPCPCPCPCPCPCPCPCPCPCPCPCPCPCPCPCPCPCPCPCPCPCPCPCPCPCPCPCPCPCPCPCPCPCPCPCPCPCPCPCPCPCPCPCPCPCPCPCPCPCPCPCPCPCPCPCPCPCPCPCPCPCPC
PCPCPCPCPCPCPCPCPCPCPCPCPCPCPCPCPCPCPCPCPCPCPCPCPCPCPCPCPCPCPCPCPCPCPCPCPCPCPCPCPCPCPCPCPCPCPCPCPCPCPCPCPCPCPCPCPCPCPCPCPCPCPCPCPCPCPCPCPCPCPCPCPCPCPC
PCPCPCPCPCPCPCPCPCPCPCPCPCPCPCPCPCPCPCPCPCPCPCPCPCPCPCPCPCPCPCPCPCPCPCPCPCPCPCPCPCPCPCPCPCPCPCPCPCPCPCPCPCPCPCPCPCPCPCPCPCPCPCPCPCPCPCPCPCPCPCPCPCPCPC
PCPCPCPCPCPCPCPCPCPCPCPCPCPCPCPCPCPCPCPCPCPCPCPCPCPCPCPCPCPCPCPCPCPCPCPCPCPCPCPCPCPCPCPCPCPCPCPCPCPCPCPCPCPCPCPCPCPCPCPCPCPCPCPCPCPCPCPCPCPCPCPCPCPCPC
PCPCPCPCPCPCPCPCPCPCPCPCPCPCPCPCPCPCPCPCPCPCPCPCPCPCPCPCPCPCPCPCPCPCPCPCPCPCPCPCPCPCPCPCPCPCPCPCPCPCPCPCPCPCPCPCPCPCPCPCPCPCPCPCPCPCPCPCPCPCPCPCPCPCPC
PCPCPCPCPCPCPCPCPCPCPCPCPCPCPCPCPCkKjKjKjKjKfoPCPCPCPCPCPCPCPCPCPCPCPCPCPCPCPCPCPCPCPCPCPCPCPCPCPCPCPCPCPCPCPCPCPCPCPCPCPCPCPCPCPCPCPCPCPCPCPCPCPCPCPC
PCPCPCPCPCPCPCPCPCPCPCPCPCPCPCPCPCGRuUBNBNuUFUCSrTyrrTCSxKCSrTCSrTCSrTCSrTCSrTCSrTCSrTJfjKHfjKfoPCPCPCPCPCPCPCPCPCPCPCPCPCPCPCPCPCPCPCPCPCPCPCPCPCPCPC
PCPCPCPCPCPCPCPCPCPCPCPCPCPCPCPCPCGRryBNBNuUFUGSGSGSGSeGGSJOGSGSGSeGJOGSyZGSyZeGJOGSyZtLxNtWumgJfoPCPCPCPCPCPCPCPCPCPCPCPCPCPCPCPCPCPCPCPCPCPCPCPCPCPC
PCPCPCPCPCPCPCPCPCPCPCPCPCPCPCPCPCGRbTBNBNBNMhGSGSGSGSGSGSGSQnGSGSGSGSGSGSGSGSGSGSGSGStLBNBNBNBNMhNwPCPCPCPCPCPCPCPCPCPCPCPCPCPCPCPCPCPCPCPCPCPCPCPCPC
PCPCPCPCPCPCPCPCPCPCPCPCPCPCPCPCPCGRAeBNBNBNYmGSGSHKGSGSGSJuGSGSyZGSGSGSHKGSGSGSGSGSGSYmBNBNjhXzMhNwNwNwPCPCPCPCPCPCPCPCPCPCPCPCPCPCPCPCPCPCPCPCPCPCPC
PCPCPCPCPCPCPCPCPCPCPCPCPCPCPCPCPCGRMuBNBNBNMhGSGSGSGSGSGSGSGSGSGSGSGSGSGSGSGSQnGSGSGStLBNBNBNBNMhNwPCPCPCPCPCPCPCPCPCPCPCPCPCPCPCPCPCPCPCPCPCPCPCPCPC
PCPCPCPCPCPCPCPCPCPCPCPCPCPCPCPCPCGRUzBNBNBNMhGSGSyZGSGSQnJOGSyZGSGSJOGSGSGSGSGSJOGSyZLqSSsOELYOQgPCPCPCPCPCPCPCPCPCPCPCPCPCPCPCPCPCPCPCPCPCPCPCPCPCPC
PCPCPCPCPCPCPCPCPCPCPCPCPCPCPCPCPCGRUzIGsguUMhuaJjuaJjFtJjuaJjuaJjFtJjuaJjuaJjFtJjuaJjLPTQTQTQRWPCPCPCPCPCPCPCPCPCPCPCPCPCPCPCPCPCPCPCPCPCPCPCPCPCPCPC
PCPCPCPCPCPCPCPCPCPCPCPCPCPCPCPCPCcqTQTQTQTQSoPCPCPCPCPCPCPCPCPCPCPCPCPCPCPCPCPCPCPCPCPCPCPCPCPCPCPCPCPCPCPCPCPCPCPCPCPCPCPCPCPCPCPCPCPCPCPCPCPCPCPCPC
"}
